词牌名,韵律,中,平,仄,总数,分段字数
十六字令,平。中仄平平仄仄平。平平仄，中仄仄平平。,2,8,6,16,"[1, 7, 3, 5]"
南歌子,『仄仄平平仄，平平仄仄平』。中平中仄仄平平，中仄中平中仄仄平平。,5,11,10,26,"[5, 5, 7, 9]"
渔歌子,中仄平平仄仄平，中平平仄仄平平。『平仄仄，仄平平』，平平仄仄仄平平。,2,14,11,27,"[7, 7, 3, 3, 7]"
忆江南,平中仄，中仄ˇ仄平平。『中仄中平平仄仄，中平中仄仄平平』。中仄仄平平。,7,10,10,27,"[3, 5, 7, 7, 5]"
潇湘神,〖平仄平，平仄平〗。仄平中仄仄平平。中仄仄平平仄仄，平平平仄仄平平。,2,14,11,27,"[3, 3, 7, 7, 7]"
捣练子,平仄仄，仄平平。仄仄平平仄仄平。中仄仄平平仄仄，仄平平仄仄平平。,1,12,14,27,"[3, 3, 7, 7, 7]"
浪淘沙,中仄平平中仄平，中平中仄仄平平。中平中仄中平仄，中仄平平仄仄平。,8,11,9,28,"[7, 7, 7, 7]"
江南春,平仄仄，仄平平。平平平仄仄，平仄仄平平。平平平仄平平仄，平仄平平平仄平。,0,19,11,30,"[3, 3, 5, 5, 7, 7]"
忆王孙,中平中仄仄平平，中仄平平中仄平。中仄平平仄仄平。仄平平，中仄平平中仄平。,7,14,10,31,"[7, 7, 7, 3, 7]"
江城子,中平中仄仄平平。仄平平，仄平平。中平中仄，中仄仄平平。中仄中平平仄仄，平仄仄，仄平平。,7,15,13,35,"[7, 3, 3, 4, 5, 7, 3, 3]"
长相思,中中平，〖中中平〗。中仄平平中仄平，中平中仄平。中中平，〖中中平〗。中仄平平中仄平，中平中仄平。,16,14,6,36,"[3, 3, 7, 5, 3, 3, 7, 5]"
醉太平,平平仄平，平平仄平，中平中仄平平，仄平平仄平。平平仄平，平平仄平，中平中仄平平，仄平平仄平。,4,24,10,38,"[4, 4, 6, 5, 4, 4, 6, 5]"
玉蝴蝶,平平平仄平平，平仄仄平平。仄仄仄平平，平平仄仄平。平平平仄仄，平仄仄平平。平仄仄平平，仄平平仄平。,0,25,16,41,"[6, 5, 5, 5, 5, 5, 5, 5]"
浣溪沙,中仄中平中仄平，中平中仄仄平平，中平中仄仄平平。『中仄中平平仄仄，中平中仄仄平平』。中平中仄仄平平。,13,16,13,42,"[7, 7, 7, 7, 7, 7]"
巫山一段云,中仄平平仄，平平中仄平。中平中仄仄平平，中仄仄平平。中仄平平仄，平平中仄平。中平中仄仄平平，中仄仄平平。,10,20,14,44,"[5, 5, 7, 5, 5, 5, 7, 5]"
采桑子,中平中仄平平仄，中仄平平。中仄平平，中仄平平中仄平。中平中仄平平仄，中仄平平。中仄平平，中仄平平中仄平。,12,20,12,44,"[7, 4, 4, 7, 7, 4, 4, 7]"
诉衷情,中平中仄仄平平，中仄仄平平。中平中仄平仄，中仄仄平平。平仄仄，仄平平，仄平平。中平平仄，中仄平平，中仄平平。,9,20,15,44,"[7, 5, 6, 5, 3, 3, 3, 4, 4, 4]"
画堂春,中平中仄仄平平，中平中仄平平。中平中仄仄平平，中仄平平。中仄中平中仄，中平中仄平平。中平中仄仄平平，中仄平平。,15,20,12,47,"[7, 6, 7, 4, 6, 6, 7, 4]"
阮郎归,中平平仄仄平平，平平中仄平。仄平平仄仄平平，中平中仄平。平仄仄，仄平平，中平中仄平。中平中仄仄平平，中平中仄平。,10,23,14,47,"[7, 5, 7, 5, 3, 3, 5, 7, 5]"
三字令,平仄仄，仄平平。仄平平。平仄仄，仄平平。仄平平，平仄仄，仄平平。平仄仄，仄平平。仄平平。平仄仄，仄平平。仄平平，平仄仄，仄平平。,0,26,22,48,"[3, 3, 3, 3, 3, 3, 3, 3, 3, 3, 3, 3, 3, 3, 3, 3]"
朝中措,中平中仄仄平平，中仄仄平平。中仄中平中仄，中平中仄平平。中平中仄，中平中仄，中仄平平。中仄中平中仄，中平中仄平平。,18,17,13,48,"[7, 5, 6, 6, 4, 4, 4, 6, 6]"
眼儿媚,平仄平平仄平平，中仄仄平平。中平中仄，中平中仄，中仄平平。中平中仄平平仄，中仄仄平平。中平中仄，中平中仄，中仄平平。,14,20,14,48,"[7, 5, 4, 4, 4, 7, 5, 4, 4, 4]"
人月圆,中平中仄平平仄，中仄仄平平。中平中仄，平平仄仄，中仄平平。中平中仄，中平中仄，中仄平平。中平中仄，平平仄仄，中仄平平。,14,19,15,48,"[7, 5, 4, 4, 4, 4, 4, 4, 4, 4, 4]"
柳梢青,中仄平平，中平中仄，仄仄平平。中仄平平，中平中仄，中仄平平。中平中仄平平，仄中仄、平平仄平。中仄平平，中平中仄，中仄平平。,14,21,14,49,"[4, 4, 4, 4, 4, 4, 6, 3, 4, 4, 4, 4]"
太常引,中平中仄仄平平，中仄仄平平。中仄仄平平，仄中仄、平平去平。中平中仄，中平中仄，中仄仄平平。中仄仄平平，仄中仄、平平去平。,12,19,16,47,"[7, 5, 5, 3, 4, 4, 4, 5, 5, 3, 4]"
少年游,中平中仄仄平平，中仄仄平平。中平中仄，中平中仄，中仄仄平平。中平中仄平平仄，中仄仄平平。中仄平平，中平中仄，中仄仄平平。,15,19,16,50,"[7, 5, 4, 4, 5, 7, 5, 4, 4, 5]"
临江仙,中仄中平平仄仄，中平中仄平平。中平中仄仄平平。中平中仄，中仄仄平平。中仄中平平仄仄，中平中仄平平。中平中仄仄平平。中平中仄，中仄仄平平。,18,22,18,58,"[7, 6, 7, 4, 5, 7, 6, 7, 4, 5]"
鹧鸪天,中仄平平中仄平，中平中仄仄平平。『中平中仄平平仄，中仄平平中仄平』。『平仄仄，仄平平』。中平中仄仄平平。中平中仄平平仄，中仄平平中仄平。,14,24,17,55,"[7, 7, 7, 7, 3, 3, 7, 7, 7]"
小重山,中仄平平中仄平。中平平仄仄，仄平平。中平中仄仄平平。平中仄，中仄仄平平。中仄仄平平。中平平仄仄，仄平平。中平中仄仄平平。平中仄，中仄仄平平。,13,25,20,58,"[7, 5, 3, 7, 3, 5, 5, 5, 3, 7, 3, 5]"
一剪梅,中仄平平中仄平。中仄平平，中仄平平。中平中仄仄平平，中仄平平，中仄平平。中仄平平中仄平。中仄平平，中仄平平。中平中仄仄平平，中仄平平，中仄平平。,16,28,16,60,"[7, 4, 4, 7, 4, 4, 7, 4, 4, 7, 4, 4]"
唐多令,平仄仄平平，中平中仄平。仄中平、中仄平平。中仄中平平仄仄，中中仄，仄平平。平仄仄平平，中平中仄平。仄中平、中仄平平。中仄中平平仄仄，中中仄，仄平平。,16,24,20,60,"[5, 5, 3, 4, 7, 3, 3, 5, 5, 3, 4, 7, 3, 3]"
破阵子,仄仄平平中仄，中平中仄平平。中仄中平平仄仄，中仄平平中仄平。中平中仄平。仄仄平平中仄，中平中仄平平。中仄中平平仄仄，中仄平平中仄平。中平中仄平。,18,24,20,62,"[6, 6, 7, 7, 5, 6, 6, 7, 7, 5]"
喝火令,仄仄平平仄，平平仄仄平。仄平平仄仄平平。中仄仄平平仄，中仄仄平平。仄仄平平仄，平平仄仄平。仄平平仄仄平平。仄仄平平，仄仄仄平平。仄仄仄平平仄，中仄仄平平。,3,30,32,65,"[5, 5, 7, 6, 5, 5, 5, 7, 4, 5, 6, 5]"
行香子,中仄平平，中仄平平。中平中、中仄平平。中平中仄，中仄平平。仄中平中，中平仄，中平平。中平中仄，中仄平平。中平中、中仄平平。中平中仄，中仄平平。仄中平ˇ中，中平ˇ仄，仄平ˇ平。,24,27,15,66,"[4, 4, 3, 4, 4, 4, 4, 3, 3, 4, 4, 3, 4, 4, 4, 4, 3, 3]"
风入松,中平中仄仄平平，中仄仄平平。中平中仄平平仄，中平中、中仄平平。中仄平平平仄，中平中仄平平。中平中仄仄平平，中仄仄平平。中平中仄平平仄，中平中、中仄平平。中仄平平平仄，中平中仄平平。,22,34,20,76,"[7, 5, 7, 3, 4, 6, 6, 7, 5, 7, 3, 4, 6, 6]"
金人捧露盘,『仄平平（增韵），平仄仄』，仄平平。仄仄仄、中仄平平。平平仄仄，仄中平平仄仄平平。仄平平仄，仄中平、中仄平平。平平仄，平平仄，平仄仄，仄平平。仄仄仄、中仄平平。平平仄仄，仄中平平仄仄平平。仄平平仄，仄中平、中仄平平。,8,38,35,81,"[3, 3, 3, 3, 4, 4, 8, 4, 3, 4, 3, 3, 3, 3, 3, 4, 4, 8, 4, 3, 4]"
八六子,仄平平，仄平平仄，平平仄仄平平。仄『仄仄平平仄仄，仄平平仄平平』，仄平仄平。平平平仄平平，仄仄仄平平仄，平平仄仄平平。仄仄仄、平平仄平平仄，『仄平平仄，仄平平仄』，平平『仄仄平平仄仄，平平平仄平平』。仄平平，平平去平去平。,0,50,36,86,"[3, 4, 6, 7, 6, 4, 6, 6, 6, 3, 6, 4, 4, 8, 6, 3, 6]"
雪梅香,仄平仄，平平仄仄仄平平。仄平平平仄，平平仄仄平平。中仄平平仄平仄，仄平平仄仄平平。仄平仄，仄仄平平，平仄平平。平平，仄平仄，仄仄平平，仄仄平平。仄仄平平，仄平仄仄平平。中仄平平仄平仄，仄平平仄仄平平。平平仄，仄仄平平，平仄平平。,2,51,41,94,"[3, 7, 5, 6, 7, 7, 3, 4, 4, 2, 3, 4, 4, 4, 6, 7, 7, 3, 4, 4]"
满庭芳,中仄平平，中平中仄，仄中平仄平平。仄平平仄，平仄仄平平。中仄平平仄仄，中中仄、中仄平平。平平仄，中平中仄，中仄仄平平。平平，平仄仄，平平仄仄，中仄平平。仄平仄平平，中仄平平。中仄中平仄仄，中中仄、中仄平平。平平仄，中平中仄，中仄仄平平。,21,40,34,95,"[4, 4, 6, 4, 5, 6, 3, 4, 3, 4, 5, 2, 3, 4, 4, 5, 4, 6, 3, 4, 3, 4, 5]"
水调歌头,中仄仄平仄，中仄仄平平。中平中仄平中，中仄仄平平。中仄平平中仄，中仄平平中仄，中仄仄平平。中仄仄平仄，中仄仄平平。中中中，中中仄，仄平平。中平中仄，平中平仄仄平平。『中仄平平中仄，中仄平平中仄』，中仄仄平平。中仄中平仄，中仄仄平平。,29,32,34,95,"[5, 5, 6, 5, 6, 6, 5, 5, 5, 3, 3, 3, 4, 7, 6, 6, 5, 5, 5]"
凤凰台上忆吹箫,平仄平平，仄平平仄，仄平平仄平平。仄仄平平仄，仄仄平平。平仄平平仄仄，平仄仄、仄仄平平。平平仄，平平仄仄，仄仄平平。平平，仄平仄仄，平仄仄平平，仄仄平平。仄仄平平仄，平仄平平。平仄平平平仄，平仄仄、平仄平平。平平仄，平平仄平，仄仄平平。,0,53,42,95,"[4, 4, 6, 5, 4, 6, 3, 4, 3, 4, 4, 2, 4, 5, 4, 5, 4, 6, 3, 4, 3, 4, 4]"
汉宫春,中仄平平，仄中平中仄，中仄平平。中平中仄，仄中中仄平平。平平仄仄，仄平平、中仄平平。平仄仄、平平中仄，中平中仄平平。中仄中平平仄，仄平平仄仄，中仄平平。平平仄平仄仄，中仄平平。平平仄仄，仄平平、中仄平平。平仄仄、平平中仄，中平中仄平平。,20,43,33,96,"[4, 5, 4, 4, 6, 4, 3, 4, 3, 4, 6, 6, 5, 4, 6, 4, 4, 3, 4, 3, 4, 6]"
八声甘州,仄中平仄仄仄平平，中中仄平平。仄平平中仄，中平中仄，中仄平平。中仄平平中仄，中仄仄平平。中仄平平仄，中仄平平。中仄中平中仄，仄中平中仄，中仄平平。仄平平中仄，中仄仄平平。仄平平、中平平仄，仄中平、中仄仄平平。平平仄、仄平平仄，中仄平平。,24,39,34,97,"[8, 5, 5, 4, 4, 6, 5, 5, 4, 6, 5, 4, 5, 5, 3, 4, 3, 5, 3, 4, 4]"
扬州慢,平仄平平，仄平平仄，仄平仄仄平平。仄平平仄仄，仄仄仄平平。仄平仄、平平仄仄，仄平平仄，平仄平平。仄平平、平仄平平，平仄平平。仄平仄仄，仄平平、平仄平平。仄仄仄平平，平平仄仄，平仄平平。仄仄仄平平仄，平平仄、仄仄平平。仄平平平仄，平平平仄平平。,0,55,43,98,"[4, 4, 6, 5, 5, 3, 4, 4, 4, 3, 4, 4, 4, 3, 4, 5, 4, 4, 6, 3, 4, 5, 6]"
高阳台,中仄平平，平平仄仄，中平中仄平平。中仄平平，中平中仄平平。中平中仄平平仄，仄中平、中仄平平。仄平平（增韵）、中仄平平，中仄平平。平平仄仄平平仄，仄平平中仄，中仄平平。中仄平平，中平中仄平平。中平中仄平平仄，仄中平、中仄平平。仄平平（增韵）、中仄平平，中仄平平。,23,49,28,100,"[4, 4, 6, 4, 6, 7, 3, 4, 3, 4, 4, 7, 5, 4, 4, 6, 7, 3, 4, 3, 4, 4]"
锦堂春慢,平仄平平，平平仄仄，平平仄仄平平。仄仄平平，平仄仄仄平平。仄仄仄平平仄，仄仄平仄平平。仄仄平仄仄，仄仄平平，平仄平平。仄平平平平仄，仄平平仄仄，仄仄平平。平仄平平平仄，仄仄平平。仄仄平平仄仄，仄仄仄、平仄平平。仄仄平平仄仄，平仄平平，仄仄平平。,0,51,50,101,"[4, 4, 6, 4, 6, 6, 6, 5, 4, 4, 6, 5, 4, 6, 4, 6, 3, 4, 6, 4, 4]"
寿楼春,平平平平平。仄平平仄仄，平仄平平。仄仄平平平仄，仄平平平。平仄仄，平平平。仄仄平、平平平平。仄仄仄平平，平平仄仄，平仄仄平平。平平仄，平平平。仄平平仄仄，平仄平平。仄仄平平平仄，仄平平平。平仄仄，平平平。仄仄平、平平平平。仄平仄平平，平平仄仄平仄平。,0,64,37,101,"[5, 5, 4, 6, 4, 3, 3, 3, 4, 5, 4, 5, 3, 3, 5, 4, 6, 4, 3, 3, 3, 4, 5, 7]"
忆旧游,仄平平仄仄，仄仄平平，平仄平平。仄仄平平仄，仄平平仄仄，仄仄平平。仄平仄仄平仄，平仄仄平平。仄仄仄平平，平平仄仄，仄仄平平。平平，仄平仄，仄仄仄平平，平仄平平。仄仄平平仄，仄平平平仄，平仄平平。仄平仄仄平仄，平仄仄平平。仄仄仄平平，平平仄仄平仄平。,0,51,51,102,"[5, 4, 4, 5, 5, 4, 6, 5, 5, 4, 4, 2, 3, 5, 4, 5, 5, 4, 6, 5, 5, 7]"
夜飞鹊,平平仄平仄，平仄平平。平仄仄仄平平。平平仄仄仄平仄，中平平仄平平。平平仄平仄，仄平平平仄，仄仄平平。平平仄仄，仄平平、中仄平平。平仄仄平平仄，平仄仄平平，平仄平平。平仄平平平仄，平平仄仄，平仄平平。仄平仄仄，仄平平、仄仄平平。仄平平平仄，平平仄仄，中仄平平。,3,60,43,106,"[5, 4, 6, 7, 6, 5, 5, 4, 4, 3, 4, 6, 5, 4, 6, 4, 4, 4, 3, 4, 5, 4, 4]"
望海潮,平平平仄，平平中仄，平平仄仄平平。『平仄仄平，平平仄仄』，平平仄仄平平。平仄仄平平。仄平仄平仄，平仄平平。仄仄平平，仄平平仄仄平平。平平（增韵）仄仄平平。仄平平仄仄，中仄平平。『平仄仄平，平平仄仄』，平平仄仄平平。平仄仄平平。仄仄平中仄，平仄平平。中仄平平仄仄，平仄仄平平。,4,59,44,107,"[4, 4, 6, 4, 4, 6, 5, 5, 4, 4, 7, 6, 5, 4, 4, 4, 6, 5, 5, 4, 6, 5]"
沁园春,中仄平平，仄仄平平，仄仄仄平。仄『中平中仄，中平中仄，中平中仄，中仄平平』。中仄平平，中平中仄，中仄平平中仄平。平平仄，仄中平中仄，中仄平平。平平（增韵）中仄平平，仄中仄平平中仄平。仄『中平中仄，中平中仄，中平中仄，中仄平平』。中仄平平，中平中仄，中仄平平中仄平。平平仄，仄中平中仄，中仄平平。,34,44,36,114,"[4, 4, 4, 5, 4, 4, 4, 4, 4, 7, 3, 5, 4, 6, 8, 5, 4, 4, 4, 4, 4, 7, 3, 5, 4]"
多丽,仄平平，中平中仄平平。仄平平、平平仄仄，中中中仄平平。仄平平、中平中仄，中中仄、中仄平平。中仄平平，平平仄仄，仄平平仄仄平平。仄中仄、中平平仄，中仄仄平平。平平仄、中平中仄，中仄平平。仄平平、平平仄仄，仄中平仄平平。仄平平、仄平仄仄，中中中、平仄平平。中仄平平，中平仄仄，中平平仄仄平平。仄中仄、中平中仄，平仄仄平平。平平仄、中平中仄，中仄平平。,30,62,47,139,"[3, 6, 3, 4, 6, 3, 4, 3, 4, 4, 4, 7, 3, 4, 5, 3, 4, 4, 3, 4, 6, 3, 4, 3, 4, 4, 4, 7, 3, 4, 5, 3, 4, 4]"
六州歌头,平平中仄，中仄仄平平。平中仄，平平仄，仄平平。仄平平。中仄中平仄，中平仄，平中仄，中中仄，平中仄，仄平平。中仄中平，中仄平平仄，中仄平平。仄中平中仄，中仄仄平平。中仄平平，仄平平。仄平平仄，中平仄，平中仄，仄平平。中中仄，平中仄，仄平平。仄平平。中仄平平仄，中中仄，仄平平。平中仄，平中仄，仄平平。中仄中平中仄，中平仄、中仄平平。仄中平中仄，中仄仄平平。中仄平平。,37,57,49,143,"[4, 5, 3, 3, 3, 3, 5, 3, 3, 3, 3, 3, 4, 5, 4, 5, 5, 4, 3, 4, 3, 3, 3, 3, 3, 3, 3, 5, 3, 3, 3, 3, 3, 6, 3, 4, 5, 5, 4]"
如梦令,中仄中平平仄，中仄中平平仄。中仄仄平平，中仄仄平平仄。平仄，〖平仄〗，中仄仄平平仄。,7,12,14,33,"[6, 6, 5, 6, 2, 2, 6]"
归自谣,平仄仄，中仄中平平仄仄，中平中仄平平仄。平平中仄平中仄。平平仄，中平中仄平平仄。,8,14,12,34,"[3, 7, 7, 7, 3, 7]"
天仙子,中仄中平平仄仄，仄平平仄平平仄。平平中仄仄平平，平仄仄，仄平仄，仄仄中平平仄仄。,4,14,16,34,"[7, 7, 7, 3, 3, 7]"
生查子,中仄仄平平，中仄平平仄。中仄仄平平，中仄平平仄。中仄仄平平，中仄平平仄。中仄仄平平，中仄平平仄。,8,16,16,40,"[5, 5, 5, 5, 5, 5, 5, 5]"
醉花间,平平仄，仄平〖仄〗，平仄平平仄。平仄仄平平，仄仄平平仄。平平平仄仄，仄仄平平仄。平平仄仄平，平仄平平仄。,0,22,19,41,"[3, 3, 5, 5, 5, 5, 5, 5, 5]"
点绛唇,中仄平平，中平中仄（增韵）平平仄。仄平平仄，中仄平平仄。中仄平平，中仄平平仄。平中仄，仄平平仄，中仄平平仄。,8,18,15,41,"[4, 7, 4, 5, 4, 5, 3, 4, 5]"
霜天晓角,中平中仄，中仄平平仄。平仄仄平平仄，中中仄、平平仄。中平平仄仄，中平平仄仄。平仄仄平平仄，中中仄、平平仄。,9,17,17,43,"[4, 5, 6, 3, 3, 5, 5, 6, 3, 3]"
伤春怨,仄仄平平仄。仄仄平平平仄。仄仄仄平平，仄仄平平平仄。仄平平平仄。仄仄平平仄。仄仄仄平平，仄仄仄、平平仄。,0,19,24,43,"[5, 6, 5, 6, 5, 5, 5, 3, 3]"
卜算子,中仄仄平平，中仄平平仄。中仄平平仄仄平，中仄平平仄。中仄仄平平，中仄平平仄。中仄平平仄仄平，中仄平平仄。,8,18,18,44,"[5, 5, 7, 5, 5, 5, 7, 5]"
谒金门,平中仄，平仄仄平平仄。中仄中平平仄仄，仄平平仄仄。中仄中平中仄，中仄中平平仄。中仄中平平仄仄，仄平平仄仄。,10,15,20,45,"[3, 6, 7, 5, 6, 6, 7, 5]"
好事近,中仄仄平平，中仄仄平平仄。中仄仄平平仄，仄中平平仄。中平中仄仄平平，中中仄平仄。中仄仄平平仄，仄中平平仄。,10,16,19,45,"[5, 6, 6, 5, 7, 5, 6, 5]"
忆少年,平平中仄，平平仄仄，平平平仄。平平仄中仄，仄平平平仄。仄仄平平平仄仄，仄平平、仄平平仄。平平仄平仄，仄平平中仄。,3,24,19,46,"[4, 4, 4, 5, 5, 7, 3, 4, 5, 5]"
忆秦娥,平中仄，中平中仄平平仄。〖平平仄〗，中平中仄，仄平平仄。中平中仄平平仄，中平中仄平平仄。〖平平仄〗，中平中仄，仄平平仄。,11,20,15,46,"[3, 7, 3, 4, 4, 7, 7, 3, 4, 4]"
烛影摇红,仄仄平平，仄仄平，仄仄平、平平仄。平平平仄仄平平，平仄平平仄。平仄平平仄仄，仄平平、平平仄仄。仄平平仄，仄仄平平，平平平仄。,0,28,22,50,"[4, 3, 3, 3, 7, 5, 6, 3, 4, 4, 4, 4]"
醉花阴,中仄中平平仄仄，中仄平平仄。中仄仄平平，中仄平平，中仄平平仄。中平中仄平平仄，仄仄平平仄。中仄仄平平，中仄平平，中仄平平仄。,11,21,20,52,"[7, 5, 5, 4, 5, 7, 5, 5, 4, 5]"
望江东,平仄平平仄平仄，仄中仄、平平仄。中平中仄仄平仄，仄仄仄、平平仄。平平仄仄平平仄，仄中仄、平平仄。中平中仄仄平仄，仄中仄、平平仄。,7,20,25,52,"[7, 3, 3, 7, 3, 3, 7, 3, 3, 7, 3, 3]"
木兰花,仄仄仄平平仄仄，平仄仄平平仄仄。平仄仄，仄平平，仄仄仄平平仄仄。仄仄仄平平仄仄，平仄仄平平仄仄。平平仄仄仄平平，平仄仄平平仄仄。,0,22,33,55,"[7, 7, 3, 3, 7, 7, 7, 7, 7]"
鹊桥仙,中平中仄（增韵），中平中仄（增韵），中仄中平中仄。中平中仄仄平平，仄中仄、平平中仄。中平中仄（增韵），中平中仄（增韵），中仄中平中仄。中平中仄仄平平，仄中仄、平平中仄。,22,16,18,56,"[4, 4, 6, 7, 3, 4, 4, 4, 6, 7, 3, 4]"
夜游宫,仄仄平平仄仄，仄中仄、中平平仄。中仄平平仄中仄。仄平平，仄平平，平仄仄。仄仄平平仄，仄中仄、中平平仄。中仄平平仄中仄。仄平平，仄平平，平仄仄。,8,22,27,57,"[6, 3, 4, 7, 3, 3, 3, 5, 3, 4, 7, 3, 3, 3]"
踏莎行,『中仄平平，中平中仄』，中平中仄平平仄。中平中仄仄平平，中平中仄平平仄。『中仄平平，中平中仄』，中平中仄平平仄。中平中仄仄平平，中平中仄平平仄。,18,24,16,58,"[4, 4, 7, 7, 7, 4, 4, 7, 7, 7]"
钗头凤,平平仄，平平仄，仄平平仄平平仄。平平仄，平平仄，中平平仄，仄平平仄。仄，〖仄〗，〖仄〗。平平仄，平平仄，仄平平仄平平仄。平平仄，平平仄，中平平仄，仄平平仄。仄，〖仄〗，〖仄〗。,2,32,26,60,"[3, 3, 7, 3, 3, 4, 4, 1, 1, 1, 3, 3, 7, 3, 3, 4, 4, 1, 1, 1]"
蝶恋花,中仄中平平仄仄。中仄平平，中仄平平仄。中仄中平平仄仄，中平中仄平平仄。中仄中平平仄仄。中仄平平，中仄平平仄。中仄中平平仄仄，中平中仄平平仄。,16,22,22,60,"[7, 4, 5, 7, 7, 7, 4, 5, 7, 7]"
渔家傲,中仄中平平仄仄，中平中仄平平仄。中仄中平平仄仄。平中仄，中平中仄平平仄。中仄中平平仄仄，中平中仄平平仄。中仄中平平仄仄。平中仄，中平中仄平平仄。,18,22,22,62,"[7, 7, 7, 3, 7, 7, 7, 7, 3, 7]"
苏幕遮,仄平平，平仄仄。中仄平平，中仄平平仄。中仄平平平仄仄。中仄平平，中仄平平仄。仄平平，平仄仄。中仄平平，中仄平平仄。中仄平平平仄仄。中仄平平，中仄平平仄。,10,28,24,62,"[3, 3, 4, 5, 7, 4, 5, 3, 3, 4, 5, 7, 4, 5]"
淡黄柳,平平仄仄，平仄平平仄。仄仄平平平仄仄。仄仄平平仄仄，平仄平平仄平仄。仄平仄，平平仄平仄。仄平仄，仄平仄。仄平平仄仄平平仄。仄仄平平，仄平平仄，平仄平平仄仄。,0,31,34,65,"[4, 5, 7, 6, 7, 3, 5, 3, 3, 8, 4, 4, 6]"
锦缠道,仄仄平平，仄仄仄平平仄。仄平平、仄平平仄。仄平平仄平平仄。仄仄平平，仄仄平平仄。仄平平仄平，仄平平仄。仄平平、仄平平仄。仄平平、平仄平平，仄仄平平仄，仄仄平平仄。,0,34,32,66,"[4, 6, 3, 4, 7, 4, 5, 5, 4, 3, 4, 3, 4, 5, 5]"
酷相思,仄仄平平平仄仄。仄中仄、平平仄。仄平仄平平平仄仄。中仄仄、平平仄。〖中仄仄、平平仄〗。仄仄平平平仄仄。仄中仄、平平仄。仄平仄平平平仄仄。中仄仄、平平仄。〖中仄仄、平平仄〗。,6,26,34,66,"[7, 3, 3, 8, 3, 3, 3, 3, 7, 3, 3, 8, 3, 3, 3, 3]"
解佩令,平平中仄，平平中仄，仄平平、平平平仄。仄仄平平，仄仄中、中平平仄。仄平平、仄平仄仄。平平中仄，平平中仄，仄平平、平平平仄。仄仄平平，仄仄中、中平平仄。仄平平、仄平仄仄。,8,32,26,66,"[4, 4, 3, 4, 4, 3, 4, 3, 4, 4, 4, 3, 4, 4, 3, 4, 3, 4]"
青玉案,中平中仄平平仄，仄中仄、平平仄。仄仄平平平仄仄。中平平仄，中平中仄，中仄平平仄。中平中仄平平仄，中仄平平仄平仄。仄仄平平平仄仄。中平平仄，中平中仄，中仄平平仄。,14,27,26,67,"[7, 3, 3, 7, 4, 4, 5, 7, 7, 7, 4, 4, 5]"
千秋岁,仄平平仄，平仄平平仄。平仄仄，平平仄。平平平仄仄，平仄平平仄。平仄仄，仄平仄仄平平仄。仄仄平平仄，平仄平平仄。平仄仄，平平仄。仄平平仄仄，仄仄平平仄。平仄仄，仄平仄仄平平仄。,0,34,37,71,"[4, 5, 3, 3, 5, 5, 3, 7, 5, 5, 3, 3, 5, 5, 3, 7]"
离亭燕,中仄中平平仄，平仄仄平平仄。中仄仄平平仄仄，仄仄中平平仄。仄仄仄平平，中仄中平平仄。中仄中平平仄，平仄仄平平仄。中仄仄平平仄仄，仄仄中平平仄。仄仄仄平平，中仄中平平仄。,12,26,34,72,"[6, 6, 7, 6, 5, 6, 6, 6, 7, 6, 5, 6]"
粉蝶儿,仄仄平平仄平仄平仄仄，仄平平、仄平平仄。仄平平、仄仄仄、仄平平仄。仄平平、平仄仄平平仄。平平平仄平仄仄仄平仄。仄平平、仄平平仄。仄平平、平仄仄、仄平平仄。仄平平、平仄仄平平仄。,0,36,36,72,"[10, 3, 4, 3, 3, 4, 3, 6, 10, 3, 4, 3, 3, 4, 3, 6]"
御街行,平平仄仄平平仄。仄仄仄、平平仄。平平平仄仄平平，平仄平平平仄。平平中仄，中平平仄，平仄平平仄。平平仄仄平平仄。仄仄仄、平平仄。平平平仄仄平平，平仄平平平仄。平平中仄，中平平仄，平仄ˇ平平仄。,4,44,30,78,"[7, 3, 3, 7, 6, 4, 4, 5, 7, 3, 3, 7, 6, 4, 4, 5]"
祝英台近,仄平平，平仄仄，平仄仄平仄。中仄平平，中仄仄平仄。中平中仄平平，中平中仄，仄中仄、中平平仄。仄平仄，中中平仄平平，中平仄平仄。中仄平平，中中仄平仄。中平中仄平平，中平中仄，仄中仄、中平平仄。,20,29,28,77,"[3, 3, 5, 4, 5, 6, 4, 3, 4, 3, 6, 5, 4, 5, 6, 4, 3, 4]"
蓦山溪,平平中仄，中仄平平仄。中仄仄平平，仄中中、平平中仄。仄平平仄，中仄仄平平，平仄仄。平仄仄，中仄平平仄。平平中仄，中仄平平仄。中仄仄平平，仄中中、平平中仄。仄平平仄，中仄仄平平，平仄仄，平仄仄。中仄平平仄。,16,32,34,82,"[4, 5, 5, 3, 4, 4, 5, 3, 3, 5, 4, 5, 5, 3, 4, 4, 5, 3, 3, 5]"
洞仙歌,中平中仄，仄中平平仄。中仄平平仄平仄。仄平平、中仄平仄平平，平中仄、中仄平平中仄。中平平仄仄，中仄平平，中仄平平仄平仄。仄仄仄平平，仄仄平平，平中仄、中平中仄。仄中仄平平仄平平，仄仄仄平平，仄平平仄。,15,35,33,83,"[4, 5, 7, 3, 6, 3, 6, 5, 4, 7, 5, 4, 3, 4, 8, 5, 4]"
惜红衣,仄仄平平，平平仄仄，仄平平仄。仄仄平平，平平仄平仄。平平仄仄，平仄仄、平平平仄。平仄。平仄仄平，仄平平平仄。平平仄仄，平仄平平，平平仄平仄。平平仄仄仄仄，仄平仄。仄仄仄平平仄，仄仄仄平平仄。仄仄平平仄，平仄仄平平仄。,0,43,45,88,"[4, 4, 4, 4, 5, 4, 3, 4, 2, 4, 5, 4, 4, 5, 6, 3, 6, 6, 5, 6]"
法曲献仙音,平仄平平，仄平平仄，仄仄平平平仄。仄仄平平，仄平平仄，平平仄仄平仄。仄仄仄平平仄，平平仄平仄。仄平仄，仄平平、仄平平仄。平仄仄、平仄仄平平仄。仄仄仄平平，仄平平、平仄平仄。仄仄平平，仄平平、仄仄仄仄。仄平平平仄，仄仄平平平仄。,0,45,47,92,"[4, 4, 6, 4, 4, 6, 6, 5, 3, 3, 4, 3, 6, 5, 3, 4, 4, 3, 4, 5, 6]"
满江红,中仄平平，平中仄、中平中仄。平仄仄、仄平平仄，仄平中仄。中仄中平平仄仄，中平中仄平平仄。中中中、中仄仄平平，平平仄。中中仄，平仄仄。平仄仄，平平仄。仄平平中仄，仄平平仄。中仄中平平仄仄，中平中仄平平仄。中中中、中仄仄平平，平平仄。,24,34,35,93,"[4, 3, 4, 3, 4, 4, 7, 7, 3, 5, 3, 3, 3, 3, 3, 5, 4, 7, 7, 3, 5, 3]"
天香,中仄平平，平平仄仄，仄仄平平平仄。仄仄平平，平平中仄，仄仄平平平仄。仄平平仄，平仄仄、仄平平仄。平仄平平仄仄，平平仄平平仄。平平仄平仄仄。仄平平、仄平平仄。平仄平平仄仄，仄平平仄。平仄平平仄仄。仄平仄、平平仄平仄。仄仄平平，平平仄仄。,2,49,45,96,"[4, 4, 6, 4, 4, 6, 4, 3, 4, 6, 6, 6, 3, 4, 6, 4, 6, 3, 5, 4, 4]"
声声慢,平平仄仄，仄仄平平，平平仄仄仄仄。仄仄平平平仄，仄平平仄。平平仄仄仄仄，仄仄平、仄平平仄。仄仄仄，仄平平、仄仄仄平平仄。仄仄平平平仄，平仄仄、平平仄平平仄。仄仄平平，仄仄仄平仄仄。平平仄平仄仄，仄平平、仄仄仄仄。仄仄仄，仄仄仄平仄仄仄。,0,37,60,97,"[4, 4, 6, 6, 4, 6, 3, 4, 3, 3, 6, 6, 3, 6, 4, 6, 6, 3, 4, 3, 7]"
黄莺儿,平平平仄平平仄。仄仄平平，平仄平平，平平平平，仄平平仄。平仄仄仄平平，仄仄平平仄。仄平平仄平平，仄仄平平平仄平仄。平仄，仄仄仄平平，仄仄平平仄。仄平平仄，仄仄平平，平平仄平平仄。平仄仄仄平平，仄仄平平仄。仄仄仄仄平平，平仄平平仄。,0,52,44,96,"[7, 4, 4, 4, 4, 6, 5, 6, 8, 2, 5, 5, 4, 4, 6, 6, 5, 6, 5]"
剑器近,仄平仄，仄仄仄、平平平仄。仄平仄平平仄，仄平仄。仄平仄，仄仄仄、平平仄仄。平平仄平平仄，仄平仄。平仄，仄平平仄仄。平平仄仄，仄仄仄、仄仄平平仄。平平平仄仄平平，仄平平仄平，仄平平仄平仄。仄平平仄，仄仄平平，仄仄平平仄仄。仄平仄仄平平仄。,0,43,53,96,"[3, 3, 4, 6, 3, 3, 3, 4, 6, 3, 2, 5, 4, 3, 5, 7, 5, 6, 4, 4, 6, 7]"
醉蓬莱,仄平平仄仄，仄仄平平，仄平平仄。仄仄平平，仄平平平仄。仄仄平平，仄平平仄，仄仄平平仄。仄仄平平，平平仄仄，仄平平仄。仄仄平平，仄平平仄，仄仄平平，仄平平仄。平仄平平，仄仄平平仄。仄仄平平，仄仄平仄，仄仄平平仄。仄仄平平，平平平仄，仄平平仄。,0,48,49,97,"[5, 4, 4, 4, 5, 4, 4, 5, 4, 4, 4, 4, 4, 4, 4, 4, 5, 4, 4, 5, 4, 4, 4]"
暗香,仄平仄仄，仄仄平仄仄，平平平仄。仄仄仄平，仄仄平平仄平仄。平仄平平仄仄，平仄仄、平平平仄。仄仄仄、仄仄平平，平仄仄平仄。平仄，仄仄仄。仄仄仄仄平，仄仄平仄。仄平仄仄，平仄平平仄平仄。平仄平平仄仄，平仄仄、平平平仄。仄仄仄、平仄仄，仄平仄仄。,0,37,60,97,"[4, 5, 4, 4, 7, 6, 3, 4, 3, 4, 5, 2, 3, 5, 4, 4, 7, 6, 3, 4, 3, 3, 4]"
长亭怨慢,去平仄、平平平仄。仄仄平平，仄平平仄。『仄仄平平，仄平平仄』，去平仄。仄平平仄，平仄仄、平平仄。仄仄仄平平，仄仄仄、平平平仄。仄仄，去平平仄仄，仄仄仄平平仄。平平仄仄，仄仄仄、仄平平仄。仄仄仄、仄仄平平，去平仄、平平平仄。去仄仄平平，平仄平平平仄。,0,43,49,92,"[3, 4, 4, 4, 4, 4, 3, 4, 3, 3, 5, 3, 4, 2, 5, 6, 4, 3, 4, 3, 4, 3, 4, 5, 6]"
双双燕,仄平仄仄，仄平仄平平，仄平平仄。平平仄仄，仄仄仄平平仄。平仄平平仄仄，仄仄仄、平平仄仄。平平仄仄平平，仄仄平平平仄。平仄，平平仄仄。仄仄仄平平，仄平平仄。平平平仄，仄仄仄平平仄。平仄平平仄仄，仄仄仄、平平平仄。平仄仄仄平平，仄仄仄平仄仄。,0,44,54,98,"[4, 5, 4, 4, 6, 6, 3, 4, 6, 6, 2, 4, 5, 4, 4, 6, 6, 3, 4, 6, 6]"
宴山亭,中仄平平，平仄仄平，仄仄平平平仄。平仄仄平，仄仄平平，中仄仄平平仄。仄仄平平，仄平仄、中平平仄。平仄，仄仄仄平平，仄平平仄。平仄平仄平平，仄中仄平平，仄平平仄。平平仄仄，仄仄平平，平平仄平平仄。仄仄平平，中中仄、中平平仄。平仄，平仄仄、平平仄仄。,7,47,45,99,"[4, 4, 6, 4, 4, 6, 4, 3, 4, 2, 5, 4, 6, 5, 4, 4, 4, 6, 4, 3, 4, 2, 3, 4]"
念奴娇,中平中仄，仄平中中仄，中平平仄。中仄中平平仄仄，中仄中平平仄。中仄平平，中平中仄，中仄平平仄。中平中仄，仄平平仄中仄。中仄中仄平平，中平中仄，中仄平平仄。中仄中平平仄仄，中仄中平平仄。中仄平平，中平中仄，中仄平平仄。中平平仄，仄平平仄平仄。,30,35,35,100,"[4, 5, 4, 7, 6, 4, 4, 5, 4, 6, 6, 4, 5, 7, 6, 4, 4, 5, 4, 6]"
绕佛阁,仄平仄仄，平仄仄仄，平仄平仄。平仄平仄，仄平仄仄平平仄平仄。仄平仄仄，平仄仄仄，平仄平仄。平仄平仄。仄平仄仄平平仄平仄。仄仄仄平仄，仄仄平平平仄仄。平仄仄平平平平仄仄。仄仄仄平平，平仄平仄。仄平平仄。仄仄仄平平，平仄平仄。仄平平、仄平平仄。,0,43,57,100,"[4, 4, 4, 4, 9, 4, 4, 4, 4, 9, 5, 7, 9, 5, 4, 4, 5, 4, 3, 4]"
绛都春,平平仄仄。仄仄仄仄平，平平平仄。仄仄仄平，平仄平平平平仄。中平中仄平平仄，仄中仄、平平平仄。仄平中仄，平平仄仄，仄平平仄。平仄，平平仄仄，仄平仄、仄仄平平平仄。仄仄仄平，中仄平平平平仄，中平平仄平平仄。仄中仄、中平中仄。仄平中仄平平，仄平仄仄。,10,44,46,100,"[4, 5, 4, 4, 7, 7, 3, 4, 4, 4, 4, 2, 4, 3, 6, 4, 7, 7, 3, 4, 6, 4]"
桂枝香,平平仄仄，仄仄仄中平，中中平仄。中仄平平中仄，仄平平仄。中平中仄平平仄，仄平平、中平平仄。仄平平仄，中平中仄，仄平平仄。仄中中、平平仄仄。仄中中平中，中中平仄。中仄平平中仄，仄平平仄。中平中仄平平仄，仄平平中仄平仄。仄平平仄，中平中仄，仄平平仄。,24,39,38,101,"[4, 5, 4, 6, 4, 7, 3, 4, 4, 4, 4, 3, 4, 5, 4, 6, 4, 7, 7, 4, 4, 4]"
翠楼吟,仄仄平平，平平仄仄，平平仄仄平仄。平平平仄仄，仄平仄平平平仄。平平平仄。仄仄仄平平，平平平仄。平平仄，仄平平仄，仄平平仄。仄仄，平仄平平，仄仄平平仄，仄平平仄。仄平平仄仄，仄平仄平平平仄。平平平仄。仄仄仄平平，平平平仄。平平仄，仄平平仄，仄平平仄。,0,55,46,101,"[4, 4, 6, 5, 7, 4, 5, 4, 3, 4, 4, 2, 4, 5, 4, 5, 7, 4, 5, 4, 3, 4, 4]"
霓裳中序第一,平平仄仄仄。仄仄平平平仄仄。平仄仄平仄仄。仄平仄仄平，平平平仄。平平仄仄，仄仄平平仄平仄。平平仄，仄平仄仄，仄仄仄平仄。平仄，仄平平仄。仄仄仄平平仄仄。平平平仄仄仄，仄仄平平，仄仄平仄。仄平平仄仄，仄仄仄平平仄仄。平平仄，平平平仄，仄仄仄平仄。,0,42,59,101,"[5, 7, 6, 5, 4, 4, 7, 3, 4, 5, 2, 4, 7, 6, 4, 4, 5, 7, 3, 4, 5]"
水龙吟,仄平中仄平平，中平中仄平平仄。中平仄仄，中平中仄，中平中仄。中仄平平，中平中仄，中平平仄。仄中平中仄，中平中仄，中平仄，平平仄。中仄中平中仄（增韵），仄平平、中平平仄。中平中仄，中平平仄，中平平仄。中仄平平，中平中仄，中平平仄。仄平平仄仄，中平中仄，仄平平仄。,31,39,32,102,"[6, 7, 4, 4, 4, 4, 4, 4, 5, 4, 3, 3, 6, 3, 4, 4, 4, 4, 4, 4, 4, 5, 4, 4]"
石州慢,中仄平平，平仄仄平，平仄平仄。平平中仄平平，仄仄中平平仄。中平中仄，仄中中仄平平，中平中仄平平仄。中仄仄平平，仄平平平仄。平仄，中平平仄，中仄平平，仄平平仄。中仄平平，仄仄平平平仄。中平中仄，仄中中仄平平，中平中仄平平仄。中仄仄平平，仄平平平仄。,20,46,36,102,"[4, 4, 4, 6, 6, 4, 6, 7, 5, 5, 2, 4, 4, 4, 4, 6, 4, 6, 7, 5, 5]"
瑞鹤仙,仄平平仄仄，平仄仄、仄仄平平仄仄。平平仄平仄，仄平平平仄，平平平仄。平平仄仄，仄仄平、平仄仄仄。仄平平仄仄，平仄仄平，仄仄平仄。仄仄平平仄仄，仄仄平平，仄平平仄。平平仄仄，平平仄，仄平仄。仄平平仄仄，平平平仄，平平平仄仄仄。仄平平仄仄，平仄仄平仄仄。,0,46,56,102,"[5, 3, 6, 5, 5, 4, 4, 3, 4, 5, 4, 4, 6, 4, 4, 4, 3, 3, 5, 4, 6, 5, 6]"
宴清都,仄仄平平仄。平平仄、仄平平仄平仄。平平平仄，平平仄仄，仄平平仄。平平仄仄平平，仄仄仄、平平仄仄。仄仄仄、仄仄平平，平平仄仄平仄。平平仄仄平平，平平仄仄，平仄平仄。平平仄仄，平平仄仄，仄平平仄。平平仄平平仄，仄仄仄、平平仄仄。仄仄平、仄仄平平，平平仄仄。,0,50,52,102,"[5, 3, 6, 4, 4, 4, 6, 3, 4, 3, 4, 6, 6, 4, 4, 4, 4, 4, 6, 3, 4, 3, 4, 4]"
齐天乐,仄平平仄平平仄（增韵），平平仄平平仄。仄仄平平，平平仄仄，平仄平平平仄。平平仄仄。仄平仄平平，仄平平仄。仄仄平平，仄平中仄仄平仄。平平仄平仄仄（增韵），仄平平仄仄，平仄平仄。仄仄平平，平平仄仄，中仄平平中仄。平平仄仄。仄中仄平平，仄平平仄。仄仄平平，仄平平仄仄。,4,50,48,102,"[7, 6, 4, 4, 6, 4, 5, 4, 4, 7, 6, 5, 4, 4, 4, 6, 4, 5, 4, 4, 5]"
雨霖铃,平平平仄。仄平平仄，仄仄平仄。平平仄仄平仄，平平仄仄，平平平仄。仄仄平平仄仄，仄平仄平仄。仄仄仄、平仄平平，仄仄平平仄平仄。平平仄仄平平仄，仄平平、仄仄平平仄。平平仄仄平仄，平仄仄、仄平平仄。仄仄平平，平仄、平平仄仄平仄。仄仄仄、平仄平平，仄仄平平仄。,0,49,54,103,"[4, 4, 4, 6, 4, 4, 6, 5, 3, 4, 7, 7, 3, 5, 6, 3, 4, 4, 2, 6, 3, 4, 5]"
眉妩,仄平平平仄，仄仄平平，平仄仄平仄。仄仄平平仄，平平仄，平平平仄平仄。仄平仄仄，仄仄平、平仄平仄。仄平仄、仄仄平平仄，仄平仄平仄。平仄平平平仄。仄仄平中仄，平仄平仄。中仄平平仄，平平仄、平平平仄平仄。仄平仄仄，仄仄平、平仄平仄。仄平仄平平，平仄仄平仄仄。,2,48,53,103,"[5, 4, 5, 5, 3, 6, 4, 3, 4, 3, 5, 5, 6, 5, 4, 5, 3, 6, 4, 3, 4, 5, 6]"
永遇乐,平仄平平，中平平仄，平仄平仄。仄仄平平，平平仄仄，仄仄平平仄。中平中仄，平平仄仄，中仄仄平平仄。仄平平、平平中仄，仄平中中平仄。平平仄仄，平平平仄，中仄中平中仄。仄仄平平，中平平仄，平仄平平仄。仄平平仄，中平中仄，中仄中平中仄。中平仄、平平仄仄，仄平仄仄。,17,45,42,104,"[4, 4, 4, 4, 4, 5, 4, 4, 6, 3, 4, 6, 4, 4, 6, 4, 4, 5, 4, 4, 6, 3, 4, 4]"
二郎神,平平仄，仄仄仄、平平平仄。仄仄仄平平平仄仄，平平仄、仄平平仄。平仄平平平仄仄，仄仄仄、平平仄仄。仄仄仄、平平仄仄，仄仄平平平仄。平仄，平平仄仄，仄平平仄。仄仄仄平平平仄仄，平仄仄、平平平仄。仄仄平平平仄仄，仄平仄、平平仄仄。仄平仄平平，仄仄平平，平平平仄。,0,49,55,104,"[3, 3, 4, 8, 3, 4, 7, 3, 4, 3, 4, 6, 2, 4, 4, 8, 3, 4, 7, 3, 4, 5, 4, 4]"
拜星月慢,仄仄平平，平平平仄，仄仄平平仄仄。仄仄平平，仄平平平仄。仄平仄，仄仄、平平仄仄平仄，仄仄平平平仄。仄仄平平，仄平平平仄。仄平平、仄仄平平仄。平平仄、仄仄平平仄，仄仄仄仄平平，仄平平平仄。仄平平、仄仄平平仄，平平仄、仄仄平平仄。仄仄仄、仄仄平平，仄平平仄仄。,0,49,55,104,"[4, 4, 6, 4, 5, 3, 2, 6, 6, 4, 5, 3, 5, 3, 5, 6, 5, 3, 5, 3, 5, 3, 4, 5]"
西河,平仄仄，平平仄仄平仄。平平仄仄仄平平，仄平仄仄。仄平仄仄仄平平，平平平仄平仄。仄平仄，平仄仄，仄平仄仄平仄。平平仄仄仄平平，仄平仄仄。仄平仄仄仄平平，平平平仄平仄。仄平仄仄仄仄仄。仄平平、平仄平仄。仄仄仄平平仄，仄平平仄仄平平平仄。平仄平平平平仄。,0,49,56,105,"[3, 6, 7, 4, 7, 6, 3, 3, 6, 7, 4, 7, 6, 7, 3, 4, 6, 9, 7]"
西吴曲,仄平平仄仄平仄，仄平平仄仄仄平仄。仄平平仄仄，平平平仄平仄。仄仄平平，平仄仄平平平仄。仄仄仄平仄平平，仄仄仄仄平平仄。仄平平仄，平仄仄平平，平平仄平仄仄。仄仄仄。仄平平仄平平，平平平仄，仄仄平平仄仄。平平平仄，仄仄仄仄平平，平仄仄平平，平仄仄平仄。,0,50,55,105,"[7, 8, 5, 6, 4, 7, 7, 7, 4, 5, 6, 3, 6, 4, 6, 4, 6, 5, 5]"
望远行,平平仄仄，平平仄、仄仄平平平仄。仄平平仄，仄仄平平，仄仄仄平平仄。仄仄平平，平仄仄平平仄，平仄仄平平仄。仄平平、平仄平平仄仄。平仄，平仄仄平仄仄，仄仄仄、仄平平仄。仄仄仄平，仄平仄仄，平仄仄平平仄。平仄平平平仄，平平平仄，仄仄平平平仄。仄仄平平仄，平平平仄。,0,51,55,106,"[4, 3, 6, 4, 4, 6, 4, 6, 6, 3, 6, 2, 6, 3, 4, 4, 4, 6, 6, 4, 6, 5, 4]"
疏影,平平仄仄。仄仄平仄仄，平仄平仄。仄仄平平，平仄平平，平平仄仄平仄。平平仄仄平平仄，仄仄仄、平平平仄。仄仄平、仄仄平平，仄仄仄平平仄。平仄平平仄仄，仄平仄仄仄，平仄平仄。仄仄平平，仄仄平平，仄仄平平平仄。平平仄仄平平仄，仄仄仄、仄平平仄。仄仄平、平仄平平，仄仄仄平平仄。,0,50,60,110,"[4, 5, 4, 4, 4, 6, 7, 3, 4, 3, 4, 6, 6, 5, 4, 4, 4, 6, 7, 3, 4, 3, 4, 6]"
摸鱼儿,仄平平、仄平平仄，平平平仄平仄。中平平仄平平仄，平仄仄平平仄。平仄仄，仄中仄、中平中仄平平仄。中平中仄。仄仄仄平平，中平中仄，中仄仄平仄。平平仄，中仄平平仄仄，平平平仄平仄。中平中仄平平仄，中仄中平平仄。平仄仄，仄中仄、中平中仄平平仄。中平中仄。仄仄仄平平，中平中仄，中仄仄平仄。,22,46,48,116,"[3, 4, 6, 7, 6, 3, 3, 7, 4, 5, 4, 5, 3, 6, 6, 7, 6, 3, 3, 7, 4, 5, 4, 5]"
贺新郎,中仄平平仄。仄平平、中平中仄，仄平平仄。中仄中平平中仄，中仄平平中仄。中仄仄、平平中仄。中仄中平平中仄，仄中平中仄平平仄。中仄仄，仄平仄。中平中仄平平仄。仄平平、中平中仄，仄平平仄。中仄中平平中仄，中仄平平中仄。中仄仄、平平中仄。中仄中平平中仄，仄中平中仄平平仄。中仄仄，仄平仄。,33,39,44,116,"[5, 3, 4, 4, 7, 6, 3, 4, 7, 8, 3, 3, 7, 3, 4, 4, 7, 6, 3, 4, 7, 8, 3, 3]"
兰陵王,仄平仄，平仄平平仄仄。平平仄，平仄仄平，仄仄平平仄平仄。平平仄仄仄。平仄，平平仄仄。平平仄，平仄仄平，平仄平平仄平仄。平平仄平仄。仄仄仄平平，平仄平仄。平平平仄平平仄。平仄仄平仄，仄平平仄，平平平仄仄仄仄，仄平仄平仄。平仄，仄平仄。仄仄仄平平，平仄平仄。平平仄仄平平仄。仄仄仄平仄，仄平平仄。平平平仄，仄仄仄，仄仄仄。,0,61,69,130,"[3, 6, 3, 4, 7, 5, 2, 4, 3, 4, 7, 5, 5, 4, 7, 5, 4, 7, 5, 2, 3, 5, 4, 7, 5, 4, 4, 3, 3]"
六丑,仄平平仄仄，仄仄仄、平平平仄。仄平仄平，平平平仄仄。仄仄平仄。仄仄平平仄，仄平平仄，去仄平平仄。平平仄仄平平仄。仄仄平平，平平仄仄。平平仄平平仄。仄平平仄仄，平仄平仄。平平平仄。去平平仄仄。仄仄平平仄，平仄仄。平平仄仄平仄。仄平平仄仄，仄平平仄。平平仄、仄平平仄。平仄仄、仄仄平平仄仄，仄平平仄。平平仄、仄仄平仄。仄仄平、仄仄平平仄，平平仄仄。,0,65,73,138,"[5, 3, 4, 4, 5, 4, 5, 4, 5, 7, 4, 4, 6, 5, 4, 4, 5, 5, 3, 6, 5, 4, 3, 4, 3, 6, 4, 3, 4, 3, 5, 4]"
夜半乐,仄平仄仄平仄，平平仄仄，平仄平平仄。仄仄仄平平，仄平平仄。仄平仄仄，平平仄仄，仄平平仄平平，仄平平仄。仄仄仄、平平仄平仄。仄平仄仄仄仄，仄仄平平，仄平平仄。平仄仄、平平平平平仄。仄平平仄，平平仄仄，仄平仄仄平平，仄平平仄。仄平仄、平平仄平仄。仄仄平仄，仄仄平平，仄平平仄。仄仄仄平平仄平仄。仄平平、平仄仄仄平平仄。平仄仄、仄仄平平仄。仄平平仄平平仄。,0,67,77,144,"[6, 4, 5, 5, 4, 4, 4, 6, 4, 3, 5, 6, 4, 4, 3, 6, 4, 4, 6, 4, 3, 5, 4, 4, 4, 8, 3, 7, 3, 5, 7]"
宝鼎现,仄平平仄，仄仄平仄，平平平仄。平仄仄、平平平仄，平仄平平平仄仄。仄仄仄、仄平平平仄，平仄平平仄仄。仄仄仄、平平仄仄，仄仄平平平仄。仄仄平仄平平仄。仄平平、平仄平仄。平仄仄、平平仄仄，平仄平平平仄仄。仄仄仄、仄平平平仄，平仄平平仄仄。仄仄仄、平平仄仄，仄仄平平仄仄。平仄仄仄平平，平仄仄平平平仄。仄平平平仄，平仄平平仄仄。仄仄仄、仄平平仄。仄仄平平仄。仄仄仄、平仄平平，仄仄平平仄仄。,0,71,86,157,"[4, 4, 4, 3, 4, 7, 3, 5, 6, 3, 4, 6, 7, 3, 4, 3, 4, 7, 3, 5, 6, 3, 4, 6, 6, 7, 5, 6, 3, 4, 5, 3, 4, 6]"
莺啼序,平平仄平仄仄，仄平平仄仄。仄平仄、平仄平平，仄仄平仄平仄。仄平仄、平平仄仄，平平仄仄平平仄。仄平平，平仄平平，仄平平仄。仄仄平平，仄仄仄仄，仄平平仄仄。仄平仄、平仄平平，仄平平仄平仄。仄平平、平平仄仄，仄平仄、平平平仄。仄平平，平仄平平，仄平平仄。平平仄仄，仄仄平平，仄平仄仄仄。仄仄仄、仄平平仄，仄仄平平，仄仄平平，仄平平仄。平平仄仄，平平平仄，平平平仄平平仄，仄平平、仄仄平平仄。平平仄仄，平平仄仄平平，仄平仄仄平仄。平平仄仄，仄仄平平，仄仄平仄仄。仄仄仄、平平平仄，仄仄平平，仄仄平平，仄平平仄。平平仄仄，平平平仄，平平平仄平仄仄，仄平平、平仄平平仄。平平平仄平平，仄仄平平，仄平仄仄。,0,122,118,240,"[6, 5, 3, 4, 6, 3, 4, 7, 3, 4, 4, 4, 4, 5, 3, 4, 6, 3, 4, 3, 4, 3, 4, 4, 4, 4, 5, 3, 4, 4, 4, 4, 4, 4, 7, 3, 5, 4, 6, 6, 4, 4, 5, 3, 4, 4, 4, 4, 4, 4, 7, 3, 5, 6, 4, 4]"
南乡子,仄仄平平，中平中仄仄平平。仄仄平平平仄仄，平仄，仄仄平平平仄仄。,2,12,13,27,"[4, 7, 7, 2, 7]"
蕃女怨,仄平平仄平仄仄，仄仄平仄。仄平平，平仄仄，仄平平仄。仄平平仄仄平平，仄平平。,0,15,16,31,"[7, 4, 3, 3, 4, 7, 3]"
调笑令,平仄，〖平仄〗，仄仄平平仄仄。平平仄仄平平，平平仄仄仄平。平仄，〖平仄〗，平仄平平仄仄。,0,16,16,32,"[2, 2, 6, 6, 6, 2, 2, 6]"
昭君怨,中仄中平中仄，中仄中平中仄。中仄仄平平，仄平平。中仄中平中仄，中仄中平中仄。中仄仄平平，仄平平。,14,12,14,40,"[6, 6, 5, 3, 6, 6, 5, 3]"
菩萨蛮,中平中仄平平仄，中平中仄平平仄。中仄仄平平，中平平仄平。中平平仄仄，中仄平平仄。中仄仄平平，中平平仄平。,10,20,14,44,"[7, 7, 5, 5, 5, 5, 5, 5]"
更漏子,仄平平，平仄仄。中仄中平中仄。中仄仄，仄平平，中平中仄平。平中仄，中平仄，中仄中平中仄。中中仄，仄平平，中平中仄平。,15,15,16,46,"[3, 3, 6, 3, 3, 5, 3, 3, 6, 3, 3, 5]"
喜迁莺,中仄仄，仄平平，平仄仄平平。仄平平仄仄平平，平仄仄平平。平中仄，平中仄，仄仄仄平平仄。中平平仄仄平平，平仄仄平平。,4,23,20,47,"[3, 3, 5, 7, 5, 3, 3, 6, 7, 5]"
清平乐,中平中仄，中仄平平仄。中仄中平平仄仄，中仄中平中仄。中平中仄平平，中平中仄平平。中仄中平中仄，中平中仄平平。,17,16,13,46,"[4, 5, 7, 6, 6, 6, 6, 6]"
忆馀杭,平仄平平，中仄平平平仄仄，平平仄仄仄平平，中仄仄平平。仄平平仄平平仄，仄仄仄平仄平仄。仄平平仄仄平平，仄仄仄平平。,2,24,23,49,"[4, 7, 7, 5, 7, 7, 7, 5]"
河渎神,平仄仄平平，平仄平平仄平。仄平仄仄仄平平，仄平平仄平平。仄仄平平平仄仄，平仄平平平仄。仄仄仄平平仄，仄平平仄平仄。,0,26,23,49,"[5, 6, 7, 6, 7, 6, 6, 6]"
河传,平仄，平仄。仄平平仄，平仄平平。仄平平仄，平仄仄仄平平，仄平平仄平。平平仄仄平平仄，平仄仄，仄仄平平仄。仄平平仄，平仄仄仄平平，仄平平。,0,29,26,55,"[2, 2, 4, 4, 4, 6, 5, 7, 3, 5, 4, 6, 3]"
虞美人,中平中仄平平仄，中仄平平仄。中平中仄仄平平，中仄中平平仄仄平平。中平中仄平平仄，中仄平平仄。中平中仄仄平平，中仄中平平仄仄平平。,14,24,18,56,"[7, 5, 7, 9, 7, 5, 7, 9]"
西江月,『中仄中平平仄，中平中仄平平』。中平中仄仄平平，中仄平平中仄。中仄中平平仄，中平中仄平平。中平中仄仄平平，中仄平平中仄。,16,20,14,50,"[6, 6, 7, 6, 6, 6, 7, 6]"
醉翁操,平平，平平，平平。仄平平，平平，平平仄平平平平。仄平平仄平平，平仄平。仄仄仄平平，仄仄平仄平仄平。仄平仄仄，平仄平平。仄平仄仄，平仄平平仄仄。平仄平平平平，仄仄平平平平，平平平仄平。平平平平平，仄仄仄平平，仄平平仄仄平平。,0,59,32,91,"[2, 2, 2, 3, 2, 7, 6, 3, 5, 7, 4, 4, 4, 6, 6, 6, 5, 5, 5, 7]"
渡江云,中平平仄仄，仄平仄仄，中仄仄平平。仄平平仄仄，仄仄平平，仄仄仄平平。平平仄仄，仄中中、中仄平平。平仄中、中平平仄，中仄仄平平。平平，平平中仄，仄仄平平，仄平平中仄。平仄中、平平中仄，中仄平平。平平仄仄平平仄，仄仄中、平仄平平。平仄仄，平平仄仄平平。,14,45,41,100,"[5, 4, 5, 5, 4, 5, 4, 3, 4, 3, 4, 5, 2, 4, 4, 5, 3, 4, 4, 7, 3, 4, 3, 6]"
曲玉管,仄仄平平，平平仄仄，平平仄仄平平仄。仄仄平平平仄，平仄平平，仄平平。仄仄平平，平平平仄，仄平仄仄平平仄。仄仄平平，仄仄平仄平平，仄平平。仄仄平平，仄平仄、平平平仄，仄平仄仄平平，平平仄仄平平。仄平平。仄平平平仄，仄仄平平平仄，仄平平仄，仄仄平平，仄仄平平。,0,58,47,105,"[4, 4, 7, 6, 4, 3, 4, 4, 7, 4, 6, 3, 4, 3, 4, 6, 6, 3, 5, 6, 4, 4, 4]"
哨遍,仄仄仄平，平仄仄平，仄仄平平仄。平仄平，平仄仄平平。仄平平平平平仄。仄仄平，平平仄平平仄，平平仄仄平平仄。平仄仄平平，平平仄仄，平平平仄平仄。仄仄平平仄仄平平。仄仄仄平平仄平平。平仄平平，仄仄平平，仄平仄仄。平，平仄平平，仄平平仄平平仄。平仄平仄仄，平平平仄平仄。仄仄仄平平，仄平仄仄，平平仄仄平平仄。平仄仄平平，平平仄仄，平平平仄平仄。仄仄平仄仄仄仄平。仄仄仄平平仄平平。仄平平、仄平平仄。平平平仄平仄，仄仄平平仄。仄平平仄平平仄仄，仄仄平平仄仄。仄平平仄仄平平。仄平平、仄仄平仄。,0,106,97,203,"[4, 4, 5, 3, 5, 7, 3, 6, 7, 5, 4, 6, 8, 8, 4, 4, 4, 1, 4, 7, 5, 6, 5, 4, 7, 5, 4, 6, 8, 8, 3, 4, 6, 5, 8, 6, 7, 3, 4]"
戚氏,仄平平，仄仄平仄仄平平。仄仄平平，仄平平仄，仄平平。平平，仄平平。平平仄仄仄平平。平平仄仄平仄，仄仄平仄仄平平。仄仄平仄，平平平仄，仄平仄仄平平。仄平平仄仄，平仄平仄，平仄平平。平仄，仄仄平平。平仄仄仄，仄仄仄平平。平平仄，仄平平仄，仄仄平平。仄平平。仄仄仄仄，平平仄仄，仄仄平平。仄平仄仄，仄仄平平，仄仄平仄平平。仄仄平平仄，平平仄仄，仄仄平平。仄仄平平仄仄，仄平平仄仄仄平平。仄平仄仄平平，仄平仄仄，平仄平平仄。仄仄平、平仄平平仄。平仄仄、平仄平平。仄仄平、仄仄平平。仄平仄仄仄仄平平。仄平平仄，平平仄仄，仄仄平平。,0,102,110,212,"[3, 7, 4, 4, 3, 2, 3, 7, 6, 7, 4, 4, 6, 5, 4, 4, 2, 4, 4, 5, 3, 4, 4, 3, 4, 4, 4, 4, 4, 6, 5, 4, 4, 6, 8, 6, 4, 5, 3, 5, 3, 4, 3, 4, 8, 4, 4, 4]"
荷叶杯,中仄中平平仄，平仄，仄平平。仄平平仄仄平仄，平仄，仄平平。,2,11,10,23,"[6, 2, 3, 7, 2, 3]"
定西番,中仄中平中仄，平仄仄，仄平平，仄平平。中仄中平平仄，中平中仄平。中仄中平中仄，仄平平。,10,13,12,35,"[6, 3, 3, 3, 6, 5, 6, 3]"
相见欢,中平中仄平平，仄平平。中仄中平平仄仄平平。中中仄，中平仄，仄平平。中仄中平平仄仄平平。,9,16,11,36,"[6, 3, 9, 3, 3, 3, 9]"
上行杯,仄仄平平平仄，平仄仄、仄仄平平。平仄平平平仄仄，平平仄仄。仄平平，平仄仄，仄仄，平仄，平仄平平。,0,19,19,38,"[6, 3, 4, 7, 4, 3, 3, 2, 2, 4]"
酒泉子,平仄仄平，平仄仄平平仄。仄平平，平仄仄，仄平平。仄平平仄仄平平，平仄仄平平仄。仄平平，平仄仄。仄平平。,0,22,19,41,"[4, 6, 3, 3, 3, 7, 6, 3, 3, 3]"
定风波,中仄平平仄仄平，中平中仄仄平平。中仄中平平仄仄，平仄，中平中仄仄平平。中仄中平平仄仄，平仄，中平中仄仄平平。中仄中平平仄仄，平仄，中平中仄仄平平。,15,24,23,62,"[7, 7, 7, 2, 7, 7, 2, 7, 7, 2, 7]"
最高楼,平平仄，平仄仄平平，中仄仄平平。中平中仄平平仄，中平中仄仄平平。仄平平，平仄仄，仄平平。仄仄仄、仄平平仄仄，仄仄仄、仄平平仄仄。平仄仄，仄平平。中平中仄平平仄，中平中仄仄平平。仄平平，平仄仄，仄平平。,9,36,36,81,"[3, 5, 5, 7, 7, 3, 3, 3, 3, 5, 3, 5, 3, 3, 7, 7, 3, 3, 3]"
