词牌名,作者,韵律,中,平,仄,总数,分段字数
竹枝 ,皇甫松,平平仄仄仄平平。平平仄仄仄平平。,0,8,6,14,"[7, 7]"
竹枝 ,皇甫松,平平平平仄仄仄。仄平仄仄平平仄。,0,7,7,14,"[7, 7]"
竹枝 ,孙光宪,平平平仄仄平平。仄仄平平仄仄平。平仄平平平仄仄，仄平平仄仄平平。,0,16,12,28,"[7, 7, 7, 7]"
归字谣 ,张孝祥,平。仄仄平平仄仄平。平平仄，平仄仄平平。,0,9,7,16,"[1, 7, 3, 5]"
渔父引 ,顾况,平仄平平仄平。仄平仄仄平平。平平仄仄平平。,0,11,7,18,"[6, 6, 6]"
閒中好 ,段成式,平平仄，平仄仄平平。仄仄平平仄，平平平仄平。,0,11,7,18,"[3, 5, 5, 5]"
閒中好 ,郑符,平平仄，仄仄平平仄。仄仄平仄平，平平仄平仄。,0,9,9,18,"[3, 5, 5, 5]"
纥那曲 ,刘禹锡,平仄仄平平。仄平平仄平。平平仄平仄，平仄仄平平。,0,12,8,20,"[5, 5, 5, 5]"
拜新月 ,李端,平平仄平仄，仄仄仄平仄。仄仄平仄平，仄平平平仄。,0,9,11,20,"[5, 5, 5, 5]"
梧桐影 ,吕岩,平仄平，平平仄。平仄仄平平仄平，平平仄仄平平仄。,0,12,8,20,"[3, 3, 7, 7]"
啰唝曲 ,刘采春,仄仄平平仄，平平平仄平。仄平平仄仄，平仄仄平平。,0,11,9,20,"[5, 5, 5, 5]"
啰唝曲 ,刘采春,仄仄仄平平。平平仄仄平。平平仄仄仄，平仄仄平平。,0,10,10,20,"[5, 5, 5, 5]"
啰唝曲 ,刘采春,平仄平平仄仄平。平平仄仄仄平平。仄平仄仄平平仄，仄仄平平仄仄平。,0,14,14,28,"[7, 7, 7, 7]"
醉妆词 ,王衍,仄平仄。仄平仄。仄仄平平仄。仄平仄。仄平仄。仄仄平平仄。,0,8,14,22,"[3, 3, 5, 3, 3, 5]"
庆宣和 ,张可久,平仄平平仄仄平。仄仄平平。仄仄平平仄平平。仄仄。仄仄。,0,10,12,22,"[7, 4, 7, 2, 2]"
南歌子 ,温庭筠,仄仄平平仄，平平仄仄平。平仄仄平平。仄平平仄仄，仄平平。,0,12,11,23,"[5, 5, 5, 5, 3]"
南歌子 ,张泌,仄仄平平仄，平平仄仄平。仄平平仄仄平平。平仄仄平平仄，仄平平。,0,14,12,26,"[5, 5, 7, 6, 3]"
南歌子 ,毛熙震,仄仄平平仄，平平仄仄平。平平仄仄仄平平。仄仄仄平平仄、仄平平。仄仄平平仄，平平仄仄平。仄平平仄仄平平。仄仄平平平仄、仄平平。,0,27,25,52,"[5, 5, 7, 6, 3, 5, 5, 7, 6, 3]"
南歌子 ,辛弃疾,仄仄平平仄，平平平仄平。平平平仄仄平平。仄仄平平、仄仄仄平平。仄仄平平仄，平平仄仄平。仄平平仄仄平平。仄仄平平、仄仄仄平平。,0,28,24,52,"[5, 5, 7, 4, 5, 5, 5, 7, 4, 5]"
南歌子 ,无名氏,仄仄平平仄，平平仄仄平。仄平平仄仄平平。平仄平平、平仄仄平平。平仄平平仄，平平仄仄平。仄平平仄仄平平。仄仄平平、平仄仄平平。,0,30,22,52,"[5, 5, 7, 4, 5, 5, 5, 7, 4, 5]"
南歌子 ,周邦彦,仄仄平平仄，平平仄仄平。仄平平仄仄平平。仄仄平平平仄、平仄平平。仄仄平平仄，平平仄仄平。仄平平仄仄平平。平仄仄平平仄、仄仄平平。,0,29,25,54,"[5, 5, 7, 6, 4, 5, 5, 7, 6, 4]"
南歌子 ,石孝友,平仄平平仄，平平平仄仄。平平平仄仄平仄。仄仄平平、平仄仄平仄。平仄平平仄，仄平平仄仄。仄平平仄仄平仄。仄仄仄平、平仄仄平仄。,0,25,27,52,"[5, 5, 7, 4, 5, 5, 5, 7, 4, 5]"
荷叶杯 ,温庭筠,仄仄仄平平仄。平仄。仄平平。仄平平仄仄平仄。平仄。仄平平。,0,11,12,23,"[6, 2, 3, 7, 2, 3]"
荷叶杯 ,顾夐,平仄仄平平仄。仄仄。平仄仄平平。仄平平仄仄平平。平仄平。平仄平。,0,14,12,26,"[6, 2, 5, 7, 3, 3]"
荷叶杯 ,韦庄,仄仄仄平平仄。平仄。平仄仄平平。仄平平仄仄平平。平仄仄平平。平仄仄平平仄。平仄。平仄仄平平。平平平仄仄平平。平仄仄平平。,0,28,22,50,"[6, 2, 5, 7, 5, 6, 2, 5, 7, 5]"
回波乐 ,李景伯,平平仄平仄平。平平仄仄平平。仄仄仄平平仄，平平仄仄平平。,0,14,10,24,"[6, 6, 6, 6]"
回波乐 ,无名氏,平平仄平仄仄。仄仄仄仄仄仄。仄平仄仄平平，仄仄平平仄仄。,0,8,16,24,"[6, 6, 6, 6]"
舞马词 ,张说,仄平仄仄平平。平平仄仄平平。仄仄平平仄仄，平平仄仄平平。,0,13,11,24,"[6, 6, 6, 6]"
舞马词 ,张说,平仄平平仄仄，仄平仄仄平平。平仄仄平平仄，平平仄仄平平。,0,13,11,24,"[6, 6, 6, 6]"
三台 ,王建,平仄平平仄仄，仄平仄仄平平。平仄平平仄仄，仄平平仄平平。,0,13,11,24,"[6, 6, 6, 6]"
三台 ,王建,仄平平仄平平。仄仄平仄平平。平平仄平仄仄，仄平仄仄平平。,0,13,11,24,"[6, 6, 6, 6]"
柘枝引 ,无名氏,平平仄仄仄平平。仄仄仄平平。平仄平平仄，平平仄仄仄平平。,0,13,11,24,"[7, 5, 5, 7]"
塞姑 ,无名氏,仄仄平平仄仄。仄仄平平仄仄。平仄平平仄平，仄仄平平平仄。,0,11,13,24,"[6, 6, 6, 6]"
晴偏好 ,李霜崖,平平平仄平平仄。平平仄仄平平仄。平平仄。平平仄仄平平仄。,0,15,9,24,"[7, 7, 3, 7]"
凭阑人 ,邵亨贞,平仄平平仄仄平。平仄平平平仄平。平平平仄平。仄平平仄平。,0,16,8,24,"[7, 7, 5, 5]"
凭阑人 ,倪瓒,仄仄平平平仄平。平仄平平平仄仄。平平仄仄平。仄平平，平仄平。,0,15,10,25,"[7, 7, 5, 3, 3]"
花非花 ,白居易,平平平，仄平仄。仄仄平，平平仄。平平平仄仄平平，仄仄平平平仄仄。,0,15,11,26,"[3, 3, 3, 3, 7, 7]"
摘得新 ,皇甫松,仄仄平。平平仄仄平。仄平平仄仄，仄平平。平平平仄仄仄仄，仄平平。,0,13,13,26,"[3, 5, 5, 3, 7, 3]"
梧叶儿 ,吴西逸,平平仄，平仄平。平仄仄平平。平平仄，平仄平。仄平平。平仄平平仄仄。,0,16,10,26,"[3, 3, 5, 3, 3, 3, 6]"
梧叶儿 ,张可久,平平仄，平仄平。仄仄仄平平。平平仄，平仄平。仄平平。仄仄平、平平仄平。,0,16,11,27,"[3, 3, 5, 3, 3, 3, 3, 4]"
梧叶儿 ,张可久,平平仄，仄仄平。平仄仄平平。仄仄平平仄，平平仄仄平。平仄仄平平。仄仄平平仄平。,0,17,15,32,"[3, 3, 5, 5, 5, 5, 6]"
梧叶儿 ,张雨,平平仄，仄仄平。平仄仄平平。平平平平仄，平平仄仄平。仄仄仄平平。仄仄仄、平平仄平。,0,18,15,33,"[3, 3, 5, 5, 5, 5, 3, 4]"
梧叶儿 ,张可久,平仄平平仄，平平仄仄平。平仄仄平平。仄仄平平仄，平平仄仄平。仄仄仄平平。平仄仄、平平仄仄。,0,19,18,37,"[5, 5, 5, 5, 5, 5, 3, 4]"
渔歌子 ,张志和,平仄平平仄仄平。平平平仄仄平平。平仄仄，仄平平。平平仄仄仄平平。,0,16,11,27,"[7, 7, 3, 3, 7]"
渔歌子 ,张志和,平平仄仄仄平平。平仄平平仄仄平。平仄仄，仄平平。仄仄平平仄仄平。,0,14,13,27,"[7, 7, 3, 3, 7]"
渔歌子 ,（南唐）李煜,仄仄仄平平仄仄，平仄平平仄仄平。仄平仄，仄平平。仄仄平平仄仄平。,0,12,15,27,"[7, 7, 3, 3, 7]"
渔歌子 ,苏轼,平仄仄，平平仄。平仄仄平平仄。仄平平仄仄平平，仄仄仄平平仄。,0,12,13,25,"[3, 3, 6, 7, 6]"
渔歌子 ,顾夐,仄平平，平仄仄。仄平平仄平平仄。仄平平，仄平仄。仄仄平平仄仄。仄平平，平仄仄。平平平仄平平仄。仄平平，平仄仄。平仄平平仄仄。,0,26,24,50,"[3, 3, 7, 3, 3, 6, 3, 3, 7, 3, 3, 6]"
渔歌子 ,孙光宪,仄平平，平仄仄。仄平仄仄平平仄。平仄仄，仄平平，仄仄平平平仄。仄仄平，平仄仄。仄平仄仄平平仄。平仄仄，仄平平，仄仄平平平仄。,0,23,27,50,"[3, 3, 7, 3, 3, 6, 3, 3, 7, 3, 3, 6]"
忆江南 ,白居易,平平仄，平仄仄平平。仄仄平平平仄仄，平平平仄仄平平。平仄仄平平。,0,16,11,27,"[3, 5, 7, 7, 5]"
忆江南 ,欧阳修,平平仄，平仄仄平平。平仄平平平仄仄，平平平仄仄平平。平仄仄平平。平仄仄，仄仄仄平平。平仄平平平仄仄，仄平平仄仄平平。平仄仄平平。,0,31,23,54,"[3, 5, 7, 7, 5, 3, 5, 7, 7, 5]"
忆江南 ,冯延巳,仄仄平平平仄仄。仄仄平平，仄平平仄。仄平平仄仄平平。仄平平仄仄平平。平平平仄平平仄。仄仄平平，仄仄平平仄。平平平仄仄平平。平平仄仄仄平平。,0,33,26,59,"[7, 4, 4, 7, 7, 7, 4, 5, 7, 7]"
潇湘神 ,刘禹锡,平仄平。平仄平。仄平仄仄仄平平。仄仄仄平平仄仄，平平平仄仄平平。,0,14,13,27,"[3, 3, 7, 7, 7]"
章台柳 ,韩翃,平平仄。平平仄。仄仄平平平仄仄。仄仄平平仄仄平，仄平平仄平平仄。,0,14,13,27,"[3, 3, 7, 7, 7]"
章台柳 ,唐妓柳氏,平仄平，平平仄。仄仄平平仄平仄。仄仄平平仄仄平，仄仄平平仄平仄。,0,13,14,27,"[3, 3, 7, 7, 7]"
解红 ,和凝,仄仄仄，仄平平。仄平仄仄平仄平。仄仄平平仄平仄，仄平仄仄仄平平。,0,11,16,27,"[3, 3, 7, 7, 7]"
赤枣子 ,欧阳炯,仄仄仄，仄平平。平平平仄仄平平。平仄仄平平仄仄，平平仄仄仄平平。,0,14,13,27,"[3, 3, 7, 7, 7]"
南乡子 ,欧阳炯,仄仄平平。仄平平仄仄平平。仄仄平平平仄仄。平仄。仄仄平平平仄仄。,0,13,14,27,"[4, 7, 7, 2, 7]"
南乡子 ,欧阳炯,仄仄平平。平平仄仄仄平平。仄仄平平平仄仄。平平仄。仄仄平平平仄仄。,0,14,14,28,"[4, 7, 7, 3, 7]"
南乡子 ,冯延巳,仄仄仄平平。平仄平平仄仄平。平仄仄平平仄仄。平仄。仄仄平平平仄仄。,0,13,15,28,"[5, 7, 7, 2, 7]"
南乡子 ,李珣,平仄仄，仄平平。仄平平仄仄平平。仄仄平平平仄仄。平平仄。平仄仄平平仄仄。,0,15,15,30,"[3, 3, 7, 7, 3, 7]"
南乡子 ,欧阳修,仄仄平平。仄仄平平仄仄平。仄仄平平平仄仄，平平。仄仄平平仄仄平。仄仄平平。仄仄平平仄仄平。平仄仄平平仄仄，平平。平仄平平仄仄平。,0,27,27,54,"[4, 7, 7, 2, 7, 4, 7, 7, 2, 7]"
南乡子 ,冯延巳,仄仄仄平平。平仄平平仄仄平。平仄仄平平仄仄，平平。平仄平平仄仄平。平仄仄平平。仄仄平平仄仄平。仄仄仄平平仄仄，平平。仄仄平平仄仄平。,0,28,28,56,"[5, 7, 7, 2, 7, 5, 7, 7, 2, 7]"
南乡子 ,王之道,平仄仄平平。平仄平平仄仄平。平仄平平，平仄仄平平。仄仄平平仄仄平。平仄仄平平。仄仄平平仄仄平。仄仄仄平，平仄仄平平。仄仄平平仄仄平。,0,29,27,56,"[5, 7, 4, 5, 7, 5, 7, 4, 5, 7]"
南乡子 ,黄机,平仄仄平平。平仄平平仄仄平。平仄仄平，平平仄仄，平平。仄仄平平仄仄平。仄仄仄平平。仄仄平平仄仄平。仄仄仄平，平平仄仄，平平。平仄平平仄仄平。,0,30,28,58,"[5, 7, 4, 4, 2, 7, 5, 7, 4, 4, 2, 7]"
南乡子 ,赵长卿,仄仄仄平平。平平仄仄，平仄平平。仄仄平平平仄仄，平平。仄仄平平仄仄平。平仄仄平平。平平仄仄，仄仄平平。平仄仄平平仄仄，平平。仄仄平平仄仄平。,0,30,28,58,"[5, 4, 4, 7, 2, 7, 5, 4, 4, 7, 2, 7]"
捣练子 ,冯延巳,平仄仄，仄平平。仄仄平平仄仄平。平仄仄平平仄仄，仄平平仄仄平平。,0,13,14,27,"[3, 3, 7, 7, 7]"
捣练子 ,李石,平仄仄，仄平平。仄平平仄仄平平。仄平平，仄仄平。平仄仄，仄平平。平平仄仄仄平平。仄平平，仄仄平。,0,20,18,38,"[3, 3, 7, 3, 3, 3, 3, 7, 3, 3]"
春晓曲 ,朱敦儒,平平仄仄平平仄。仄仄平平仄仄。仄平仄仄仄平平，仄仄仄平平仄仄。,0,11,16,27,"[7, 6, 7, 7]"
春晓曲 ,张元干,平平仄仄平平仄。仄平平，平仄仄。仄平平仄仄平平，仄仄平平平仄仄。,0,14,13,27,"[7, 3, 3, 7, 7]"
桂殿秋 ,向子諲,平仄仄，仄平平。平平仄仄仄平平。平平仄仄平平仄，仄仄平平仄仄平。,0,14,13,27,"[3, 3, 7, 7, 7]"
寿阳曲 ,张可久,平平仄，平仄平。仄平平、仄平平仄。平平仄平平仄仄。仄平平、仄平平仄。,0,16,11,27,"[3, 3, 3, 4, 7, 3, 4]"
寿阳曲 ,张可久,平平仄，仄仄仄。仄平平、仄平平仄。仄平平、仄平平仄仄。仄平平、仄平平仄。,0,14,14,28,"[3, 3, 3, 4, 3, 5, 3, 4]"
寿阳曲 ,张可久,仄仄平平仄，仄平平仄平。仄平平、仄平平仄。仄平平、仄平平仄仄。平仄仄、仄平平仄。,0,16,16,32,"[5, 5, 3, 4, 3, 5, 3, 4]"
阳关曲 ,王维,仄平平仄仄平平。仄仄平平仄仄平。仄平仄仄仄平仄，平仄平平平仄平。,0,14,14,28,"[7, 7, 7, 7]"
欸乃曲 ,元结,平仄平平平仄平。平平平仄仄平平。平平仄仄仄平仄，仄仄平平平仄平。,0,17,11,28,"[7, 7, 7, 7]"
采莲子 ,皇甫松,仄仄平平仄仄平。仄平平仄仄平平。仄平仄仄平平仄，仄仄平平仄仄平。,0,13,15,28,"[7, 7, 7, 7]"
浪淘沙 ,皇甫松,平平仄仄仄平平。平仄平平仄仄平。仄仄平平平仄仄，平平仄仄仄平平。,0,15,13,28,"[7, 7, 7, 7]"
杨柳枝 ,温庭筠,平仄平平仄仄平。仄平平仄仄平平。仄平仄仄平平仄，仄仄平平仄仄平。,0,14,14,28,"[7, 7, 7, 7]"
八拍蛮 ,孙光宪,仄仄仄平平仄平。仄平平仄仄平平。仄仄平平平仄仄，平平平仄仄平平。,0,15,13,28,"[7, 7, 7, 7]"
八拍蛮 ,阎选,平仄仄平平仄仄，平平平仄仄平平。平仄仄平平仄仄，平平仄仄仄平平。,0,15,13,28,"[7, 7, 7, 7]"
字字双 ,王丽贞,平平仄平平仄平。仄仄平平平仄平。平平平仄平仄平。仄平仄仄平仄平。,0,17,11,28,"[7, 7, 7, 7]"
十样花 ,李弥逊,仄仄平平平仄。仄仄平平平仄。仄仄平平仄，平平仄，仄平仄。仄平平仄仄。,0,13,15,28,"[6, 6, 5, 3, 3, 5]"
十样花 ,李弥逊,仄仄平平平仄。平仄仄平平仄。仄仄仄平平，平仄仄。仄平仄。仄平平仄仄。,0,12,16,28,"[6, 6, 5, 3, 3, 5]"
天净沙 ,乔吉,仄平平仄平平。仄平平仄平平。仄仄平平仄平。平平平仄。仄平平仄平平。,0,18,10,28,"[6, 6, 6, 4, 6]"
天净沙 ,马致远,平平仄仄平平。仄平平仄平平。仄仄平平仄仄。仄平平仄。仄平平仄平平。,0,16,12,28,"[6, 6, 6, 4, 6]"
甘州曲 ,王衍,仄平平。平仄仄，仄平平。仄平平仄仄平平。仄仄仄平平。仄仄仄、平仄仄平平。,0,14,15,29,"[3, 3, 3, 7, 5, 3, 5]"
甘州曲 ,顾夐,仄平平仄仄平平。平仄仄，仄平平。仄平平仄仄平平。平仄仄平平。平仄仄、平仄仄平平。,0,18,15,33,"[7, 3, 3, 7, 5, 3, 5]"
醉吟商 ,姜夔,仄仄平平，仄仄仄平平仄。仄平平仄。仄仄平平仄。仄仄平平平仄。平平仄仄。,0,13,16,29,"[4, 6, 4, 5, 6, 4]"
乾荷叶 ,刘秉忠,平平仄，仄平平。仄仄平平仄。仄平平。仄平平。平平仄仄仄平平。仄仄平平仄。,0,16,13,29,"[3, 3, 5, 3, 3, 7, 5]"
乾荷叶 ,刘秉忠,平平仄，仄平平。仄仄平平仄。仄平平。仄平平。仄平平仄仄平平。平仄仄、平平仄。,0,17,13,30,"[3, 3, 5, 3, 3, 7, 3, 3]"
喜春来 ,张雨,仄平仄仄平平仄。仄仄平平仄仄平。仄平平仄仄平平。仄仄平。平仄仄平平。,0,14,15,29,"[7, 7, 7, 3, 5]"
喜春来 ,周德清,平平仄仄平平仄。仄仄平平仄仄平。仄平仄仄仄平平。平仄仄。平仄仄平平。,0,14,15,29,"[7, 7, 7, 3, 5]"
喜春来 ,司马九皋,仄平仄仄平平仄。平仄平平仄仄平。仄平平仄仄平平。平仄仄。平仄仄，仄平平。,0,15,15,30,"[7, 7, 7, 3, 3, 3]"
喜春来 ,无名氏,仄平仄仄平平仄。平仄平平仄仄平。仄平平，平仄仄，仄平平。平仄平。平仄仄平平。,0,17,14,31,"[7, 7, 3, 3, 3, 3, 5]"
踏歌词 ,崔液,仄仄平平仄，平平仄仄平。平平平仄仄，仄仄仄平平。平仄仄平平。仄仄仄平平。,0,15,15,30,"[5, 5, 5, 5, 5, 5]"
秋风清 ,李白,平平平。平仄平。仄仄仄平仄，平平平仄平。平平平仄平平仄，仄平仄仄平平平。,0,19,11,30,"[3, 3, 5, 5, 7, 7]"
秋风清 ,寇准,平仄仄，仄平平。平平平仄仄，平仄仄平平。平平平仄平平仄，平仄平平平仄平。,0,19,11,30,"[3, 3, 5, 5, 7, 7]"
秋风清 ,刘长卿,平平仄。平平仄。仄平仄仄平，平仄平平仄。平仄平平仄仄平，仄平平仄平平仄。,0,17,13,30,"[3, 3, 5, 5, 7, 7]"
抛毬乐 ,刘禹锡,仄仄仄平平。平平仄仄平。仄平平仄仄，平仄仄平平。仄仄平平仄，平平仄仄平。,0,15,15,30,"[5, 5, 5, 5, 5, 5]"
抛毬乐 ,皇甫松,平仄平平仄，平平仄仄平。仄仄平。仄平平仄仄，平仄仄平平。仄仄平平仄，平平仄仄平。,0,17,16,33,"[5, 5, 3, 5, 5, 5, 5]"
抛毬乐 ,冯延巳,平仄平平仄仄平。仄平平仄仄平平。仄平平仄平平仄，平仄平平仄仄平。仄仄平平仄，平仄平平仄仄平。,0,22,18,40,"[7, 7, 7, 7, 5, 7]"
抛毬乐 ,柳永,仄平平仄平仄，平仄平仄。仄平平、平仄仄仄，平仄平平，仄平平仄。仄仄仄、平仄平平，仄仄仄、平平平仄。仄仄仄仄平平，仄仄平平，平仄平平仄。仄仄平平仄，平平仄仄，仄平平仄，平平仄仄。仄仄仄平平，仄仄仄、平平平平仄。仄平平平仄，平仄仄平，仄平仄仄。仄仄平仄平平，仄平仄、仄仄平平仄。仄平平，平仄仄，仄仄平平仄仄。仄平仄仄，平仄平平平仄。仄平仄仄，仄平仄仄，仄仄平仄平平仄。仄仄平仄仄，平平仄仄仄平，仄仄平平仄仄。平仄仄平平，仄仄仄、仄仄平平仄。仄仄仄仄平，仄平平仄。,0,81,106,187,"[6, 4, 3, 4, 4, 4, 3, 4, 3, 4, 6, 4, 5, 5, 4, 4, 4, 5, 3, 5, 5, 4, 4, 6, 3, 5, 3, 3, 6, 4, 6, 4, 4, 7, 5, 6, 6, 5, 3, 5, 5, 4]"
法驾导引 ,陈与义,平平仄，平平仄，平仄仄平平。平仄仄平平仄仄，平平平仄仄平平。平仄仄平平。,0,18,12,30,"[3, 3, 5, 7, 7, 5]"
蕃女怨 ,温庭筠,仄平平仄平仄仄。仄仄平仄。仄平平，平仄仄。仄平平仄。仄平平仄仄平平。仄平平。,0,15,16,31,"[7, 4, 3, 3, 4, 7, 3]"
一叶落 ,后唐庄宗,仄仄仄。平平仄。仄平仄仄仄平仄。仄平仄仄平，平平平平仄。平平仄。仄仄平平仄。,0,14,17,31,"[3, 3, 7, 5, 5, 3, 5]"
忆王孙 ,李重元,平平平仄仄平平。仄仄平平平仄平。仄仄平平仄仄平。仄平平。仄仄平平平仄平。,0,18,13,31,"[7, 7, 7, 3, 7]"
忆王孙 ,白朴,平平仄仄仄平平。平仄平平仄仄平。平仄仄平仄仄仄。仄平平。平仄平平平仄仄。,0,16,15,31,"[7, 7, 7, 3, 7]"
忆王孙 ,无名氏,平仄平平平仄仄。平仄仄、平平平仄。仄平平仄仄平平，仄仄仄、平平仄。平仄仄平平仄仄。平仄仄、平平平仄。平平平仄仄平平，仄平仄、平平仄。,0,29,25,54,"[7, 3, 4, 7, 3, 3, 7, 3, 4, 7, 3, 3]"
金字经 ,张可久,仄仄平平仄，仄平平仄平。平仄平平仄仄平。平。仄平平仄平。平平仄。仄平平仄平。,0,18,13,31,"[5, 5, 7, 1, 5, 3, 5]"
金字经 ,《太平乐府》徐失名,平仄平平仄，仄平平仄平。平仄平平平仄平。平。仄平仄仄平。平平仄。仄仄仄、平仄平。,0,18,14,32,"[5, 5, 7, 1, 5, 3, 3, 3]"
金字经 ,《太平乐府》徐失名,仄仄平仄仄，仄平平仄平。仄仄仄、仄平平仄仄。平。仄平平、平仄平。平平仄。仄平平、平仄平。,0,17,17,34,"[5, 5, 3, 5, 1, 3, 3, 3, 3, 3]"
调笑令 ,王建,平仄。平仄。平平平平仄仄。平平仄仄平平。仄仄平平仄平。平仄。平仄。仄仄平平仄仄。,0,17,15,32,"[2, 2, 6, 6, 6, 2, 2, 6]"
遐方怨 ,温庭筠,平仄仄，仄平平。仄仄平平，仄平平平平仄平。仄平平仄仄平平。仄平平仄仄，仄平平。,0,18,14,32,"[3, 3, 4, 7, 7, 5, 3]"
遐方怨 ,孙光宪,平仄仄，仄平平。仄仄平平仄，平平仄仄平。仄平仄仄仄平平。仄平平仄仄平平。平仄仄，仄平平。仄仄平平仄，平平仄仄平。仄平平仄仄平平。仄平平仄仄平平。,0,31,29,60,"[3, 3, 5, 5, 7, 7, 3, 3, 5, 5, 7, 7]"
后庭花破子 ,王恽,仄仄仄平平。平平仄仄平。仄仄平平仄，平平仄仄平。仄平平。仄平仄仄，平平平仄平。,0,17,15,32,"[5, 5, 5, 5, 3, 4, 5]"
后庭花破子 ,赵孟頫,平平仄仄平。平平仄仄平。仄平平平仄，平平仄仄平。仄平平。仄平平仄，仄平仄、平仄平。,0,19,14,33,"[5, 5, 5, 5, 3, 4, 3, 3]"
如梦令 ,后唐庄宗,平仄平平平仄。仄仄仄平平仄。平仄仄平平，平仄仄平平仄。平仄。平仄。平仄仄平平仄。,0,17,16,33,"[6, 6, 5, 6, 2, 2, 6]"
如梦令 ,无名氏,仄仄仄平平仄。仄仄平平仄仄。仄仄仄平平，仄仄平平平仄。平仄。仄仄。平仄仄平平仄。,0,13,20,33,"[6, 6, 5, 6, 2, 2, 6]"
如梦令 ,无名氏,平仄仄平平仄。平仄平平仄仄。平仄仄平平，平仄仄平平仄。平仄。平仄。仄仄仄平平仄。,0,16,17,33,"[6, 6, 5, 6, 2, 2, 6]"
如梦令 ,无名氏,仄仄平平平仄。仄仄仄平仄仄。平仄仄平平，仄仄平平仄仄。平平仄仄。平仄平平平仄。,0,15,18,33,"[6, 6, 5, 6, 4, 6]"
如梦令 ,吴文英,平平平仄仄平。平平仄仄平平。平仄仄平仄，仄平仄仄平平。平平。平平。仄仄仄仄平平。,0,19,14,33,"[6, 6, 5, 6, 2, 2, 6]"
如梦令 ,魏泰,平仄仄平仄仄。仄仄平平平仄。平仄仄平平，平仄仄平平仄。平仄。平仄。平仄平平仄仄。仄仄平平仄仄。平仄平平平仄。平仄仄平平，仄仄仄平仄仄。平仄。平仄。平仄仄平仄仄。,0,30,36,66,"[6, 6, 5, 6, 2, 2, 6, 6, 6, 5, 6, 2, 2, 6]"
诉衷情 ,温庭筠,平仄。平仄。平仄仄。仄平平。平仄仄。平仄。仄平平。仄仄仄平平。平平。平平平仄平。仄平平。,0,19,14,33,"[2, 2, 3, 3, 3, 2, 3, 5, 2, 5, 3]"
诉衷情 ,韦庄,仄仄平平平仄仄，仄平平。平仄仄。平仄。仄平平。平仄仄平平。平平。仄平平仄平。仄平平。,0,19,14,33,"[7, 3, 3, 2, 3, 5, 2, 5, 3]"
诉衷情 ,顾夐,仄仄平平平仄仄，仄平平。平仄仄。平仄。仄平平。平仄仄平平。仄平平。仄仄平、平仄平。仄平平仄平。,0,20,17,37,"[7, 3, 3, 2, 3, 5, 3, 3, 3, 5]"
诉衷情 ,毛文锡,平平平仄仄平平。平仄仄平平。平平仄，仄平平。平仄仄平平。平仄仄平平。仄平平。平平平仄仄平平。仄平平。,0,27,14,41,"[7, 5, 3, 3, 5, 5, 3, 7, 3]"
诉衷情 ,魏承班,平平平仄仄平平。平平仄仄平。平仄仄，仄平平。平仄仄平平。仄仄仄平平。仄平平。平平仄仄平平仄，仄平平。,0,24,17,41,"[7, 5, 3, 3, 5, 5, 3, 7, 3]"
西溪子 ,牛峤,仄仄平平平仄。平仄仄平平仄。仄平平，平仄仄。平仄仄。平仄平平仄仄。仄平平。仄平平。,0,17,16,33,"[6, 6, 3, 3, 3, 6, 3, 3]"
西溪子 ,毛文锡,仄仄平平平仄。平仄平平平仄。仄平平，平平仄。平平仄。平仄仄平平仄。仄仄仄平平。仄平平。,0,20,15,35,"[6, 6, 3, 3, 3, 6, 5, 3]"
天仙子 ,皇甫松,平仄仄平平仄仄。仄平平仄平平仄。平平仄仄仄平平，平仄仄。仄平仄。仄仄仄平平仄仄。,0,15,19,34,"[7, 7, 7, 3, 3, 7]"
天仙子 ,和凝,仄仄平平平仄仄。平仄平平平仄仄。仄平平仄仄平平，仄平平，平仄仄。平仄平平平仄仄。,0,18,16,34,"[7, 7, 7, 3, 3, 7]"
天仙子 ,韦庄,平仄平平平仄仄。平仄平平平仄仄。平平仄仄仄平平。平仄仄，仄平平。平仄平平平仄平。,0,20,14,34,"[7, 7, 7, 3, 3, 7]"
天仙子 ,韦庄,仄仄平平仄仄平。平平仄仄仄平平。仄平平仄仄平平。平仄仄，仄平平。平仄平平仄仄平。,0,18,16,34,"[7, 7, 7, 3, 3, 7]"
天仙子 ,张先,仄仄平平平仄仄。仄仄平平平仄仄。仄平平仄仄平平，平仄仄。平平仄。平仄平平平仄仄。平仄仄平平仄仄。仄仄仄平平仄仄。仄平平仄仄平平，平仄仄。平平仄。平仄仄平平仄仄。,0,32,36,68,"[7, 7, 7, 3, 3, 7, 7, 7, 7, 3, 3, 7]"
风流子 ,孙光宪,平仄平平仄仄。仄仄平平仄仄。平仄仄，仄平平，仄仄仄平平仄。平仄。平仄。仄仄平平平仄。,0,15,19,34,"[6, 6, 3, 3, 6, 2, 2, 6]"
风流子 ,周邦彦,平平平仄仄，平平仄、仄仄仄平平。仄仄平仄仄，仄平平仄，仄平平仄，平仄平平。仄平仄、仄平平仄仄，平仄仄平平。平仄仄平，仄平平仄，仄平平仄，平仄平平。平平平平仄，平平仄、平仄仄仄平平。平仄仄平平仄，平仄平平。仄仄仄平平，平平平仄，仄平平仄，仄仄平平。平仄仄平仄仄，平仄平平。,0,59,51,110,"[5, 3, 5, 5, 4, 4, 4, 3, 5, 5, 4, 4, 4, 4, 5, 3, 6, 6, 4, 5, 4, 4, 4, 6, 4]"
风流子 ,张耒,平平仄仄仄，平平仄、仄仄仄平平。仄平仄仄平，仄平平仄，仄平平仄，平仄平平。仄平仄、仄平平仄仄，平仄仄平平。平仄仄平，仄平平仄，仄平平仄，平仄平平。仄平平平仄，平平仄仄仄，仄仄平平。平仄仄平平仄，平仄平平。仄平平仄仄，平平仄仄，仄平仄仄，平仄平平。平仄仄平平仄，平仄平平。,0,57,53,110,"[5, 3, 5, 5, 4, 4, 4, 3, 5, 5, 4, 4, 4, 4, 5, 5, 4, 6, 4, 5, 4, 4, 4, 6, 4]"
风流子 ,王之道,平平平仄仄，平平仄、平仄仄平平。仄仄仄平平，仄平平仄，仄平平仄，平仄平平。平仄仄、仄平平仄仄，平仄仄平平。仄仄仄平平，仄平仄仄，仄平仄仄，平仄平平。平平平平仄，仄平平平仄，仄仄平平。平仄仄平平仄，平仄平平。仄平平平仄，平平仄仄，平平仄仄，平仄平平。平仄仄平平仄，平仄平平。,0,61,50,111,"[5, 3, 5, 5, 4, 4, 4, 3, 5, 5, 5, 4, 4, 4, 5, 5, 4, 6, 4, 5, 4, 4, 4, 6, 4]"
风流子 ,王千秋,仄仄仄平仄，平平仄、平仄仄平平。仄平平平仄，仄平平仄，仄平平仄，仄仄平平。仄平平、仄平平仄仄，仄仄仄平平。仄仄仄平，平平平仄，仄平平仄，仄仄平平。平平平仄仄，平平仄，平仄仄，仄平平。仄仄平平平仄，平仄平平。仄平平仄仄，仄平平仄，仄平平仄，平仄平平。平仄仄平平仄，平仄平平。,0,58,52,110,"[5, 3, 5, 5, 4, 4, 4, 3, 5, 5, 4, 4, 4, 4, 5, 3, 3, 3, 6, 4, 5, 4, 4, 4, 6, 4]"
风流子 ,周邦彦,平仄仄平平。平平仄、仄仄仄平平。仄平仄仄平，仄平平仄，仄平平仄，平仄平平。仄仄仄平平仄仄，仄仄仄平平。仄仄仄平，仄平平仄，仄平平仄，平仄平平。平平平平仄，平平仄、平仄仄仄平平。仄仄仄平，平平仄仄平平。仄仄平仄仄，平平仄仄，仄平平仄，平仄平平。平仄平平，仄平平仄平平。,0,57,52,109,"[5, 3, 5, 5, 4, 4, 4, 7, 5, 4, 4, 4, 4, 5, 3, 6, 4, 6, 5, 4, 4, 4, 4, 6]"
风流子 ,吴文英,平仄仄平平。平平仄、仄仄仄平平。仄平仄仄平，仄平平仄，仄平仄仄，仄仄平平。仄仄仄平平仄仄，平仄仄平平。平仄仄平，仄平平仄，仄平平仄，平仄平平。平平平平仄，平平仄、平仄仄仄平平。仄仄仄平平仄，平仄平平。仄仄仄平平，平平平仄，仄平平仄，平仄平平。平仄仄平平仄，平仄平平。,0,58,51,109,"[5, 3, 5, 5, 4, 4, 4, 7, 5, 4, 4, 4, 4, 5, 3, 6, 6, 4, 5, 4, 4, 4, 6, 4]"
风流子 ,贺铸,平仄仄平平。平平仄、仄仄仄平平。仄仄仄平，仄平平仄，平平平仄，仄仄平平。仄平仄、仄平平仄仄，仄仄仄平平。平仄仄平，仄平平仄，仄平仄仄，仄仄平平。平仄仄平平。平平仄平仄，仄仄平平。平仄仄平平仄，平仄平平。仄仄平平，平平仄仄，仄平平仄，仄仄平平。仄仄仄平平仄，平仄平平。,0,54,54,108,"[5, 3, 5, 4, 4, 4, 4, 3, 5, 5, 4, 4, 4, 4, 5, 5, 4, 6, 4, 4, 4, 4, 4, 6, 4]"
风流子 ,吴激,平仄仄平平。平平仄、仄仄仄平平。仄平仄仄平，仄平平仄，仄平平仄，平仄平平。仄平仄、仄平平仄仄，平仄仄平平。仄仄仄平，仄平平仄，仄平平仄，平仄平平。平仄仄平平。平平仄平仄，仄仄仄平平。仄仄仄平平仄，仄仄平平。仄仄仄平平，平平仄仄，仄平平仄，平仄平平。仄仄仄平平仄，平仄平平。,0,56,55,111,"[5, 3, 5, 5, 4, 4, 4, 3, 5, 5, 4, 4, 4, 4, 5, 5, 5, 6, 4, 5, 4, 4, 4, 6, 4]"
归自谣 ,欧阳修,平仄仄。平仄仄平平仄仄。仄平平仄平平仄。平平仄仄平仄仄。平平仄。仄平仄仄平平仄。,0,16,18,34,"[3, 7, 7, 7, 3, 7]"
饮马歌 ,曹勛,平平平仄仄。仄仄平平仄。仄平平平仄。仄平平平仄。仄平平，仄仄平，仄仄平平仄。仄平仄。,0,17,17,34,"[5, 5, 5, 5, 3, 3, 5, 3]"
定西番 ,温庭筠,仄仄仄平平仄。平仄仄，仄平平。仄平平。平仄仄平平仄。仄平平仄平。平仄仄平平仄。仄平平。,0,18,17,35,"[6, 3, 3, 3, 6, 5, 6, 3]"
定西番 ,温庭筠,仄仄仄平平仄。平仄仄，仄平平。仄平平。平仄仄平平仄。仄平平仄平。平仄仄平平仄，仄平平。,0,18,17,35,"[6, 3, 3, 3, 6, 5, 6, 3]"
定西番 ,韦庄,平仄平平平仄，平仄仄，仄平平。仄平平。平仄平平平仄。平平仄仄平。仄仄平平平仄。仄平平。,0,21,14,35,"[6, 3, 3, 3, 6, 5, 6, 3]"
定西番 ,孙光宪,平仄平平平仄，平仄仄，仄平平。仄平平。仄仄平平仄仄，平平仄仄平。仄仄平平平仄，仄平平。,0,19,16,35,"[6, 3, 3, 3, 6, 5, 6, 3]"
定西番 ,张先,仄仄仄平平仄，平仄仄，仄平平。平仄仄平平仄，仄平平。平仄仄平平仄，仄平平仄平。仄仄平平平仄，仄平平。,0,21,20,41,"[6, 3, 3, 6, 3, 6, 5, 6, 3]"
江城子 ,韦庄,仄平平仄仄平平。仄平平。仄平平。仄平平仄、平仄仄平平。仄仄仄平平仄仄，平仄仄，仄平平。,0,18,17,35,"[7, 3, 3, 4, 5, 7, 3, 3]"
江城子 ,欧阳炯,仄仄平平仄仄平。仄平平。仄平平。仄仄平平、仄仄仄平平。平仄平平平仄仄，平平仄仄，仄平平。,0,19,17,36,"[7, 3, 3, 4, 5, 7, 4, 3]"
江城子 ,牛峤,仄仄平平仄仄平。平平平仄平。仄平平。仄仄平平、平仄仄平平。仄仄平平平仄仄，平仄仄，仄平平。,0,20,17,37,"[7, 5, 3, 4, 5, 7, 3, 3]"
江城子 ,尹鹗,平平仄，仄平平。平平仄仄平。仄平平。仄仄平平、仄仄仄平平。仄仄平平平仄仄，平仄仄，仄平平。,0,19,17,36,"[3, 3, 5, 3, 4, 5, 7, 3, 3]"
江城子 ,苏轼,仄平平仄仄平平。仄平平。仄平平。仄仄平平、平仄仄平平。平仄平平平仄仄，平仄仄，仄平平。仄平平仄仄平平。仄平平。仄平平。平仄平平、平仄仄平平。仄仄仄平平仄仄，平仄仄，仄平平。,0,39,31,70,"[7, 3, 3, 4, 5, 7, 3, 3, 7, 3, 3, 4, 5, 7, 3, 3]"
望江怨 ,牛峤,平平仄。仄仄平平仄平仄。平平平仄仄。仄平平仄平平仄。仄平仄。仄仄仄平平，仄平平仄仄。,0,17,18,35,"[3, 7, 5, 7, 3, 5, 5]"
长相思 ,白居易,仄仄平。仄仄平。平仄平平仄仄平。平平仄仄平。仄平平。仄平平。仄仄平平平仄平。仄平平仄平。,0,20,16,36,"[3, 3, 7, 5, 3, 3, 7, 5]"
长相思 ,白居易,平仄平。仄仄平。平仄平平平仄平。平平平仄平。平平平，平平平。仄仄平平平仄平。平平仄仄平。,0,25,11,36,"[3, 3, 7, 5, 3, 3, 7, 5]"
长相思 ,晏几道,平平平。平平平。仄仄平平仄仄平。平平平仄平。平平平。平平平。仄仄平平仄仄平。仄平平仄平。,0,25,11,36,"[3, 3, 7, 5, 3, 3, 7, 5]"
长相思 ,欧阳修,平仄平。仄仄平。平仄平平平仄平。平平仄仄平。平平平。仄平平。平仄平平仄仄平。平平平仄平。,0,24,12,36,"[3, 3, 7, 5, 3, 3, 7, 5]"
长相思 ,刘光祖,仄平平。仄平平。仄仄平平平仄平。平平平仄平。仄平平，仄平平。仄仄平平平仄平。平平平仄平。,0,24,12,36,"[3, 3, 7, 5, 3, 3, 7, 5]"
思帝乡 ,温庭筠,平平。仄平平仄平。平仄仄平平仄，仄平平。平仄仄平平仄，仄平平仄平。平仄仄平平仄、仄平平。,0,21,15,36,"[2, 5, 6, 3, 6, 5, 6, 3]"
思帝乡 ,韦庄,平仄平。仄平平仄平。仄仄平平平仄，仄平平。仄仄平平仄仄，仄平平。仄仄平平仄、仄平平。,0,18,16,34,"[3, 5, 6, 3, 6, 3, 5, 3]"
思帝乡 ,韦庄,平仄仄，仄平平。仄仄平平平仄，仄平平。仄仄平平仄仄，仄平平。仄仄平平平仄、仄平平。,0,17,16,33,"[3, 3, 6, 3, 6, 3, 6, 3]"
相见欢 ,薛昭蕴,平平仄仄平平。仄平平。仄仄平平平仄、仄平平。仄平仄。平平仄。仄平平。仄仄平平平仄、仄平平。,0,21,15,36,"[6, 3, 6, 3, 3, 3, 3, 6, 3]"
相见欢 ,杨无咎,仄平仄仄平平。仄平平。仄仄平平仄仄、仄平平。平平仄。平仄仄。仄平平。平仄仄平平仄、仄平平。,0,19,17,36,"[6, 3, 6, 3, 3, 3, 3, 6, 3]"
相见欢 ,蔡伸,平平平仄平平。仄平平。仄仄平平平仄、仄平平。平仄仄，平仄仄，仄平平。平仄仄平平仄、仄平平。,0,21,15,36,"[6, 3, 6, 3, 3, 3, 3, 6, 3]"
相见欢 ,张镃,仄平平仄平平。仄平平。仄仄平平平仄、仄平平。平仄平平平仄，仄平平。平仄平平仄仄、仄平平。,0,22,14,36,"[6, 3, 6, 3, 6, 3, 6, 3]"
相见欢 ,吴文英,平平平仄平平。仄平平。平仄平平仄仄、仄平平。仄仄仄，仄平平。仄平平。平仄仄平平仄、仄平平。,0,21,15,36,"[6, 3, 6, 3, 3, 3, 3, 6, 3]"
河满子 ,和凝,仄仄平平平仄，平平平仄平平。仄仄平平平仄，平平平仄平平。仄仄平平仄仄，仄平平仄平平。,0,22,14,36,"[6, 6, 6, 6, 6, 6]"
河满子 ,和凝,仄仄仄平平仄，平平仄仄平平。平仄平平平仄仄，仄平平仄平平。仄仄平平平仄，仄平平仄平平。,0,21,16,37,"[6, 6, 7, 6, 6, 6]"
河满子 ,尹鹗,平仄平平仄仄，平平仄仄平平。仄仄平平平仄，仄平平仄平平。仄仄平平平仄，平平仄仄平平。平仄仄平平仄，仄平平仄平平。仄仄平平平仄仄，仄平平仄平平。仄仄平平平仄，平平仄仄平平。,0,42,31,73,"[6, 6, 6, 6, 6, 6, 6, 6, 7, 6, 6, 6]"
河满子 ,毛熙震,仄仄平平仄仄，仄平平仄平平。仄仄仄平平仄仄，仄平平仄平平。仄仄平平平仄，仄平平仄平平。平仄平平仄仄，仄平平仄平平。仄仄平平平仄仄，仄平平仄平平。平仄仄平平仄，仄平平仄平平。,0,40,34,74,"[6, 6, 7, 6, 6, 6, 6, 6, 7, 6, 6, 6]"
河满子 ,毛滂,仄仄平平平仄。平平平仄平仄。仄平平仄仄平仄，平仄仄平平仄。平平仄平平仄，平仄平平平仄。仄仄平平仄仄。仄仄平平仄仄。平平仄仄仄平仄，仄仄仄平平仄。平仄平平仄仄，仄仄平平仄仄。,0,35,39,74,"[6, 6, 7, 6, 6, 6, 6, 6, 7, 6, 6, 6]"
风光好 ,欧良,仄平平。仄平平。平仄平平仄仄平。仄平平。平平平仄平平仄。平平仄。仄仄平平仄仄平。仄平平。,0,22,14,36,"[3, 3, 7, 3, 7, 3, 7, 3]"
误桃源 ,无名氏,仄仄仄平仄，仄仄仄平平。仄平平仄平。仄平平。仄平仄仄仄，平仄仄平平。仄仄仄平仄，仄平平。,0,15,21,36,"[5, 5, 5, 3, 5, 5, 5, 3]"
望梅花 ,和凝,平仄平平平仄。仄仄平平平仄。仄仄平平平仄仄。仄仄平平平仄。平仄仄平平仄仄。平仄平平平仄。,0,20,18,38,"[6, 6, 7, 6, 7, 6]"
望梅花 ,孙光宪,仄平平仄仄平平。仄仄仄、平平平仄，仄仄平平平仄平。平仄仄平平。平仄平平仄仄平。平仄仄平平。,0,21,17,38,"[7, 3, 4, 7, 5, 7, 5]"
望梅花 ,蒲宗孟,平平平仄。平仄平平平仄。仄平平、仄仄平仄仄。平平平仄。仄仄仄平平仄仄。仄仄平平仄仄。仄平平仄。仄仄平平平仄。仄平平、平仄平平仄。仄平平仄。仄仄平平平仄仄。仄仄仄平平仄。,0,34,36,70,"[4, 6, 3, 5, 4, 7, 6, 4, 6, 3, 5, 4, 7, 6]"
望梅花 ,蒲宗孟,仄平平仄。仄仄仄平平仄。平仄仄平平仄仄，仄仄平平平仄。平仄仄平平仄仄，仄仄平平仄仄。仄平平仄。仄仄仄平平仄。仄仄仄平平仄仄，仄仄平平仄仄。平仄平平平仄仄，仄仄平平平仄。,0,30,42,72,"[4, 6, 7, 6, 7, 6, 4, 6, 7, 6, 7, 6]"
望梅花 ,张雨,平仄平平平仄。平平仄、仄平平仄。仄仄平平，平平平仄，仄仄平平平仄。平平仄。仄仄平平，平仄仄、平平仄仄。平仄仄平平仄。仄仄仄、仄平仄仄。平仄平平，平平平仄，平仄仄平平仄。平仄仄。仄仄平平，仄仄仄、平平仄仄。,0,41,41,82,"[6, 3, 4, 4, 4, 6, 3, 4, 3, 4, 6, 3, 4, 4, 4, 6, 3, 4, 3, 4]"
醉太平 ,刘过,平平仄平。平平仄平。仄平平仄平平。仄平平仄平。平平仄平。平平仄平。仄平平仄平平。仄仄平仄平。,0,25,13,38,"[4, 4, 6, 5, 4, 4, 6, 5]"
醉太平 ,辛弃疾,仄平仄仄。平平仄仄。仄平平仄仄平仄。仄平平仄仄。平平平仄平平仄。平仄仄，平平仄。仄仄平平仄平仄。仄平平仄仄。,0,21,24,45,"[4, 4, 7, 5, 7, 3, 3, 7, 5]"
醉太平 ,无名氏,平平仄平。仄仄平平。仄平平仄仄平平。仄平平仄平。仄平平仄平平仄。仄平平仄平平仄。仄平平仄仄平平。仄平平仄平。,0,27,19,46,"[4, 4, 7, 5, 7, 7, 7, 5]"
上行杯 ,孙光宪,仄仄平平平仄，平仄仄、仄仄平平。平仄平平平仄仄。平平仄仄。仄平平，平仄仄。仄仄。平仄。平仄平平。,0,19,19,38,"[6, 3, 4, 7, 4, 3, 3, 2, 2, 4]"
上行杯 ,孙光宪,平仄平平仄仄。平仄仄、仄平平仄。仄仄平平平仄仄。平平仄仄。仄平平，平仄仄。仄仄。平仄仄。平仄平仄。,0,17,22,39,"[6, 3, 4, 7, 4, 3, 3, 2, 3, 4]"
上行杯 ,韦庄,平仄仄平平仄。仄平平、仄平平仄。仄仄平平平仄仄。平仄仄平平仄。平仄仄平平仄仄。平仄。平仄仄，仄平仄。,0,19,22,41,"[6, 3, 4, 7, 6, 7, 2, 3, 3]"
感恩多 ,牛峤,仄平平仄仄。平仄平平仄。仄平平仄平。仄平平。仄仄平平仄仄，仄平平。仄平平。仄仄平平，仄平平仄平。,0,21,18,39,"[5, 5, 5, 3, 6, 3, 3, 4, 5]"
感恩多 ,牛峤,仄平平仄仄。平仄平平仄。仄平平仄平。仄平平。仄仄平平仄平仄，仄平平。仄平平。仄仄平平，仄平平仄平。,0,22,18,40,"[5, 5, 5, 3, 7, 3, 3, 4, 5]"
长命女 ,冯延巳,平仄仄。仄仄仄平平仄仄。仄仄平平仄。仄仄平平平仄，仄仄仄平平仄。平仄平平平仄仄。仄仄平平仄。,0,16,23,39,"[3, 7, 5, 6, 6, 7, 5]"
春光好 ,和凝,平平仄，仄平平。仄平平。仄仄仄平平仄，仄平平。仄仄仄平平仄，平平仄仄平平。平仄平平平仄仄，仄平平。,0,22,18,40,"[3, 3, 3, 6, 3, 6, 6, 7, 3]"
春光好 ,和凝,平仄仄，仄平平。仄平平。平仄平平仄仄平。仄平平。平仄平平平仄，平平仄仄仄平。平仄平平平仄仄，仄平平。,0,24,17,41,"[3, 3, 3, 7, 3, 6, 6, 7, 3]"
春光好 ,欧阳炯,平平仄，仄平平。仄平平。仄仄仄平平仄仄，仄平平。仄仄平平仄仄，平平仄仄平平。平仄平平平仄仄，仄平平。,0,22,19,41,"[3, 3, 3, 7, 3, 6, 6, 7, 3]"
春光好 ,张元干,平仄仄，仄平平。仄平平。仄仄仄平平仄仄，仄平平。平仄仄仄平平。仄平仄仄平平。仄仄平平平仄仄，仄平平。,0,20,21,41,"[3, 3, 3, 7, 3, 6, 6, 7, 3]"
春光好 ,晏几道,平平仄，仄平平。仄平平。平仄仄平平仄仄，仄平平。仄仄平仄平平。平平仄、仄仄平平。仄仄平平平仄仄，仄平平。,0,23,19,42,"[3, 3, 3, 7, 3, 6, 3, 4, 7, 3]"
春光好 ,无名氏,平平仄仄平平。仄平平。仄仄平平平仄仄，仄平平。平仄仄仄平平。平平仄、仄仄平平。平仄平平平仄仄，仄平平。,0,24,18,42,"[6, 3, 7, 3, 6, 3, 4, 7, 3]"
春光好 ,蔡伸,平平仄，仄平平。仄平平。平仄平平平仄仄，仄平平。平平仄仄平平。平平仄、平仄平平。仄仄平平平仄仄，仄仄平平。,0,26,17,43,"[3, 3, 3, 7, 3, 6, 3, 4, 7, 4]"
春光好 ,无名氏,平平仄仄平平。平仄仄、平平仄平。仄仄平平平仄仄，仄仄平平。平平仄仄平平。仄平仄、平平仄平。平仄平平平仄仄，仄仄平平。,0,27,21,48,"[6, 3, 4, 7, 4, 6, 3, 4, 7, 4]"
酒泉子 ,温庭筠,平仄仄平。平仄仄平平仄。仄平平，平仄仄。平平平。仄平平仄仄平仄。仄平平仄仄。仄平平，平仄仄。仄平平。,0,21,19,40,"[4, 6, 3, 3, 3, 7, 5, 3, 3, 3]"
酒泉子 ,孙光宪,仄仄仄平，仄仄平平仄仄。仄平平，平仄仄。仄平平。仄平平仄平平仄。仄平平仄仄。仄仄平，平仄仄。仄平平。,0,18,22,40,"[4, 6, 3, 3, 3, 7, 5, 3, 3, 3]"
酒泉子 ,温庭筠,仄仄仄平。平仄仄平平仄。仄平平，平仄仄。仄平平。仄平平仄平平仄。平仄平仄仄。仄仄平，平仄仄。仄平平。,0,19,21,40,"[4, 6, 3, 3, 3, 7, 5, 3, 3, 3]"
酒泉子 ,韦庄,仄仄平平。平仄仄平平仄。仄平平，平仄仄。仄平平。仄平平仄平平仄。仄仄平平平仄。仄平平，平仄仄。仄平平。,0,22,19,41,"[4, 6, 3, 3, 3, 7, 6, 3, 3, 3]"
酒泉子 ,李珣,仄仄平平。平仄仄平平仄仄。仄平平，平仄仄。仄平平。平平仄仄平平仄。仄仄仄平平仄仄。仄平平，平仄仄。仄平平。,0,21,22,43,"[4, 7, 3, 3, 3, 7, 7, 3, 3, 3]"
酒泉子 ,顾夐,平仄仄平。平仄平平平仄。仄平平，平仄仄。仄平平。仄平平仄仄平平。仄平平仄仄。仄平平，平仄仄。仄平平。,0,22,18,40,"[4, 6, 3, 3, 3, 7, 5, 3, 3, 3]"
酒泉子 ,温庭筠,平仄仄平。平仄仄平平仄。仄平平，平仄仄。仄平平。仄平平仄仄平平。平仄仄平平仄。仄平平，平仄仄。仄平平。,0,22,19,41,"[4, 6, 3, 3, 3, 7, 6, 3, 3, 3]"
酒泉子 ,张泌,平仄仄平。平仄仄平平仄仄。仄平平，平仄仄。仄平平。仄平平仄仄平平。平仄仄平平仄仄。仄平平，平仄仄。仄平平。,0,22,21,43,"[4, 7, 3, 3, 3, 7, 7, 3, 3, 3]"
酒泉子 ,顾夐,仄仄平平。仄仄仄平平仄。仄平平，平仄仄。仄平平。仄平平仄平平仄。仄仄平平平仄仄。仄平平，平仄仄。仄平平。,0,21,21,42,"[4, 6, 3, 3, 3, 7, 7, 3, 3, 3]"
酒泉子 ,顾夐,仄仄平平。仄仄仄平平仄仄。平平平仄。仄平平。仄平平。平平平仄平平仄。仄仄平平平仄仄。仄平平，平仄仄。仄平平。,0,24,20,44,"[4, 7, 4, 3, 3, 7, 7, 3, 3, 3]"
酒泉子 ,冯延巳,平仄平平。仄仄平平平仄仄。平平平，平平仄。仄平平。平平平仄仄平平。仄仄仄平平仄。仄平平，平仄仄。仄平平。,0,25,17,42,"[4, 7, 3, 3, 3, 7, 6, 3, 3, 3]"
酒泉子 ,冯延巳,平仄平平。平仄仄平平仄仄。仄平平，平平仄，仄平平。平平平仄仄平平。平仄平平平仄。仄平平，平仄仄，仄平平。,0,26,16,42,"[4, 7, 3, 3, 3, 7, 6, 3, 3, 3]"
酒泉子 ,司空图,仄仄仄平，仄仄平平平仄仄。仄平平仄仄平平。仄平平。仄平仄仄仄平平。仄仄平平平仄仄。平平仄仄仄平平。仄平平。,0,22,23,45,"[4, 7, 7, 3, 7, 7, 7, 3]"
酒泉子 ,顾夐,仄仄仄平，平仄仄平平仄仄。仄平平仄仄平平。仄平平。仄平平仄仄平平。平平平仄仄。平平仄仄仄平平。仄平平。,0,23,20,43,"[4, 7, 7, 3, 7, 5, 7, 3]"
酒泉子 ,牛峤,仄仄仄平，平仄仄平平仄仄，仄平平。平仄仄，仄平平。仄平平仄仄平仄。平仄平平仄。仄平平仄仄平仄。仄平平。,0,20,22,42,"[4, 7, 3, 3, 3, 7, 5, 7, 3]"
酒泉子 ,顾夐,仄仄平平，平仄仄平平仄仄。平平仄仄。仄平平。仄平平。平平仄仄仄平平。仄平平仄仄，平平仄仄仄平平。仄平平。,0,23,20,43,"[4, 7, 4, 3, 3, 7, 5, 7, 3]"
酒泉子 ,张泌,仄仄平平，平仄仄平平仄，仄平仄仄仄平平。仄平平。平平平仄仄平平。仄仄仄平平仄，仄平仄仄仄平平。仄平平。,0,22,21,43,"[4, 6, 7, 3, 7, 6, 7, 3]"
酒泉子 ,毛文锡,仄仄平平，仄仄平平平仄仄，仄平平仄仄平平。仄平平。仄平平仄仄平平。平仄仄平平仄仄，仄平平仄仄平平。仄平平。,0,24,21,45,"[4, 7, 7, 3, 7, 7, 7, 3]"
酒泉子 ,李珣,平仄平平，平仄仄平平仄，仄平平仄仄平平。仄平平。平平仄仄仄平平。仄仄平平平仄仄，仄平平，仄平仄，仄平平。,0,24,19,43,"[4, 6, 7, 3, 7, 7, 3, 3, 3]"
酒泉子 ,冯延巳,平仄平平。平仄平平平仄仄，平仄平，平仄仄，仄平平。仄平平仄仄平平。平平平平平仄，平平平，平仄仄，仄平平。,0,27,15,42,"[4, 7, 3, 3, 3, 7, 6, 3, 3, 3]"
酒泉子 ,顾夐,仄仄平平，仄仄仄平平仄仄，仄平仄仄仄平平。仄平平。平平平仄仄平平。仄平平仄仄，仄平仄仄仄平平。仄平平。,0,21,22,43,"[4, 7, 7, 3, 7, 5, 7, 3]"
酒泉子 ,李珣,平仄平平，仄仄仄平平仄，仄平平仄仄平平。仄平平。平仄仄，仄平平。平仄仄平平仄，仄平平仄仄平平。仄平平。,0,23,19,42,"[4, 6, 7, 3, 3, 3, 6, 7, 3]"
怨回纥 ,皇甫松,仄仄仄平仄，平平仄仄平。仄平平仄仄，平仄仄平平。平仄平平仄，平平平仄平。仄平平仄仄，平仄仄平平。,0,21,19,40,"[5, 5, 5, 5, 5, 5, 5, 5]"
怨回纥 ,无名氏,平平仄仄仄平平。平平仄仄仄平平。仄仄平平平仄仄，平平仄仄仄平平。仄仄平平仄，平平仄仄仄平平。,0,21,19,40,"[7, 7, 7, 7, 5, 7]"
生查子 ,韩偓,仄仄仄平平，仄仄平平仄。仄平仄仄平，仄仄平平仄。仄仄仄平平，平仄平平仄。平仄仄平平，平平仄平仄。,0,19,21,40,"[5, 5, 5, 5, 5, 5, 5, 5]"
生查子 ,刘侍读,平平平仄平，仄仄平平仄。仄仄仄平平，仄仄平平仄。仄平平仄仄。仄仄平平仄。平仄仄平平，平仄平平仄。,0,20,20,40,"[5, 5, 5, 5, 5, 5, 5, 5]"
生查子 ,牛希济,平平平仄平，平仄平平仄。平仄仄平平，仄仄平平仄。仄仄平，平仄仄。平仄平平仄。仄仄仄平平，仄仄平平仄。,0,21,20,41,"[5, 5, 5, 5, 3, 3, 5, 5, 5]"
生查子 ,孙光宪,仄仄仄平平，仄仄平平仄。平仄仄平平，仄仄平平仄。平平仄仄仄平平，仄仄平平仄。平仄仄平平，仄仄平平仄。,0,20,22,42,"[5, 5, 5, 5, 7, 5, 5, 5]"
生查子 ,张泌,平仄平，仄平仄。平仄平平仄。平仄仄平平，平仄平平仄。平仄平，平仄仄。平仄平平仄。仄仄仄平平，平仄平平仄。,0,23,19,42,"[3, 3, 5, 5, 5, 3, 3, 5, 5, 5]"
蝴蝶儿 ,张泌,平仄平。仄平平。仄平平仄仄平平。仄平仄仄平。平仄平平仄，平平仄仄平。平平平仄仄平平。仄平平仄平。,0,24,16,40,"[3, 3, 7, 5, 5, 5, 7, 5]"
添声杨柳枝 ,顾夐,平仄平平仄仄平。仄平平。平平平仄仄平平。仄平平。仄仄仄平平仄仄。平平仄。仄平平仄仄平平。仄平平。,0,23,17,40,"[7, 3, 7, 3, 7, 3, 7, 3]"
添声杨柳枝 ,贺铸,仄仄平平平仄平。仄平平。仄平平仄仄平平。仄平平。平仄平平平仄仄，仄平平。平平平仄仄平平。仄平平。,0,25,15,40,"[7, 3, 7, 3, 7, 3, 7, 3]"
添声杨柳枝 ,朱敦儒,平平仄，仄平。平仄仄，仄平。仄仄平平平仄平。仄平平。仄平。仄仄平。仄平。仄平平。仄平。平仄平平仄仄平。仄平平。仄平。,0,24,20,44,"[3, 2, 3, 2, 7, 3, 2, 3, 2, 3, 2, 7, 3, 2]"
醉公子 ,顾夐,平仄平平仄。平仄平平仄。仄仄仄平平。平平仄仄平。仄仄平平仄。仄仄平平仄。平仄仄平平。平平仄仄平。,0,21,19,40,"[5, 5, 5, 5, 5, 5, 5, 5]"
醉公子 ,尹鹗,仄平平仄仄。仄平平仄仄。仄仄仄平平。平平仄仄平。平平平仄仄。仄平平仄仄。平仄仄平平。平平平仄平。,0,21,19,40,"[5, 5, 5, 5, 5, 5, 5, 5]"
醉公子 ,顾夐,仄仄平平仄。仄平平仄仄。平仄仄平平。仄平平仄平。仄平平仄仄。平平平仄仄。仄仄仄平平。平平仄仄平。,0,20,20,40,"[5, 5, 5, 5, 5, 5, 5, 5]"
醉公子 ,史达祖,平平平平仄。平平平仄，仄仄平仄。仄仄平平，仄仄平平，仄仄平仄。平仄仄。仄平平、仄仄平仄，平仄平仄。仄平平平仄，平仄仄平，平仄仄平仄。平平仄平平平仄。仄仄仄平平、仄平仄。仄仄平平，仄仄平平，平仄平仄。平仄仄。仄平平、仄平平仄，平仄平仄。仄平仄、平仄平平，仄平平仄仄。,0,53,53,106,"[5, 4, 4, 4, 4, 4, 3, 3, 4, 4, 5, 4, 5, 7, 5, 3, 4, 4, 4, 3, 3, 4, 4, 3, 4, 5]"
昭君怨 ,万俟咏,平仄平平仄仄。平仄平平平仄。仄仄仄平平。仄平平。仄仄平平平仄。仄仄仄平平仄。平仄仄平平。仄平平。,0,21,19,40,"[6, 6, 5, 3, 6, 6, 5, 3]"
昭君怨 ,蔡伸,仄仄平平平仄。平仄平平平仄。仄仄仄平平。仄平平。仄仄平平仄。仄仄仄平平仄。平仄仄平平。仄平平。,0,20,19,39,"[6, 6, 5, 3, 5, 6, 5, 3]"
昭君怨 ,周紫芝,仄仄平平平仄。平仄仄平平仄。仄仄仄平平。仄平平。平仄仄。平仄仄。平仄平平仄仄。平仄仄平平。仄平平。,0,20,20,40,"[6, 6, 5, 3, 3, 3, 6, 5, 3]"
玉蝴蝶 ,温庭筠,平平平仄平平。平仄仄平平。仄仄仄平平。平平仄仄平。平平平仄仄，平仄仄平平。平仄仄平平。仄平平仄平。,0,25,16,41,"[6, 5, 5, 5, 5, 5, 5, 5]"
玉蝴蝶 ,孙光宪,平仄仄，仄平平。仄平平仄平。仄仄仄平平。平平仄仄平。平平仄。平平仄。平仄仄平平。平仄仄平平。仄平平仄平。,0,24,18,42,"[3, 3, 5, 5, 5, 3, 3, 5, 5, 5]"
玉蝴蝶 ,柳永,仄仄仄平平仄，平平仄仄，仄仄平平。仄仄平平，平仄仄仄平平。仄平平、平平仄仄，仄仄仄、平仄平平。仄平平。仄平平仄，平仄平平。平平。平平仄仄，仄平平仄，仄仄平平。仄仄平平，仄平平仄仄平平。仄平仄、平平仄仄，仄仄平、平仄平平。仄平平。仄平平仄，仄仄平平。,0,52,47,99,"[6, 4, 4, 4, 6, 3, 4, 3, 4, 3, 4, 4, 2, 4, 4, 4, 4, 7, 3, 4, 3, 4, 3, 4, 4]"
玉蝴蝶 ,柳永,仄仄仄平平仄，仄平平仄，平仄平平。仄仄平平平仄，仄仄平平。仄平平、仄平仄仄，平仄仄、仄仄平平。仄平平。仄平平仄，仄仄平平。平平。仄平平仄，平平平仄，仄仄平平。仄仄平平仄仄，仄仄仄平平。仄平平、仄平仄仄，仄仄仄、平仄平平。仄平平。仄平平仄，仄仄平平。,0,49,50,99,"[6, 4, 4, 6, 4, 3, 4, 3, 4, 3, 4, 4, 2, 4, 4, 4, 6, 5, 3, 4, 3, 4, 3, 4, 4]"
玉蝴蝶 ,李之仪,仄仄平平平仄，仄平平仄，平仄平平。仄仄平平平仄，平仄平平。仄平平、平平仄仄，平仄仄、仄仄平平。仄平平。仄平平仄，平仄平平。平平。仄平仄仄，仄平平仄，平仄平平。平仄仄平平仄，仄仄平平。仄平平、平平仄仄，平仄仄、仄仄平平。仄平平。仄平平仄，平仄平平。,0,55,43,98,"[6, 4, 4, 6, 4, 3, 4, 3, 4, 3, 4, 4, 2, 4, 4, 4, 6, 4, 3, 4, 3, 4, 3, 4, 4]"
玉蝴蝶 ,张炎,平仄仄平平仄，仄平平仄，平仄平平。平仄平平，仄仄仄仄平平。仄平平、平平仄仄，平仄仄、平仄平平。仄平平。仄平仄仄，平仄平平。仄仄平平平仄，平平仄仄，平仄平平。仄仄平平，仄平平仄仄平平。仄仄仄、平平仄仄，仄平仄、平仄平平。仄平平。仄平平仄，平仄平平。,0,54,45,99,"[6, 4, 4, 4, 6, 3, 4, 3, 4, 3, 4, 4, 6, 4, 4, 4, 7, 3, 4, 3, 4, 3, 4, 4]"
玉蝴蝶 ,辛弃疾,仄仄仄平，平仄平平平仄，平仄平平。平仄平平仄仄，平仄平平。仄平平、平平仄仄，仄平仄、平仄平平。仄平平。平平平仄，仄仄平平。平平。平平仄仄，平平仄仄，平仄平平。仄仄平平，平平仄仄仄平平。仄平平、平平平仄，平仄仄、仄仄平平。仄平平。平平仄仄，仄仄平平。,0,58,41,99,"[4, 6, 4, 6, 4, 3, 4, 3, 4, 3, 4, 4, 2, 4, 4, 4, 4, 7, 3, 4, 3, 4, 3, 4, 4]"
女冠子 ,温庭筠,平平平仄。仄仄平平仄仄。仄平平。平仄平平仄，平平仄仄平。仄平平仄仄，平仄仄平平。仄仄平平仄，仄平平。,0,22,19,41,"[4, 6, 3, 5, 5, 5, 5, 5, 3]"
女冠子 ,康与之,仄平平仄。平平仄仄平仄。平平平仄。平平仄仄，仄平仄仄，平平平仄。平平平仄仄，仄仄平平，仄平平仄。仄平仄仄，仄仄平平，平平仄仄。仄平平、平仄平平仄。仄平平、平仄仄平平平仄。仄平平仄。仄仄平平仄，平平平仄。仄平平仄仄，仄平平仄，仄平平仄。仄平平仄，仄平平仄，平平平仄。,0,57,50,107,"[4, 6, 4, 4, 4, 4, 5, 4, 4, 4, 4, 4, 3, 5, 3, 7, 4, 5, 4, 5, 4, 4, 4, 4, 4]"
女冠子 ,李邴,仄平平仄。平平平仄平仄。平平平仄。仄平平仄，仄仄平平，平平平仄。平平平仄仄，仄仄仄平，仄仄仄平仄仄。仄仄平平仄仄仄，平仄仄平平仄。平平平仄平平仄。仄仄平平仄，仄仄平平仄。仄平平仄。仄仄仄仄仄，平平平仄。仄平平仄仄，仄平仄仄，仄仄平仄。仄仄平平仄，仄平平仄，仄平平仄。,0,50,60,110,"[4, 6, 4, 4, 4, 4, 5, 4, 6, 7, 6, 7, 5, 5, 4, 5, 4, 5, 4, 4, 5, 4, 4]"
女冠子 ,柳永,仄平平仄。平平仄、平平仄仄。仄平仄、仄仄平仄。仄平仄仄，仄平仄仄平平、仄平仄。平仄平平，仄平平仄平仄。仄平平平仄，平平仄仄，仄平平仄。仄仄仄平平，平平仄仄，仄仄平平仄仄，平平仄、平平仄仄。仄平仄仄，平仄平平仄平仄。仄仄平平，仄平平、仄平平仄。仄平平平仄，仄平仄仄，仄平平仄。,0,53,58,111,"[4, 3, 4, 3, 4, 4, 6, 3, 4, 6, 5, 4, 4, 5, 4, 6, 3, 4, 4, 7, 4, 3, 4, 5, 4, 4]"
女冠子 ,蒋捷,仄平平仄。仄平平仄平仄。平平平仄，仄平平仄，仄仄平平，平平平仄。平平平仄仄。仄仄仄平平仄，仄平平仄。仄平平、平仄仄仄，平仄平平平仄。平平平仄平平仄。仄平平平仄，仄仄平平仄。仄平平仄。仄仄仄仄仄，仄平平仄。平平平仄仄。仄仄仄平平仄，仄平平仄。仄仄平平仄，仄平平仄，仄平平仄。,0,56,56,112,"[4, 6, 4, 4, 4, 4, 5, 6, 4, 3, 4, 6, 7, 5, 5, 4, 5, 4, 5, 6, 4, 5, 4, 4]"
女冠子 ,柳永,仄平平仄。仄平平，平平仄。仄平仄、平平平仄。平平平仄，平平平仄，平平平仄。平平仄仄平仄。平平仄仄平平仄。平平仄仄，平平仄仄，平平仄仄。仄仄平平，平仄平平仄仄，仄仄仄仄平平仄。仄平平仄，仄平平、仄平仄仄，仄仄平平平仄。平平仄仄平仄。平平仄仄平平仄。仄平平仄，平平仄仄，平平仄仄。,0,60,53,113,"[4, 3, 3, 3, 4, 4, 4, 4, 6, 7, 4, 4, 4, 4, 6, 7, 4, 3, 4, 6, 6, 7, 4, 4, 4]"
女冠子 ,无名氏,平平仄仄。仄平平、仄仄平仄。平平仄仄仄。仄平平仄仄，仄仄平平，仄平平仄。仄平平平仄仄，仄仄平平，仄平平仄。仄平平仄，仄仄平平，仄平平仄。仄平平、平仄平平仄。仄平平、平平仄仄平平仄。仄平仄仄。仄平平仄仄，平仄仄平平仄。平平平仄仄，仄仄平平，仄平平仄。仄仄平、平仄仄仄，仄仄平平平仄。,0,55,59,114,"[4, 3, 4, 5, 5, 4, 4, 6, 4, 4, 4, 4, 4, 3, 5, 3, 7, 4, 5, 6, 5, 4, 4, 3, 4, 6]"
中兴乐 ,毛文锡,仄仄平平平仄平。平平仄仄平平。仄平仄。平仄。仄平平。平平仄仄平平仄。平平仄。仄平平仄。平仄。仄仄平平。,0,23,18,41,"[7, 6, 3, 2, 3, 7, 3, 4, 2, 4]"
中兴乐 ,牛希济,平平仄仄仄平平。平平仄仄平平。平仄平平，仄仄平平。平平平仄仄平。平平平。平平仄仄，仄平平仄，仄仄平平。,0,26,16,42,"[7, 6, 4, 4, 6, 3, 4, 4, 4]"
中兴乐 ,李珣,仄平仄仄仄平平。平平仄仄平平。仄平平仄，平仄平平。平平平仄平平。仄平平。仄平仄仄，平平仄仄，仄仄平平。平平平仄仄平平。仄平仄仄平平。仄平平仄，仄仄平平。仄平平仄平平。仄平平。仄平平仄，平平平仄，平仄平平。,0,50,34,84,"[7, 6, 4, 4, 6, 3, 4, 4, 4, 7, 6, 4, 4, 6, 3, 4, 4, 4]"
纱窗恨 ,毛文锡,平平仄仄平平仄。仄平平。仄平平仄平平仄。仄平平。仄平仄、仄仄平仄，平平仄、仄仄平平。仄仄平平，仄平平。,0,22,19,41,"[7, 3, 7, 3, 3, 4, 3, 4, 4, 3]"
纱窗恨 ,毛文锡,平平仄仄平平仄。仄平平。仄平仄仄平平仄。仄平平。仄平仄、仄平平仄，仄仄平、平仄平平。仄仄平平仄，仄平平。,0,22,20,42,"[7, 3, 7, 3, 3, 4, 3, 4, 5, 3]"
醉花间 ,毛文锡,平平仄。仄平仄。平仄平平仄。平仄仄平平，仄仄平平仄。平平平仄仄。仄仄平平仄。平平仄仄平，平仄平平仄。,0,22,19,41,"[3, 3, 5, 5, 5, 5, 5, 5, 5]"
醉花间 ,毛文锡,平平仄。仄平仄。平仄平平仄。平仄仄平平，平仄平平仄。仄仄仄平平，平平平仄仄。平仄仄平平，仄仄平平仄。,0,22,19,41,"[3, 3, 5, 5, 5, 5, 5, 5, 5]"
醉花间 ,冯延巳,平仄仄平平仄仄。平平平仄仄。平仄仄平平，平仄平平仄。平平平仄仄。仄仄平平仄。仄平平仄仄。平平仄仄仄平平，仄平平，平仄仄。,0,26,24,50,"[7, 5, 5, 5, 5, 5, 5, 7, 3, 3]"
点绛唇 ,冯延巳,仄仄平平，平平平仄平平仄。仄平平仄。平仄平平仄。仄仄平平，平仄平平仄。平仄仄。仄平平仄。平仄平平仄。,0,23,18,41,"[4, 7, 4, 5, 4, 5, 3, 4, 5]"
点绛唇 ,苏轼,仄仄平平，平平平仄。平平仄。平平仄仄。仄仄平平仄。仄仄平平，平仄平平仄。平平仄。仄平平仄。平仄平平仄。,0,23,18,41,"[4, 4, 3, 4, 5, 4, 5, 3, 4, 5]"
点绛唇 ,韩琦,仄仄平平，仄平平平仄平平仄。仄平平仄。仄仄平平仄。平仄平平，平平仄平平仄。平平仄。仄平平仄。平仄平平仄。,0,25,18,43,"[4, 8, 4, 5, 4, 6, 3, 4, 5]"
平湖乐 ,王恽,平平平仄仄平平。仄仄平平仄。仄仄平平仄平仄。仄平平。平平仄仄平平仄。仄平平仄，仄平平仄，平仄仄平平。,0,23,19,42,"[7, 5, 7, 3, 7, 4, 4, 5]"
平湖乐 ,张可久,平平平仄仄平平。平仄平平仄。平仄平平仄平仄。仄平平。平平仄仄平平仄。平平仄仄。平平平仄。平仄仄平平。,0,26,16,42,"[7, 5, 7, 3, 7, 4, 4, 5]"
平湖乐 ,王恽,仄平平仄仄平平。平仄平平仄。仄仄平平仄平仄。仄平平。仄平仄仄平平仄。平平仄仄，平平平仄，仄平仄、仄平平。,0,23,20,43,"[7, 5, 7, 3, 7, 4, 4, 3, 3]"
归国谣 ,温庭筠,平仄。仄仄仄平平仄仄。仄平平仄平仄。仄平平仄仄。仄仄仄平平仄。仄平平仄仄。仄平平仄平仄。仄平平仄仄。,0,17,25,42,"[2, 7, 6, 5, 6, 5, 6, 5]"
归国谣 ,韦庄,平仄仄。仄仄仄平平仄仄。平仄仄平平仄。平平平仄仄。平仄仄平平仄。仄平平仄仄。仄仄仄平平仄。仄平平仄仄。,0,18,25,43,"[3, 7, 6, 5, 6, 5, 6, 5]"
归国谣 ,颜奎,平平仄仄。平平平仄仄。仄平平仄平仄。仄平平仄仄。平平仄平平仄。仄平平仄仄。平平平仄平仄。仄平平仄仄。,0,22,20,42,"[4, 5, 6, 5, 6, 5, 6, 5]"
恋情深 ,毛文锡,仄仄平平平仄仄。仄平平仄。仄平平仄仄平平。仄平平。平平平仄仄平平。平仄仄平平。仄仄仄平平仄，仄平平。,0,23,19,42,"[7, 4, 7, 3, 7, 5, 6, 3]"
恋情深 ,毛文锡,仄仄平平平仄仄。仄平平仄。平平仄仄仄平平。仄平平。仄平平仄仄平平。仄仄仄平平。仄仄仄、平平仄，仄平平。,0,21,21,42,"[7, 4, 7, 3, 7, 5, 3, 3, 3]"
赞浦子 ,毛文锡,仄仄平平仄，平平仄仄平。仄仄平平仄，平平仄仄平。仄仄平平仄仄，仄平仄仄平平。仄仄平平仄，平平仄仄平。,0,20,22,42,"[5, 5, 5, 5, 6, 6, 5, 5]"
浣溪沙 ,韩偓,仄仄平平仄仄平。仄平平仄仄平平。平平仄仄仄平平。平仄仄平平仄仄，仄平平仄仄平平。仄平平仄仄平平。,0,22,20,42,"[7, 7, 7, 7, 7, 7]"
浣溪沙 ,薛昭蕴,平仄仄平平仄仄，仄平平仄仄平平。仄平平仄仄平平。仄仄平平平仄仄，仄平平仄仄平平。仄平平仄仄平平。,0,22,20,42,"[7, 7, 7, 7, 7, 7]"
浣溪沙 ,孙光宪,平仄平平仄仄平。仄平平仄仄平平。仄平平仄仄平平。平仄仄平平仄仄，平平平仄仄平平。仄平平，平仄仄，仄平平。,0,25,19,44,"[7, 7, 7, 7, 7, 3, 3, 3]"
浣溪沙 ,顾夐,平仄平平仄仄平。仄平平仄仄平平。平仄平，仄仄仄，仄平平。仄仄仄平平仄仄，平平平仄仄平平。仄平平，平仄仄，仄平平。,0,24,22,46,"[7, 7, 3, 3, 3, 7, 7, 3, 3, 3]"
浣溪沙 ,李煜,平仄仄平平仄仄。平平仄仄平平仄。平仄仄平平仄仄。平平仄仄平平仄。仄仄平平平仄仄。仄仄平平平仄仄。,0,20,22,42,"[7, 7, 7, 7, 7, 7]"
醉垂鞭 ,张先,仄仄仄平平。平平仄。平平仄。仄仄仄平平。仄平平仄平。平平平仄仄。平平仄。仄平平。仄仄仄平平。平平平仄平。,0,24,18,42,"[5, 3, 3, 5, 5, 5, 3, 3, 5, 5]"
雪花飞 ,黄庭坚,平仄平平仄仄，平平仄仄平平。平仄平平仄仄，平仄平平。平仄平平仄，平平仄仄平。平仄平平仄仄，仄仄平平。,0,24,18,42,"[6, 6, 6, 4, 5, 5, 6, 4]"
沙塞子 ,朱敦儒,仄仄平平平仄，平仄仄，仄平平。仄仄仄平平仄，仄平平。仄仄平平平仄，平仄仄，仄平平。平仄平平平仄，仄平平。,0,22,20,42,"[6, 3, 3, 6, 3, 6, 3, 3, 6, 3]"
沙塞子 ,葛立方,平平仄仄平平。仄仄仄、平平仄平。平仄仄、仄平平仄，仄仄平平。平平平仄仄平平。仄仄仄、平平仄平。平平仄、仄平平仄，仄仄平平。,0,26,23,49,"[6, 3, 4, 3, 4, 4, 7, 3, 4, 3, 4, 4]"
沙塞子 ,周紫芝,仄平平仄仄平平。仄平仄、平仄平平。仄平仄、仄平平仄，仄仄平平。仄平平仄仄平平。仄仄仄、平仄平平。平平仄、仄平平仄，仄仄平平。,0,26,24,50,"[7, 3, 4, 3, 4, 4, 7, 3, 4, 3, 4, 4]"
沙塞子 ,赵彦端,平仄仄平平仄。仄仄仄、平平仄仄。仄平平、仄仄平平，平平平仄。平平仄仄平仄仄。仄平仄、平平仄仄。仄平平、仄平平仄，平平平仄。,0,25,24,49,"[6, 3, 4, 3, 4, 4, 7, 3, 4, 3, 4, 4]"
殿前欢 ,张可久,仄平平。仄平平仄仄平平。平平仄仄平平仄。平仄平平。平平仄仄平。平平仄。仄仄平平仄。仄平平仄，仄仄平平。,0,24,18,42,"[3, 7, 7, 4, 5, 3, 5, 4, 4]"
殿前欢 ,张可久,仄平平。仄平平仄仄平平。平平仄仄平平仄。仄仄平平。平平仄仄平。平仄平平仄。仄仄平平仄。平平仄仄，仄仄平平。,0,24,20,44,"[3, 7, 7, 4, 5, 5, 5, 4, 4]"
水仙子 ,张可久,平平仄仄仄平平。仄仄平平仄仄平。平平仄仄平平仄。平平仄仄平。仄平仄仄平平。平平仄。仄仄平。平仄平平。,0,23,19,42,"[7, 7, 7, 5, 6, 3, 3, 4]"
水仙子 ,倪瓒,平平平仄仄平平。平仄平平仄仄平。平平仄仄平平仄。平平仄仄平。平平仄仄平平。平平平仄，平平仄平。仄仄平平。,0,28,16,44,"[7, 7, 7, 5, 6, 4, 4, 4]"
霜天晓角 ,林逋,平平平仄。仄仄平平仄。仄仄仄平平仄，平平仄、平平仄。仄仄。平仄仄。仄平平仄仄。仄仄平平平仄，仄仄仄、平平仄。,0,19,24,43,"[4, 5, 6, 3, 3, 2, 3, 5, 6, 3, 3]"
霜天晓角 ,辛弃疾,平平仄仄。仄仄平平仄。平仄仄平平仄，平平仄、平平仄。仄平平仄仄。仄平平仄仄。平仄仄平平仄，仄仄仄、平平仄。,0,20,23,43,"[4, 5, 6, 3, 3, 5, 5, 6, 3, 3]"
霜天晓角 ,赵师侠,仄平平仄。仄仄平平仄。平仄平平平仄。平平仄、仄平仄。仄平平仄仄。平仄平平仄。仄仄平平平仄。平仄仄、仄平仄。,0,21,22,43,"[4, 5, 6, 3, 3, 5, 5, 6, 3, 3]"
霜天晓角 ,葛长庚,仄平平仄。平仄平平仄。仄仄平平平仄。平仄仄。平仄仄。仄仄。平仄仄。仄仄平平仄。仄仄平平仄仄，平平仄。仄平仄。,0,18,25,43,"[4, 5, 6, 3, 3, 2, 3, 5, 6, 3, 3]"
霜天晓角 ,程垓,仄仄仄平仄。仄平平仄仄。仄仄仄平平仄，平平仄、仄平仄。平仄仄平仄。仄平平仄仄。仄仄平平平仄，平平仄、仄平仄。,0,18,26,44,"[5, 5, 6, 3, 3, 5, 5, 6, 3, 3]"
霜天晓角 ,吴文英,平平平仄仄。平仄平仄仄。平仄平平平仄，平平仄、仄平仄。仄仄。平仄仄。仄平平仄仄。仄仄平平平仄，平平仄、仄平仄。,0,21,23,44,"[5, 5, 6, 3, 3, 2, 3, 5, 6, 3, 3]"
霜天晓角 ,黄机,仄仄平平。仄平平仄平。仄仄平平平仄，仄仄仄、仄平平。仄平平仄平。仄平平仄平。平仄仄平平仄，平仄仄、仄平平。,0,22,21,43,"[4, 5, 6, 3, 3, 5, 5, 6, 3, 3]"
霜天晓角 ,蒋捷,平仄平平。仄平平仄平。仄仄平平仄仄，平仄仄、仄平平。平平。平仄平。仄平平仄平。仄仄仄平平仄，平仄仄、仄平平。,0,23,20,43,"[4, 5, 6, 3, 3, 2, 3, 5, 6, 3, 3]"
霜天晓角 ,赵长卿,仄平平仄仄，平平仄仄平。仄仄仄平平仄，平平仄、仄平平。仄仄仄仄仄，仄仄平仄平。仄仄仄平仄仄，平仄仄、仄平平。,0,17,27,44,"[5, 5, 6, 3, 3, 5, 5, 6, 3, 3]"
清商怨 ,晏殊,平平平仄仄仄仄。仄仄平仄仄。仄仄平平，平平平仄仄。平平平平仄仄。仄仄仄、仄平平仄。仄仄平平，平平平仄仄。,0,20,23,43,"[7, 5, 4, 5, 6, 3, 4, 4, 5]"
清商怨 ,周邦彦,平平平仄仄仄。仄仄平平仄。仄仄平平，仄平平仄仄。平平平仄仄仄。仄仄平、平仄平仄。仄仄平平，平平平仄仄。,0,20,22,42,"[6, 5, 4, 5, 6, 3, 4, 4, 5]"
清商怨 ,沈会宗,平仄平平仄仄。仄仄平平仄。仄仄平平，平平平仄仄。平仄平平仄仄。平仄仄、仄仄平平仄。仄仄平平，平平平仄仄。,0,21,22,43,"[6, 5, 4, 5, 6, 3, 5, 4, 5]"
伤春怨 ,王安石,仄仄平平仄。仄仄平平平仄。仄仄仄平平，仄仄平平平仄。仄平平平仄。仄仄平平仄。仄仄仄平平，仄仄仄、平平仄。,0,19,24,43,"[5, 6, 5, 6, 5, 5, 5, 3, 3]"
菩萨蛮 ,李白,平平仄仄平平仄。平平仄仄平平仄。仄仄仄平平。仄平平仄平。仄平平仄仄。仄仄平平仄。平仄仄平平。平平平仄平。,0,24,20,44,"[7, 7, 5, 5, 5, 5, 5, 5]"
菩萨蛮 ,朱敦儒,平平仄仄平平仄。平平仄仄平平仄。平仄仄平平。仄平平仄平。仄平平仄仄。平仄平平仄。仄仄仄平平。仄平平仄平。,0,24,20,44,"[7, 7, 5, 5, 5, 5, 5, 5]"
菩萨蛮 ,楼扶,平平平仄平平仄。仄平平仄平平仄。平仄仄平平。平平仄仄平。仄平平仄仄。仄仄平平仄。仄仄仄平平。仄平平仄平。,0,24,20,44,"[7, 7, 5, 5, 5, 5, 5, 5]"
采桑子 ,和凝,平平仄仄平平仄，仄仄平平。平仄平平。仄仄平平仄仄平。平平平仄平平仄，平仄平平。平仄平平。平仄平平仄仄平。,0,27,17,44,"[7, 4, 4, 7, 7, 4, 4, 7]"
采桑子 ,李清照,平平平仄平平仄，平仄平平。平仄平平。仄仄平平、平仄仄平平。平平仄仄平平仄，仄仄平平。仄仄平平。平仄平平、仄仄仄平平。,0,29,19,48,"[7, 4, 4, 4, 5, 7, 4, 4, 4, 5]"
采桑子 ,朱淑真,平平仄仄平平仄，仄仄平平。平仄平平。仄仄平平仄仄平。平仄仄平平。仄平平仄平平仄，仄仄平平。平仄平平。平仄平平仄仄平，仄仄仄平平。,0,30,24,54,"[7, 4, 4, 7, 5, 7, 4, 4, 7, 5]"
后庭花 ,毛熙震,平平仄仄平平仄。仄平平仄。仄平平仄平平仄。仄平平仄。平平仄仄平平仄。仄平平仄。平平平仄平平仄。仄平平仄。,0,25,19,44,"[7, 4, 7, 4, 7, 4, 7, 4]"
后庭花 ,孙光宪,仄平平仄平平仄。仄平平仄。平平平仄平平仄。仄仄平仄。仄平平仄仄、平平仄。仄仄平平仄。平平仄仄平平仄。仄平平仄。,0,24,22,46,"[7, 4, 7, 4, 5, 3, 5, 7, 4]"
后庭花 ,孙光宪,仄平平仄平平仄。仄平平仄。仄仄平平平仄仄。仄仄平仄。仄平平仄仄、仄平平仄。仄平平仄。仄仄平平平仄仄。仄仄平仄。,0,20,26,46,"[7, 4, 7, 4, 5, 4, 4, 7, 4]"
后庭花 ,张先,平平仄仄平平仄。仄平平仄。平平仄仄平平，仄仄平平仄。仄平平仄平平仄。仄平平仄。仄平平仄平平，仄平平平仄。,0,25,19,44,"[7, 4, 6, 5, 7, 4, 6, 5]"
诉衷情令 ,晏殊,平平仄仄仄平平。平仄仄平平。仄平平仄平仄，平仄仄平平。平仄仄，仄平平。仄平平。仄平平仄，平仄平平，平仄平平。,0,26,18,44,"[7, 5, 6, 5, 3, 3, 3, 4, 4, 4]"
诉衷情令 ,欧阳修,平平平仄仄平平。平仄仄平平。平平仄仄平仄，仄仄仄、仄平平。平仄仄，仄平平。仄平平。仄平平仄，仄仄平平，仄仄平平。,0,24,21,45,"[7, 5, 6, 3, 3, 3, 3, 3, 4, 4, 4]"
诉衷情令 ,张元干,仄平仄仄仄平平。平仄仄平平。平平仄仄平平仄，仄仄仄平平。平仄仄，仄平平。仄平平。平平平仄，仄仄平平，仄仄平平。,0,24,21,45,"[7, 5, 7, 5, 3, 3, 3, 4, 4, 4]"
减字木兰花 ,欧阳修,平平仄仄。平仄平平平仄仄。平仄平平。仄仄平平仄仄平。平平仄仄。平仄平平平仄仄。平仄平平。仄仄平平仄仄平。,0,24,20,44,"[4, 7, 4, 7, 4, 7, 4, 7]"
卜算子 ,苏轼,仄仄仄平平，仄仄平平仄。平仄平平仄仄平，仄仄平平仄。平仄仄平平，仄仄平平仄。仄仄平平仄仄平，仄仄平平仄。,0,20,24,44,"[5, 5, 7, 5, 5, 5, 7, 5]"
卜算子 ,石孝友,仄仄平平仄。仄仄平平仄。仄仄平平仄仄平，仄仄平平仄。仄仄平平仄。仄仄平平仄。仄仄平平仄仄平，仄仄平平仄。,0,18,26,44,"[5, 5, 7, 5, 5, 5, 7, 5]"
卜算子 ,徐俯,平平平仄平，仄仄平平仄。仄仄平平仄仄平，仄仄平平仄。仄仄平平仄。平仄平平仄。平仄平平仄仄平，平仄仄、平平仄。,0,23,22,45,"[5, 5, 7, 5, 5, 5, 7, 3, 3]"
卜算子 ,黄公度,仄仄仄平平，仄仄平平仄。平仄平平仄仄平，仄平仄、平平仄。平仄仄平平，平仄平平仄。平仄平平仄仄平，仄仄平平仄。,0,23,22,45,"[5, 5, 7, 3, 3, 5, 5, 7, 5]"
卜算子 ,张先,仄仄平仄平，仄仄平平仄。平仄平平仄仄平，仄仄仄、平平仄。平平平仄仄。平仄平平仄。平仄平平平仄平，仄仄仄、平平仄。,0,23,23,46,"[5, 5, 7, 3, 3, 5, 5, 7, 3, 3]"
卜算子 ,杜安世,平仄平平仄。仄仄平平仄。仄仄平平平平仄，仄仄仄、平平仄。仄平仄平仄。仄仄平平仄。仄仄平平仄平仄，仄仄仄、平仄仄。,0,19,27,46,"[5, 5, 7, 3, 3, 5, 5, 7, 3, 3]"
卜算子 ,无名氏,平平仄仄平，仄仄平平仄。平仄平平仄仄平，平仄平平仄。仄仄仄平平，仄仄平平仄。仄仄平平仄仄平，平平仄仄平平仄。,0,23,23,46,"[5, 5, 7, 5, 5, 5, 7, 7]"
一落索 ,无名氏,仄仄平平平仄。仄平平仄。仄平平仄仄平平，平仄平平仄。仄仄平平平仄。平平平仄。仄平平仄仄平平，平仄平平仄。,0,25,19,44,"[6, 4, 7, 5, 6, 4, 7, 5]"
一落索 ,吕渭老,平仄平平仄仄。仄平平仄。平平仄仄仄平平，仄仄平平仄。仄仄仄平平仄。仄平平仄。平平仄仄仄平平，平仄仄、平平仄。,0,22,23,45,"[6, 4, 7, 5, 6, 4, 7, 3, 3]"
一落索 ,毛滂,仄仄平平平仄。仄平仄仄。仄平平仄仄平平，仄仄仄、平平仄。平仄仄平平仄。平平仄仄。平平仄仄仄平平，仄平仄、平平仄。,0,22,24,46,"[6, 4, 7, 3, 3, 6, 4, 7, 3, 3]"
一落索 ,张先,平平仄仄平平仄。仄平平仄。仄平平仄仄平平，仄仄仄、平平仄。平仄平平平仄。仄平平仄。仄平平仄仄平平，平仄仄、平平仄。,0,25,22,47,"[7, 4, 7, 3, 3, 6, 4, 7, 3, 3]"
一落索 ,秦观,平平平仄平仄。仄仄平平仄。仄平平仄仄平平，仄仄仄、平平仄。仄仄仄平平仄。仄平平平仄。仄平仄仄仄平平，仄仄仄、平平仄。,0,22,26,48,"[6, 5, 7, 3, 3, 6, 5, 7, 3, 3]"
一落索 ,严仁,平仄平平平仄。仄仄平平仄。仄平平仄仄平平，仄仄仄、平平平仄。仄仄仄平平仄。仄平平仄。仄平仄仄仄平平，仄仄仄、平平仄。,0,22,26,48,"[6, 5, 7, 3, 4, 6, 4, 7, 3, 3]"
一落索 ,陈凤仪,仄平平仄平平仄。仄平平平仄。仄平仄仄仄平平，仄仄仄、平平仄。仄仄仄平平仄。仄平平平仄。仄平仄仄仄平平，平仄仄、平平仄。,0,23,26,49,"[7, 5, 7, 3, 3, 6, 5, 7, 3, 3]"
一落索 ,欧阳修,平平仄仄平平仄。仄平平平仄。仄平平仄仄平平，仄仄仄、平平仄。仄平平仄平平仄。仄平平平仄。平平仄仄仄平平，仄平仄、平平仄。,0,27,23,50,"[7, 5, 7, 3, 3, 7, 5, 7, 3, 3]"
好时光 ,唐明皇,仄仄平平平仄，平仄仄、仄平平。平仄仄平平仄仄，平平仄仄平。仄仄平仄仄，仄仄仄、仄平平。仄仄平平仄，仄仄仄平平。,0,19,26,45,"[6, 3, 3, 7, 5, 5, 3, 3, 5, 5]"
谒金门 ,韦庄,平平仄。平仄仄平平仄。平仄平平平仄仄。仄平平仄仄。平仄仄平平仄。仄仄仄平平仄。仄仄仄平平仄仄。仄平平仄仄。,0,20,25,45,"[3, 6, 7, 5, 6, 6, 7, 5]"
谒金门 ,孙光宪,平仄仄。平仄仄平平仄。仄仄平平平仄仄。平平平仄仄。平仄平，平平仄。平仄仄平平仄。仄仄仄平平仄仄。平平平仄仄。,0,22,23,45,"[3, 6, 7, 5, 3, 3, 6, 7, 5]"
谒金门 ,周必大,平仄仄。仄仄仄、平平仄。平仄仄平平仄仄。平平平仄仄。仄仄平平平仄。仄仄仄、平平仄。平仄仄平平仄仄。平平平仄仄。,0,20,25,45,"[3, 3, 3, 7, 5, 6, 3, 3, 7, 5]"
谒金门 ,程过,平仄仄。平仄仄平平仄。仄仄平平平仄仄。仄仄平平仄。仄仄平平平仄仄。仄仄仄平平仄。平仄平平平仄仄。仄平平仄仄。,0,20,26,46,"[3, 6, 7, 5, 7, 6, 7, 5]"
柳含烟 ,毛文锡,平平仄，仄平平。仄仄平平仄仄，仄平平仄仄平平。仄平平。仄仄平平平仄仄。平仄平平仄仄。仄平平仄仄平平。仄平平。,0,24,21,45,"[3, 3, 6, 7, 3, 7, 6, 7, 3]"
杏园芳 ,尹鹗,平平仄仄平平。平平仄仄平平。平平仄仄仄平平。仄平平。平平仄仄平平仄，平平仄仄平平。平平平仄仄平平。仄平平。,0,29,16,45,"[6, 6, 7, 3, 7, 6, 7, 3]"
好事近 ,宋祁,仄仄仄平平，平仄仄平平仄。平仄仄平平仄，仄平平平仄。平平仄仄仄平平，平平仄平仄。仄仄仄平平仄，仄平平平仄。,0,23,22,45,"[5, 6, 6, 5, 7, 5, 6, 5]"
好事近 ,陆游,仄仄仄平平，平仄仄平平仄。仄仄仄平平仄。仄平平平仄。平平平仄仄平平，平仄仄平仄。平仄仄平平仄。仄平平平仄。,0,23,22,45,"[5, 6, 6, 5, 7, 5, 6, 5]"
华清引 ,苏轼,平平仄仄仄平平。仄仄平平。仄平平仄平仄，平平仄仄平。仄平仄仄仄平平。仄平平仄平平。仄平平仄仄，平仄仄平平。,0,24,21,45,"[7, 4, 6, 5, 7, 6, 5, 5]"
天门谣 ,贺铸,平仄平平仄。仄平仄、仄平平仄。平仄仄。仄平平平仄。仄仄仄平平平仄仄。仄仄平平平仄仄。平仄仄。仄仄仄、平平平仄。,0,20,25,45,"[5, 3, 4, 3, 5, 8, 7, 3, 3, 4]"
忆闷令 ,晏几道,仄仄平平平仄仄。仄平平平仄。平平仄仄平平，平仄平平仄。仄仄平平仄。仄平平平仄。仄平仄、仄仄平平，平仄平平仄。,0,24,21,45,"[7, 5, 6, 5, 5, 5, 3, 4, 5]"
散余霞 ,毛滂,平平平仄平平仄。仄仄平仄仄。平仄平仄平平，仄平平仄仄。平平仄平仄仄。仄仄平平仄。平仄仄仄平平，仄平平仄仄。,0,22,23,45,"[7, 5, 6, 5, 6, 5, 6, 5]"
好女儿 ,黄庭坚,仄仄仄平平。平仄仄平平。仄仄平平平仄，仄仄仄平平。仄仄仄平平。仄仄仄、平仄平平。平平平仄，平平仄仄，仄仄平平。,0,22,23,45,"[5, 5, 6, 5, 5, 3, 4, 4, 4, 4]"
好女儿 ,黄庭坚,平仄仄平平。仄平仄平平。仄仄平平平仄，平仄仄平平。平仄仄平平。仄平平、平仄平平。仄平平仄平平仄，仄仄仄平平。,0,26,19,45,"[5, 5, 6, 5, 5, 3, 4, 7, 5]"
好女儿 ,晏几道,仄仄平平。平仄平平。仄平平、仄仄平平仄，仄平平仄仄，仄平平仄，仄仄平平。平仄平平平仄，仄平仄、仄平平。仄平平、仄仄平平仄，仄平平仄仄，平平平仄，仄仄平平。,0,33,29,62,"[4, 4, 3, 5, 5, 4, 4, 6, 3, 3, 3, 5, 5, 4, 4]"
万里春 ,周邦彦,平平仄仄。仄仄平平平仄。仄平平、仄仄平平，仄平平仄仄。仄仄平平仄。仄平仄、仄平平仄。仄平平、仄仄平平，仄平平平仄。,0,23,23,46,"[4, 6, 3, 4, 5, 5, 3, 4, 3, 4, 5]"
彩鸾归令 ,张元干,平仄平平。仄仄平平仄仄平。仄平仄仄仄平平。仄平平。仄平平仄平平仄，仄仄平平仄仄平。仄平平仄仄平平。仄平平。,0,24,21,45,"[4, 7, 7, 3, 7, 7, 7, 3]"
锦园春 ,张孝祥,仄平平仄。平平平仄仄，仄平平仄。仄仄平平，仄平平平仄。平平仄仄。仄平仄、仄平平仄。仄仄平平，平平仄仄，平平平仄。,0,24,21,45,"[4, 5, 4, 4, 5, 4, 3, 4, 4, 4, 4]"
太平年 ,无名氏,平平平仄平平仄。仄仄平平仄。平平平仄仄平仄。仄平平仄仄。仄仄平平平平仄。仄仄平平仄。平仄仄平仄。仄仄平仄。,0,22,23,45,"[7, 5, 7, 5, 7, 5, 5, 4]"
清平乐 ,李白,仄平平仄。仄仄平平仄。仄仄平平平平仄。平仄平平平仄。仄仄仄仄平平。仄平平仄平平。仄仄平平仄仄，平平平仄平平。,0,25,21,46,"[4, 5, 7, 6, 6, 6, 6, 6]"
清平乐 ,赵长卿,平平仄仄。仄仄平平仄。仄仄平平平仄仄。仄平仄、平平仄。平平仄仄平平。仄平平仄平平。平仄仄平平仄，仄平仄仄平平。,0,24,22,46,"[4, 5, 7, 3, 3, 6, 6, 6, 6]"
清平乐 ,李白,仄平平仄。平仄仄平仄。平仄平平仄平仄。仄仄仄平平仄。仄仄平仄平平，仄仄平平仄仄。平仄平平平仄。仄仄仄平平仄。,0,21,25,46,"[4, 5, 7, 6, 6, 6, 6, 6]"
忆秦娥 ,李白,平平仄。平平仄仄平平仄。平平仄。平平仄仄，仄平平仄。仄平平仄平平仄。平平仄仄平平仄。平平仄。平平平仄，仄平平仄。,0,27,19,46,"[3, 7, 3, 4, 4, 7, 7, 3, 4, 4]"
忆秦娥 ,晁补之,平平仄。平平仄仄平平仄。平平仄。平平平仄，仄平平仄。平仄平平平仄仄。仄平平仄平平仄。平平仄。仄平仄仄，仄平平仄。,0,26,20,46,"[3, 7, 3, 4, 4, 7, 7, 3, 4, 4]"
忆秦娥 ,石孝友,平平仄。平平仄仄平平仄。平平仄。仄平平仄，仄平平仄。平平平仄仄平平，平平仄仄平平仄。平平仄。平平平仄，仄平平仄。,0,28,18,46,"[3, 7, 3, 4, 4, 7, 7, 3, 4, 4]"
忆秦娥 ,秦观,仄平仄。平平仄仄平平仄。平平仄。仄平平仄，平平平仄。平平仄仄平平仄。平平平仄平平仄。平平仄。仄平仄仄，平平平仄。,0,27,19,46,"[3, 7, 3, 4, 4, 7, 7, 3, 4, 4]"
忆秦娥 ,倪瓒,平平仄。平平仄仄平平仄。仄平平仄，仄平平仄。平平仄仄平平仄。平平平仄平平仄。仄平平仄，仄平平仄。,0,23,17,40,"[3, 7, 4, 4, 7, 7, 4, 4]"
忆秦娥 ,冯延巳,平仄仄。仄仄平平仄。仄仄。平仄平平平仄仄。平平平仄仄平仄。仄仄平平仄。仄仄。仄仄仄平平平仄。,0,16,22,38,"[3, 5, 2, 7, 7, 5, 2, 7]"
忆秦娥 ,张先,平平仄。平仄平平仄。平仄仄。平仄平平平仄仄。仄平平、平仄仄平仄。平仄平平仄。平仄仄。平仄平平平仄仄。,0,22,19,41,"[3, 5, 3, 7, 3, 5, 5, 3, 7]"
忆秦娥 ,毛滂,仄仄。仄仄平平仄。平平。仄仄平平仄仄平。平平平仄平平仄。仄仄平平仄。平平。仄仄平平仄仄平。,0,19,18,37,"[2, 5, 2, 7, 7, 5, 2, 7]"
忆秦娥 ,贺铸,仄平平。平平仄仄平平平。平平平。平平平仄，仄仄平平。仄平平仄平平平。平平平仄平平平。平平平。平平平仄，仄仄平平。,0,34,12,46,"[3, 7, 3, 4, 4, 7, 7, 3, 4, 4]"
忆秦娥 ,秦观,仄平平。平平仄仄仄平平。仄平平。仄平仄仄，平仄平平。平平仄仄平平平。平平仄仄平平平。平平平。仄平平仄，平仄平平。,0,30,16,46,"[3, 7, 3, 4, 4, 7, 7, 3, 4, 4]"
忆秦娥 ,颜奎,仄平平。仄平平仄平平平。平平平仄，仄仄平平。平平仄仄平平平。平平仄仄平平平。平平仄仄，平仄平平。,0,27,13,40,"[3, 7, 4, 4, 7, 7, 4, 4]"
更漏子 ,温庭筠,仄平平，平仄仄。平仄仄平平仄。平仄仄，仄平平。仄平平仄平。平平仄。平平仄。仄仄平平仄仄。仄仄仄，仄平平。平平仄仄平。,0,23,23,46,"[3, 3, 6, 3, 3, 5, 3, 3, 6, 3, 3, 5]"
更漏子 ,韦庄,平仄平，平仄仄。仄仄仄平平仄。平仄仄，仄平平。仄平平仄平。平仄仄，平仄仄。平仄仄平平仄。平仄仄，仄平平。仄平平仄平。,0,22,24,46,"[3, 3, 6, 3, 3, 5, 3, 3, 6, 3, 3, 5]"
更漏子 ,贺铸,仄平平，平仄仄。仄仄仄平平仄。仄仄仄，仄平平。平平仄仄平。仄平平，平仄仄。仄仄仄平平仄。平仄仄，仄平平。平平平仄平。,0,22,24,46,"[3, 3, 6, 3, 3, 5, 3, 3, 6, 3, 3, 5]"
更漏子 ,欧阳炯,仄平平，平仄仄。仄仄仄平平仄。仄仄仄，仄平平。仄平平仄平。仄仄。平平仄。仄仄仄平平仄。平仄仄，仄平平。仄平平仄平。,0,20,25,45,"[3, 3, 6, 3, 3, 5, 2, 3, 6, 3, 3, 5]"
更漏子 ,孙光宪,仄平平，平仄仄。仄仄仄平平仄。平仄仄，仄平平。仄平平仄平。平仄仄，仄平平。仄平仄仄平平。平仄仄，仄平平。平平仄仄平。,0,23,23,46,"[3, 3, 6, 3, 3, 5, 3, 3, 6, 3, 3, 5]"
更漏子 ,无名氏,仄仄平，仄平仄。平仄平平平仄。仄平仄，仄平平。仄平平仄平。仄平平，平平仄。仄仄仄平仄。仄仄仄，仄平平。平平仄仄平。,0,22,23,45,"[3, 3, 6, 3, 3, 5, 3, 3, 5, 3, 3, 5]"
更漏子 ,欧阳炯,平仄仄平平仄仄，仄平仄仄平平。平平仄仄仄平平。平仄仄平平。平仄仄，仄平平。平平仄仄平平。平平仄仄仄平平。仄平平仄平。,0,27,22,49,"[7, 6, 7, 5, 3, 3, 6, 7, 5]"
更漏子 ,杜安世,平仄平平。仄仄仄平平，仄仄平平。仄仄平平、仄仄平仄，平仄仄仄平平。仄仄仄仄平平，平仄仄仄平。仄平仄平平，仄仄仄仄，仄仄平平。平仄仄仄平平。仄仄仄平平，仄仄平平。仄仄平平、仄平平仄，平平仄仄平平。平仄仄平平仄，仄平仄仄平。仄平平平仄，仄平平平，仄仄平平。,0,50,54,104,"[4, 5, 4, 4, 4, 6, 6, 5, 5, 4, 4, 6, 5, 4, 4, 4, 6, 6, 5, 5, 4, 4]"
巫山一段云 ,唐昭宗,仄仄平平仄，平平仄仄平。仄平平仄仄平平。仄平平仄平。平仄仄平平仄。仄仄平平平仄。平平仄仄仄平平。平平仄仄平。,0,25,21,46,"[5, 5, 7, 5, 6, 6, 7, 5]"
巫山一段云 ,唐昭宗,仄仄平平仄，平平平仄平。仄平平仄仄平平。平仄仄平平。仄仄仄平平仄。仄仄平平仄仄。平平平仄仄平平。平仄仄平平。,0,25,21,46,"[5, 5, 7, 5, 6, 6, 7, 5]"
巫山一段云 ,毛文锡,仄仄平平仄，平平仄仄平。仄平平仄仄平平。仄仄仄平平。仄仄平平仄，平平仄仄平。平平仄仄仄平平。仄仄仄平平。,0,22,22,44,"[5, 5, 7, 5, 5, 5, 7, 5]"
望仙门 ,晏殊,仄平平仄仄平平。仄平平。平平仄仄仄平平。仄平平。仄仄平平仄，平平仄仄平平。仄平平仄仄平平。仄平平。平仄仄平平。,0,27,19,46,"[7, 3, 7, 3, 5, 6, 7, 3, 5]"
占春芳 ,苏轼,平仄仄，平平仄，仄仄仄平平。仄仄平平平仄，仄平仄仄平平。仄仄仄平平。仄平平、平仄平平。仄平平仄平平仄，平仄平平。,0,25,21,46,"[3, 3, 5, 6, 6, 5, 3, 4, 7, 4]"
朝天子 ,晁补之,仄仄平平仄。平仄仄、仄平平仄。平仄仄仄。仄仄平平仄。仄仄仄、平平平仄仄。仄仄平平平仄仄。平仄仄。仄平仄、平平平仄。,0,19,27,46,"[5, 3, 4, 4, 5, 3, 5, 7, 3, 3, 4]"
忆少年 ,晁补之,平平平仄，平平仄仄，平平平仄。平平仄平仄，仄平平平仄。仄仄平平平仄仄。仄平平、仄平平仄。平平仄平仄，仄平平平仄。,0,27,19,46,"[4, 4, 4, 5, 5, 7, 3, 4, 5, 5]"
忆少年 ,曹组,平平仄仄，平平仄仄，平平平仄。平平仄仄仄，仄平平平仄。仄仄仄、平平平仄仄。仄平平、仄平平仄。平平仄平仄，仄平平仄仄。,0,24,23,47,"[4, 4, 4, 5, 5, 3, 5, 3, 4, 5, 5]"
西地锦 ,蔡伸,仄仄平平平仄。仄平平仄仄。平平仄仄，平平仄仄，平平平仄。仄仄平平平仄。仄平平平仄。平平仄仄，平平仄仄，平平平仄。,0,25,21,46,"[6, 5, 4, 4, 4, 6, 5, 4, 4, 4]"
西地锦 ,石孝友,平仄仄平平仄。仄仄平平仄。平平仄仄，仄平仄仄，仄平平平仄。仄仄仄平平仄。平仄平平仄。平平仄仄，平平仄仄，仄平平平仄。,0,23,25,48,"[6, 5, 4, 4, 5, 6, 5, 4, 4, 5]"
西地锦 ,无名氏,仄仄平平平仄。仄仄平平仄。平平仄仄仄平平，平仄平平仄。平仄平平仄仄。仄仄仄、平平仄。仄平仄仄仄仄平，仄仄平平仄。,0,21,26,47,"[6, 5, 7, 5, 6, 3, 3, 7, 5]"
相思引 ,袁去华,仄仄平平仄仄平。仄平平仄仄平平。仄平平仄，平仄仄平平。平仄平平平仄仄，仄平平仄仄平平。平平平仄，平仄仄平平。,0,26,20,46,"[7, 7, 4, 5, 7, 7, 4, 5]"
相思引 ,无名氏,仄平平，平仄仄。平仄平平平仄。平仄平平平仄仄。仄仄平平仄。平仄仄平平仄仄。平仄仄平平仄。仄仄平平平仄仄。平仄平平仄。,0,25,24,49,"[3, 3, 6, 7, 5, 7, 6, 7, 5]"
相思引 ,无名氏,仄平平，平仄仄。平仄平平平仄。平仄平平仄仄。平仄平平仄。仄仄仄平平仄仄。仄仄仄平平仄。平仄仄平平仄仄。平仄平平仄。,0,23,25,48,"[3, 3, 6, 6, 5, 7, 6, 7, 5]"
落梅风 ,无名氏,平平平仄仄平平。平平仄仄平平。仄平仄仄仄平平。仄平平。仄平平仄平平仄，平平仄仄平平。仄平平仄仄平平。仄平平。,0,28,18,46,"[7, 6, 7, 3, 7, 6, 7, 3]"
江亭怨 ,无名氏,平仄仄平仄仄。平仄仄平平仄。仄仄仄平平，平仄平平仄仄。仄仄仄平仄仄。仄仄平平平仄。平仄仄平平，仄仄平平平仄。,0,20,26,46,"[6, 6, 5, 6, 6, 6, 5, 6]"
喜迁莺 ,韦庄,平仄仄，仄平平。平仄仄平平。仄平平仄仄平平。平仄仄平平。平仄平，平仄仄。仄仄仄平平仄。平平平仄仄平平。平仄仄平平。,0,26,21,47,"[3, 3, 5, 7, 5, 3, 3, 6, 7, 5]"
喜迁莺 ,冯延巳,仄平平，平仄仄，平仄仄平平。平平平仄仄平平。平仄仄平平。仄平平，平仄仄。仄仄平平平仄。平平平仄仄平平。平平仄仄平。,0,28,19,47,"[3, 3, 5, 7, 5, 3, 3, 6, 7, 5]"
喜迁莺 ,薛昭蕴,平平仄，仄平平。仄仄仄平平。仄平平仄仄平平。仄仄仄平平。仄仄平，平平仄。仄仄仄平平仄。仄平平仄仄平平。仄仄仄平平。,0,23,24,47,"[3, 3, 5, 7, 5, 3, 3, 6, 7, 5]"
喜迁莺 ,（南唐）李煜,仄仄仄，仄平平。平仄仄平平。仄平平仄仄平平。平仄仄平平。平平仄。平平仄。仄仄仄平平仄。仄平平仄仄平平。平仄仄平平。,0,25,22,47,"[3, 3, 5, 7, 5, 3, 3, 6, 7, 5]"
喜迁莺 ,毛文锡,平仄仄，仄平平。平仄仄平平。仄平平仄仄平平。平仄仄平平。仄仄平，平仄仄。仄仄平平平仄。仄平平仄仄平平，平仄平平仄。,0,25,22,47,"[3, 3, 5, 7, 5, 3, 3, 6, 7, 5]"
喜迁莺 ,张元干,平仄仄，仄平平。仄仄仄平平。仄平仄仄仄平平。仄仄仄平平。仄平平，平仄仄，平仄仄平平。仄平仄仄仄平平。平仄仄平平。,0,22,24,46,"[3, 3, 5, 7, 5, 3, 3, 5, 7, 5]"
喜迁莺 ,康与之,平平平仄。仄平仄仄平，仄平平仄。平仄平平，平平平仄，平仄仄平平仄。平仄仄平平仄，仄仄平平平仄。仄仄仄，仄仄平仄仄，平平平仄。平平平仄仄。平仄仄平，仄仄平平仄。仄仄平平，平平平仄，仄仄仄平平仄。仄仄仄平平仄，仄仄平平平仄。仄仄仄，仄仄平平仄，仄平平仄。,0,49,54,103,"[4, 5, 4, 4, 4, 6, 6, 6, 3, 5, 4, 5, 4, 5, 4, 4, 6, 6, 6, 3, 5, 4]"
喜迁莺 ,蒋捷,平平平仄。仄仄仄仄平，平平平仄。仄仄平平，平平平仄，平仄仄平平仄。仄平仄平平仄，平仄平平平仄。仄仄仄，仄平平仄仄，平平平仄。平仄。平仄仄，平仄仄平，仄仄平平仄。仄仄平平，平平仄仄，平仄仄平平仄。仄平仄平平仄，平仄平平平仄。仄平仄，仄平平仄仄，平平仄仄。,0,52,51,103,"[4, 5, 4, 4, 4, 6, 6, 6, 3, 5, 4, 2, 3, 4, 5, 4, 4, 6, 6, 6, 3, 5, 4]"
喜迁莺 ,吴文英,平平平仄。仄平仄、仄仄平平仄仄。仄仄平平，平平平仄，平仄仄平平仄。仄仄仄平平仄，仄仄平平平仄。仄平仄，仄平平，平仄平平平仄。平仄。平仄仄。平仄平平，仄仄平平仄。仄仄平平，仄平平仄，平仄仄平平仄。仄平仄平平仄，平仄平平平仄。仄平仄，仄平平，仄仄平平平仄。,0,53,50,103,"[4, 3, 6, 4, 4, 6, 6, 6, 3, 3, 6, 2, 3, 4, 5, 4, 4, 6, 6, 6, 3, 3, 6]"
喜迁莺 ,赵长卿,平平平仄。仄平仄平平，仄平平仄。仄仄平平，平平平仄，平仄仄平平仄。平平仄仄，平平仄仄，平平平仄。仄平仄，仄仄平，仄仄仄平平仄。平仄，平平仄。平仄仄仄，平平平平仄。仄仄平平，平平平仄，仄仄平平平仄。平平仄仄，平平平仄，仄平平仄。仄平仄，仄平平，仄仄平平平仄。,0,56,47,103,"[4, 5, 4, 4, 4, 6, 4, 4, 4, 3, 3, 6, 2, 3, 4, 5, 4, 4, 6, 4, 4, 4, 3, 3, 6]"
喜迁莺 ,史达祖,仄平平仄。仄仄平平仄，仄平平仄。仄仄平平，平平仄仄，平仄仄平平仄。仄平平仄仄，平仄仄、仄平平仄。仄平仄，仄平平仄仄，平仄平仄。平仄。仄仄仄。仄仄仄平，仄仄平平仄。仄仄平仄，平平仄仄，平仄仄平平仄。仄平平仄仄，平仄仄、平平平仄。仄仄仄，仄仄平仄平，平仄平仄。,0,43,60,103,"[4, 5, 4, 4, 4, 6, 5, 3, 4, 3, 5, 4, 2, 3, 4, 5, 4, 4, 6, 5, 3, 4, 3, 5, 4]"
喜迁莺 ,姜夔,仄平平仄。仄仄仄仄平，平仄平仄。平仄平平，平平平仄，平仄仄平平仄。平平仄平仄仄，仄平仄、仄平平仄。仄仄仄。仄仄平平仄，平平平仄。平仄。平仄仄。平仄仄平，仄仄平平仄。仄仄平平，仄平平仄，平仄仄平平仄。仄平仄平平仄，仄仄仄、平平平仄。仄平仄。仄平平平仄，平平平仄。,0,51,54,105,"[4, 5, 4, 4, 4, 6, 6, 3, 4, 3, 5, 4, 2, 3, 4, 5, 4, 4, 6, 6, 3, 4, 3, 5, 4]"
喜迁莺 ,无名氏,平平仄仄，仄仄仄仄仄，平平平仄。仄仄平平，平平仄仄，平仄平平平仄。仄平仄仄平仄，仄仄平平平仄。平仄仄，仄仄平平仄，平平仄仄。平平平仄仄，仄仄仄平，仄仄平平仄。仄仄平平，平平仄仄，仄仄仄平平仄。仄平仄平平仄，平仄平平平仄。仄平仄，仄平平平仄，平平平仄。,0,49,54,103,"[4, 5, 4, 4, 4, 6, 6, 6, 3, 5, 4, 5, 4, 5, 4, 4, 6, 6, 6, 3, 5, 4]"
喜迁莺 ,江汉,平平平仄。仄仄仄仄仄，平平平仄。仄仄平平，平仄平平，仄仄仄平平仄。仄平仄仄，平仄仄仄平平平仄。仄仄仄，仄仄仄平平，平平平仄。平仄。平仄仄。平仄仄平，平仄平平仄。仄仄平平，仄平平仄，平仄仄平平仄。仄平仄平平仄，仄仄仄平仄仄。仄仄仄，仄仄仄平平，平平平仄。,0,46,57,103,"[4, 5, 4, 4, 4, 6, 4, 8, 3, 5, 4, 2, 3, 4, 5, 4, 4, 6, 6, 6, 3, 5, 4]"
喜迁莺 ,蔡伸,仄平平仄。仄仄仄仄平，平平平仄。仄仄平平，仄仄平平，仄仄仄平平仄。仄仄仄平，平平仄仄，平平平仄。平平仄，仄平平平仄，仄平平仄。平平平仄仄。仄平仄仄，仄仄平平仄。仄仄平平，平平仄仄，平仄仄平平仄。仄仄仄平平，仄仄仄、平平平仄。平仄仄，仄仄平平仄，平平平仄。,0,49,54,103,"[4, 5, 4, 4, 4, 6, 4, 4, 4, 3, 5, 4, 5, 4, 5, 4, 4, 6, 5, 3, 4, 3, 5, 4]"
喜迁莺 ,无名氏,仄平平仄。仄仄仄平平，平平仄仄。仄仄平平，平平平仄，仄仄仄平平仄。仄平仄平平仄，仄仄平平平仄。仄平仄，仄平平，平仄平平平仄。平仄平仄仄仄，仄平仄仄平平仄。仄仄平平，平仄平平，仄仄仄平平仄。仄平仄仄平仄，仄仄平平平仄。仄平仄，仄平平，平仄平平平仄。,0,50,52,102,"[4, 5, 4, 4, 4, 6, 6, 6, 3, 3, 6, 6, 7, 4, 4, 6, 6, 6, 3, 3, 6]"
喜迁莺 ,无名氏,平平平仄。仄平平仄平，仄平平仄。仄仄平平，平平平仄，仄仄仄平平仄。仄平仄仄，平平仄仄，平仄平仄。仄平仄，仄平仄平仄，平平平仄。仄仄平平仄仄仄，仄平平仄平平仄。平仄平平，平仄平仄，仄仄仄仄平仄。仄平仄仄，平仄仄平，平平平仄。仄平仄，仄平平，平仄平平平仄。,0,51,52,103,"[4, 5, 4, 4, 4, 6, 4, 4, 4, 3, 5, 4, 7, 7, 4, 4, 6, 4, 4, 4, 3, 3, 6]"
乌夜啼 ,（南唐）李煜,仄仄平平仄，平平仄仄平平。仄平仄仄平平仄，仄仄仄平平。仄仄仄平平仄，仄平仄仄平平。仄平仄仄平平仄，仄仄仄平平。,0,21,26,47,"[5, 6, 7, 5, 6, 6, 7, 5]"
乌夜啼 ,赵令畤,平仄平平仄仄，平平仄仄平平。平平平仄平平仄，平仄仄平平。仄仄平平仄仄，平平仄仄平平。平平仄仄平平仄，平仄仄平平。,0,28,20,48,"[6, 6, 7, 5, 6, 6, 7, 5]"
乌夜啼 ,程垓,平仄仄平平仄，平平仄仄平平。平平平仄平平仄，平平仄，仄平平。平仄平平仄仄，仄平平仄平平。平平仄仄平平仄，仄平仄，仄平平。,0,30,20,50,"[6, 6, 7, 3, 3, 6, 6, 7, 3, 3]"
相思儿令 ,晏殊,仄仄仄平平仄，平仄仄平平。平仄仄平平仄，平仄仄平平。仄仄仄仄平平。仄平平、平仄平平。平平平仄平平，仄平平仄平平。,0,27,20,47,"[6, 5, 6, 5, 6, 3, 4, 6, 6]"
阮郎归 ,（南唐）李煜,平平平仄仄平平。平平平仄平。仄平平仄仄平平。平平仄仄平。平仄仄，仄平平。平平仄仄平。平平平仄仄平平。平平仄仄平。,0,30,17,47,"[7, 5, 7, 5, 3, 3, 5, 7, 5]"
阮郎归 ,黄庭坚,平平平仄仄平平。仄平平仄平。仄平平仄仄平平。仄平平仄平。平仄仄，仄平平。仄平平仄平。仄平平仄仄平平。仄平平仄平。,0,28,19,47,"[7, 5, 7, 5, 3, 3, 5, 7, 5]"
贺圣朝 ,冯延巳,平平仄仄平平仄。平平平仄。平平平仄，仄平平仄，仄平平仄。平平平仄，平平仄仄，仄平平仄。仄平平仄，仄平平仄，平平平仄。,0,28,19,47,"[7, 4, 4, 4, 4, 4, 4, 4, 4, 4, 4]"
贺圣朝 ,黄庭坚,仄平平仄平平仄。平平仄仄。平平平仄仄平平，仄平平平仄。平平平仄。平平仄仄，仄平平仄。平平平仄仄平平，仄平平平仄。,0,29,18,47,"[7, 4, 7, 5, 4, 4, 4, 7, 5]"
贺圣朝 ,叶清臣,仄平仄仄平平仄。仄平平平仄。平平平仄仄平平，仄仄平平仄。平平平仄，平平仄仄。仄平平平仄。仄平平仄仄平平，仄平平平仄。,0,28,21,49,"[7, 5, 7, 5, 4, 4, 5, 7, 5]"
贺圣朝 ,赵师侠,平平仄仄平平仄。仄仄平平仄。平平平仄仄平平，仄平平平仄。平平平仄，仄平仄仄，仄平平仄仄。仄平仄仄仄平平，仄仄平平仄。,0,25,24,49,"[7, 5, 7, 5, 4, 4, 5, 7, 5]"
贺圣朝 ,赵彦端,仄平平仄平平仄。仄仄平平仄。仄平平仄，仄平平仄，仄平平仄。平平仄仄平平仄。仄平平平仄。平平仄仄，仄平平、仄平平平仄。,0,26,22,48,"[7, 5, 4, 4, 4, 7, 5, 4, 3, 5]"
贺圣朝 ,赵彦端,平平平仄平平仄。仄平平平仄。仄平仄仄仄平平，仄仄平平仄。平平仄仄平平仄。仄平平仄仄。仄平平仄仄平平，仄平平平仄。,0,26,22,48,"[7, 5, 7, 5, 7, 5, 7, 5]"
贺圣朝 ,杜安世,仄平仄仄平平仄。平平平仄。仄平平仄仄平平，仄平平仄。平平仄仄，平平仄仄，仄平平平仄。仄平平仄仄平平，仄仄平平仄。,0,25,22,47,"[7, 4, 7, 4, 4, 4, 5, 7, 5]"
贺圣朝 ,杜安世,平平仄仄平平仄。平平平仄。仄平平仄仄平平，仄平平仄。仄平平仄，平平仄仄。仄平平平仄。仄平平仄，仄平仄仄，平仄平仄。,0,25,22,47,"[7, 4, 7, 4, 4, 4, 5, 4, 4, 4]"
贺圣朝 ,无名氏,仄仄仄仄，平平仄仄，仄仄平平。仄平平、仄平仄仄，平仄仄平平。平平仄仄，仄平平仄，平仄平平。仄平平、仄平仄仄，平仄平仄平平。,0,24,25,49,"[4, 4, 4, 3, 4, 5, 4, 4, 4, 3, 4, 6]"
贺圣朝 ,无名氏,仄平平仄，平平平仄，仄仄平平。仄平平、平仄仄平平，仄仄仄平平。平平仄仄，平平平仄，平仄平平。仄平平、仄仄仄平平，仄仄仄平平。,0,28,22,50,"[4, 4, 4, 3, 5, 5, 4, 4, 4, 3, 5, 5]"
贺圣朝 ,无名氏,仄平平仄，平平平仄，平仄平平。仄平平平仄，仄平平仄，仄仄平平。平平仄仄，平平平仄，仄仄平平。仄平平平仄，仄平平仄，仄仄平平。,0,29,21,50,"[4, 4, 4, 5, 4, 4, 4, 4, 4, 5, 4, 4]"
甘草子 ,寇准,平仄。仄平平仄，平仄平平仄。仄仄平平仄。平仄平平仄。平仄仄平仄平仄。仄仄仄、平平仄仄。平仄平平仄平仄。仄仄平平仄。,0,22,25,47,"[2, 4, 5, 5, 5, 7, 3, 4, 7, 5]"
甘草子 ,柳永,平仄。仄仄平平，仄仄平平仄。仄仄仄平平，仄仄平平仄。平仄仄平平平仄。仄仄仄、平平平仄。仄仄平平仄平仄。仄仄平平仄。,0,21,26,47,"[2, 4, 5, 5, 5, 7, 3, 4, 7, 5]"
珠帘卷 ,欧阳修,平平仄，仄平平。平平仄仄平平。平仄平平平仄，平平平仄平。平仄仄平平仄，平平仄仄平平。平仄仄平平仄，平仄仄，仄平平。,0,29,18,47,"[3, 3, 6, 6, 5, 6, 6, 6, 3, 3]"
画堂春 ,秦观,仄平平仄仄平平。仄平仄仄平平。仄平平仄仄平平。平仄平平。仄仄仄平仄仄，平平仄仄平平。仄平平仄仄平平。仄仄平平。,0,25,22,47,"[7, 6, 7, 4, 6, 6, 7, 4]"
画堂春 ,谢懋,平平平仄仄平平。平平平仄平。仄平平仄仄平平。平仄平平。仄仄仄平平仄，仄平平仄平平。仄平平仄仄平平。平仄平平。,0,29,17,46,"[7, 5, 7, 4, 6, 6, 7, 4]"
画堂春 ,赵长卿,仄平平仄仄平平。仄平仄仄平平。仄平平仄仄平平。平仄平平。仄仄平平平仄，仄平平、仄仄平平。平平平仄仄平平。平仄平平。,0,29,19,48,"[7, 6, 7, 4, 6, 3, 4, 7, 4]"
画堂春 ,黄庭坚,平平仄仄仄平平。平平平仄平平。仄平平仄仄平平。仄仄仄平平。平仄仄平平仄，仄平平仄平平。仄平仄仄仄平平。平仄仄平平。,0,28,21,49,"[7, 6, 7, 5, 6, 6, 7, 5]"
画堂春 ,赵长卿,平平仄仄仄平平。仄平平仄平平。仄平平仄仄平平。平仄平平。仄平平仄仄平平。仄平平、仄仄平平。仄平平仄仄平平。仄仄平平。,0,29,20,49,"[7, 6, 7, 4, 7, 3, 4, 7, 4]"
喜长新 ,王胜之,平平仄仄仄平平。仄仄平平。平平仄仄仄平平。平平仄仄平平。平仄平平平仄，平仄平平。平平仄仄仄平平。仄平仄仄平平。,0,28,19,47,"[7, 4, 7, 6, 6, 4, 7, 6]"
金盏子令 ,无名氏,平平仄仄，仄平平仄仄平平。平平仄仄，仄平平仄仄，平仄平平。平平仄仄，平仄平仄，仄仄平平。仄仄平、平平仄仄，仄仄平平。,0,24,23,47,"[4, 7, 4, 5, 4, 4, 4, 4, 3, 4, 4]"
献天寿 ,无名氏,仄仄平平平仄平。仄仄平平。仄平平仄仄平平。平仄仄平平。仄平平仄平平仄，仄仄平平。平平仄仄仄平平。仄平仄，仄平平。,0,26,21,47,"[7, 4, 7, 5, 7, 4, 7, 3, 3]"
三字令 ,欧阳炯,平仄仄，仄平平。仄平平。平仄仄，仄平平。仄平平，平仄仄，仄平平。平仄仄，仄平平。仄平平。平仄仄，仄平平。仄平平，平仄仄，仄平平。,0,26,22,48,"[3, 3, 3, 3, 3, 3, 3, 3, 3, 3, 3, 3, 3, 3, 3, 3]"
三字令 ,向子諲,平仄仄，仄平平。平仄仄，仄平平。平仄仄，仄平平。平平仄，平仄仄，仄平平。平平仄，仄平平。平仄仄，仄平平。平仄仄，仄平平。平仄仄，平仄仄，仄平平。,0,28,26,54,"[3, 3, 3, 3, 3, 3, 3, 3, 3, 3, 3, 3, 3, 3, 3, 3, 3, 3]"
山花子 ,南唐李璟,仄仄平平仄仄平。平平平仄仄平平。平仄平平仄平仄，仄平平。仄仄仄平平仄仄，仄平平仄仄平平。平仄仄平平仄仄，仄平平。,0,25,23,48,"[7, 7, 7, 3, 7, 7, 7, 3]"
忆余杭 ,潘阆,平仄平平，仄仄平平平仄仄，平平仄仄仄平平。仄仄仄平平。仄平平仄平平仄。仄仄仄平平仄。仄平平仄仄平平。仄仄仄平平。,0,24,24,48,"[4, 7, 7, 5, 7, 6, 7, 5]"
忆余杭 ,潘阆,平仄平平，平仄平平平仄仄，平平仄仄仄平平。平仄仄平平。仄平平仄平平仄。仄仄平平平仄仄。仄平平仄仄平平。平仄仄平平。,0,28,21,49,"[4, 7, 7, 5, 7, 7, 7, 5]"
秋蕊香 ,晏殊,平仄仄平平仄。平仄平平平仄。平平仄仄平平仄。仄仄仄平平仄。平平仄仄平平仄。平平仄。平平仄仄平平仄。平仄平平平仄。,0,27,21,48,"[6, 6, 7, 6, 7, 3, 7, 6]"
秋蕊香 ,周邦彦,仄仄平平仄仄。平仄仄平平仄。仄平仄仄仄平仄。仄仄平平仄仄。平平仄仄平平仄。平平仄。仄平仄仄仄平仄。平仄平平仄仄。,0,20,28,48,"[6, 6, 7, 6, 7, 3, 7, 6]"
秋蕊香 ,赵以夫,仄仄平平，平平仄仄，平平仄仄平平。平平仄仄仄，仄仄仄平平。仄平仄、平仄仄平平。仄平平仄平平。平平仄，仄平平仄，平仄平平。仄仄仄平平仄，平仄仄平平，平仄平平。仄平平、仄仄仄平平。平平仄、平仄仄平平。仄平仄仄平平。平仄仄，平平平仄，仄仄平平。,0,53,44,97,"[4, 4, 6, 5, 5, 3, 5, 6, 3, 4, 4, 6, 5, 4, 3, 5, 3, 5, 6, 3, 4, 4]"
胡捣练 ,晏殊,仄平平仄仄平平，仄仄平平平仄。仄仄平平平仄。平仄平平仄。平平平仄仄平平，仄仄平平平仄。平仄仄平平仄。仄仄平平仄。,0,26,22,48,"[7, 6, 6, 5, 7, 6, 6, 5]"
胡捣练 ,晏几道,仄平平仄仄平平，仄仄平平平仄。平仄平平平仄。平仄平平仄。仄平仄仄平平，仄仄平平仄仄。仄仄仄平平仄。平仄平平仄。,0,24,23,47,"[7, 6, 6, 5, 6, 6, 6, 5]"
胡捣练 ,杜安世,仄平仄仄仄平平，仄仄仄、仄平平仄。平仄仄平平仄。平仄平平仄。平平仄仄仄平平，仄仄仄、仄平平仄。平仄仄平平仄。平仄平平仄。,0,23,27,50,"[7, 3, 4, 6, 5, 7, 3, 4, 6, 5]"
桃源忆故人 ,欧阳修,平平仄仄平平仄。仄仄平平平仄。仄仄平平平仄。仄仄平平仄。仄平仄仄平平仄。仄仄平平仄仄。平仄仄平平仄。仄仄平平仄。,0,22,26,48,"[7, 6, 6, 5, 7, 6, 6, 5]"
桃源忆故人 ,王庭珪,平平仄仄平平仄。平仄平平仄仄。仄仄仄平平仄。仄仄平平仄。平平平仄平平仄。平仄仄、平平平仄。仄仄仄平平仄。仄仄平平仄。,0,24,25,49,"[7, 6, 6, 5, 7, 3, 4, 6, 5]"
撼庭秋 ,晏殊,仄平平仄平仄。仄仄平平仄。仄平平仄，平平仄仄，仄平平仄。平平仄仄，平平平仄，仄平平仄。仄平平平仄，平平仄仄，仄平平仄。,0,25,23,48,"[6, 5, 4, 4, 4, 4, 4, 4, 5, 4, 4]"
庆金枝 ,无名氏,仄仄平仄平。仄平仄、仄平平。平平平仄仄平仄，仄仄仄平平。仄平仄仄平平仄，仄平仄、仄平平。仄平仄仄仄平平。仄仄仄平平。,0,22,26,48,"[5, 3, 3, 7, 5, 7, 3, 3, 7, 5]"
庆金枝 ,张先,平平平仄平。仄平仄、仄平平。仄平平仄仄平平。仄平仄、仄平平。平平仄仄平平仄，平仄仄、仄平平。平平平仄仄平平。仄平仄、仄平平。,0,29,21,50,"[5, 3, 3, 7, 3, 3, 7, 3, 3, 7, 3, 3]"
庆金枝 ,无名氏,平平仄仄平。仄平仄、仄平平。仄平平仄仄平平。仄仄仄、仄平平。仄平平仄仄平平。仄平仄、仄平平。平平仄仄仄平平。仄平仄、仄平平。,0,26,24,50,"[5, 3, 3, 7, 3, 3, 7, 3, 3, 7, 3, 3]"
烛影摇红 ,毛滂,仄仄平平，仄平平仄平平仄。仄平平仄仄平平，仄仄平平仄。平仄仄平平仄。仄平平、平平仄仄。仄平平仄，仄仄平平，平平仄仄。,0,25,23,48,"[4, 7, 7, 5, 6, 3, 4, 4, 4, 4]"
烛影摇红 ,王诜,仄仄平平，仄仄平，仄仄仄、平平仄。平平平仄仄平平，平仄平平仄。平仄平平仄仄。仄平平、平平仄仄。仄平平仄，仄仄平平，平平平仄。,0,27,23,50,"[4, 3, 3, 3, 7, 5, 6, 3, 4, 4, 4, 4]"
烛影摇红 ,周邦彦,平仄平平，仄平仄仄平平仄。平平平仄仄平平，平仄平平仄。仄仄平平仄仄。仄仄平、平平仄仄。仄平仄仄，仄仄平平，平平仄仄。仄仄平平，仄平仄仄平平仄。平平平仄仄平平，平仄平平仄。平仄平平仄仄。仄平平、平平仄仄。仄平平仄，仄仄平平，平平平仄。,0,51,45,96,"[4, 7, 7, 5, 6, 3, 4, 4, 4, 4, 4, 7, 7, 5, 6, 3, 4, 4, 4, 4]"
朝中措 ,欧阳修,平平平仄仄平平。平仄仄平平。仄仄平平平仄，仄平仄仄平平。平平仄仄，平平仄仄，仄仄平平。平仄仄平平仄，平平仄仄平平。,0,27,21,48,"[7, 5, 6, 6, 4, 4, 4, 6, 6]"
朝中措 ,辛弃疾,平平平仄仄平平。平仄仄平平。平仄平平平仄，平平仄仄平平。平平仄仄仄平平。仄仄仄平平。仄仄仄平平仄，平平仄仄平平。,0,28,20,48,"[7, 5, 6, 6, 7, 5, 6, 6]"
朝中措 ,赵长卿,平平平仄仄平平。平仄仄平平。仄仄平平平仄，平平仄仄平平。仄平仄仄平平仄，平仄仄平平。平仄仄平平仄，平平仄仄平平。,0,28,20,48,"[7, 5, 6, 6, 7, 5, 6, 6]"
朝中措 ,蔡伸,平平平仄仄平平。平仄仄平平。仄仄仄平平仄，平平仄仄平平。平平平仄仄，平平仄仄，仄仄平平。平仄仄平平仄，平平仄仄平平。,0,28,21,49,"[7, 5, 6, 6, 5, 4, 4, 6, 6]"
洞天春 ,欧阳修,平平仄仄平仄。仄仄平平仄仄。仄仄平平仄平仄。仄平平平仄。平平仄仄仄仄。仄仄平平仄仄。仄仄平平，仄平平仄，平平平仄。,0,22,26,48,"[6, 6, 7, 5, 6, 6, 4, 4, 4]"
庆春时 ,晏几道,仄平平仄，平平平仄，仄仄平平。平平仄仄，平平仄仄，平仄仄平平。平平平仄，平仄平仄平平。平平仄仄，平平仄仄，平仄仄平平。,0,28,20,48,"[4, 4, 4, 4, 4, 5, 4, 6, 4, 4, 5]"
眼儿媚 ,左誉,平仄平平仄平平。平仄仄平平。仄平仄仄，仄平平仄，仄仄平平。仄平平仄平平仄，仄仄仄平平。仄平仄仄，平平平仄，仄仄平平。,0,25,23,48,"[7, 5, 4, 4, 4, 7, 5, 4, 4, 4]"
眼儿媚 ,贺铸,平平平仄仄平平。仄仄仄平平。仄平仄仄，仄平平仄，仄仄平平。仄平平仄平平仄，仄仄仄平平。平平仄仄，平平平仄，仄仄平平。,0,25,23,48,"[7, 5, 4, 4, 4, 7, 5, 4, 4, 4]"
眼儿媚 ,赵长卿,平平平仄仄平平。仄仄仄平平。仄平仄仄，平平仄仄，平仄平平。平平平仄仄平平。仄仄仄平平。仄平仄仄，平平平仄，平仄平平。,0,27,21,48,"[7, 5, 4, 4, 4, 7, 5, 4, 4, 4]"
人月圆 ,王诜,仄平平仄平平仄，平仄仄平平。平平仄仄，平平仄仄，平仄平平。仄平平仄，平平仄仄，平仄平平。仄平平仄，平平仄仄，平仄平平。,0,28,20,48,"[7, 5, 4, 4, 4, 4, 4, 4, 4, 4, 4]"
人月圆 ,杨无咎,平平仄仄平平仄，仄仄仄平平。平平仄仄，平平仄仄，仄仄平平。仄平仄仄，平平平仄，仄仄平平。仄平平仄仄仄仄，仄平仄平平。,0,23,25,48,"[7, 5, 4, 4, 4, 4, 4, 4, 7, 5]"
人月圆 ,杨无咎,仄平平仄平平仄。平仄平平仄。仄平平仄，平平仄仄，平仄平仄。仄平平仄，平平仄仄，平仄平仄。仄平平仄仄平仄，仄平平平仄。,0,25,23,48,"[7, 5, 4, 4, 4, 4, 4, 4, 7, 5]"
喜团圆 ,晏几道,平平仄仄，平平仄仄，平仄平平。平平仄仄平平仄，仄平仄平平。平平仄仄，仄平平仄，仄仄平平。仄平仄仄，平平仄仄，仄仄平平。,0,25,23,48,"[4, 4, 4, 7, 5, 4, 4, 4, 4, 4, 4]"
喜团圆 ,无名氏,平平仄仄，平平仄仄，仄仄平平。平仄平平，仄平仄仄，仄仄平平。仄仄平平，平平仄仄，平仄平平。平平仄仄，平平平仄，仄仄平平。,0,26,22,48,"[4, 4, 4, 4, 4, 4, 4, 4, 4, 4, 4, 4]"
海棠春 ,秦观,平平平仄平平仄。仄仄仄、仄平平仄。仄仄仄平平，仄仄平平仄。仄平仄仄平平仄。仄仄仄、平平仄仄。仄仄仄平平，仄仄平平仄。,0,20,28,48,"[7, 3, 4, 5, 5, 7, 3, 4, 5, 5]"
海棠春 ,吴潜,平平平仄平平仄。平仄仄、平平平仄。平仄仄平平，平仄平平仄。平平仄仄，平平仄仄。仄仄平平仄仄。仄仄仄平平，仄仄平平仄。,0,25,23,48,"[7, 3, 4, 5, 5, 4, 4, 6, 5, 5]"
海棠春 ,马庄父,仄平仄仄平平仄。平仄平平仄仄。平仄仄平平，平仄平平仄。仄平仄仄平平仄。仄仄平平仄仄。仄仄仄平平，仄仄平平仄。,0,21,25,46,"[7, 6, 5, 5, 7, 6, 5, 5]"
武陵春 ,毛滂,平仄平平平仄仄，仄仄仄平平。仄仄平平仄仄平。平仄仄平平。仄仄平平平仄仄，平仄仄平平。仄仄平平仄仄平。仄仄仄平平。,0,23,25,48,"[7, 5, 7, 5, 7, 5, 7, 5]"
武陵春 ,李清照,平仄平平平仄仄，仄仄仄平平。仄仄平平仄仄平。仄仄仄平平。平仄平平平仄仄，仄仄仄平平。仄仄平平仄仄平。仄仄仄、仄平平。,0,22,27,49,"[7, 5, 7, 5, 7, 5, 7, 3, 3]"
武陵春 ,万俟咏,仄仄平平平仄仄，平仄仄、仄平平。仄仄仄平平仄仄平。仄仄仄、仄平平。平平仄仄仄平平。平平仄、仄平平。仄仄仄平平平仄平。仄仄仄、仄平平。,0,25,29,54,"[7, 3, 3, 8, 3, 3, 7, 3, 3, 8, 3, 3]"
东坡引 ,曹冠,平平平仄仄。平平仄平仄。平平仄仄平平仄。平平平仄仄。平平仄仄，平仄仄仄。平仄仄、平平仄。平平仄仄平平仄。平平平仄仄。,0,26,22,48,"[5, 5, 7, 5, 4, 4, 3, 3, 7, 5]"
东坡引 ,袁去华,仄平平仄仄。平平仄平仄。平平仄仄平平仄。平平平仄仄。平平仄仄，平平仄仄。仄平仄、平仄平仄。平平仄仄平平仄。平平平仄仄。,0,26,23,49,"[5, 5, 7, 5, 4, 4, 3, 4, 7, 5]"
东坡引 ,赵师侠,平平平仄仄。平平仄平仄。平平仄仄平平仄。平平平仄仄。平平平仄仄。平平仄仄，平仄平仄。仄仄仄、平平仄。平平仄仄平平仄。平平平仄仄。平平平仄仄。,0,32,26,58,"[5, 5, 7, 5, 5, 4, 4, 3, 3, 7, 5, 5]"
东坡引 ,辛弃疾,仄平平仄仄。平平仄平仄。平平仄仄平平仄。仄平平仄仄。仄平平仄仄。仄平仄仄仄，仄平平仄。仄仄仄、平平仄。仄平仄仄平平仄。平平平仄仄。平平平仄仄。,0,27,32,59,"[5, 5, 7, 5, 5, 5, 4, 3, 3, 7, 5, 5]"
东坡引 ,辛弃疾,平平平仄仄。平仄平平仄。平平仄仄平平仄。仄平平仄仄。仄平平仄仄。平平仄仄，平平仄仄。仄平平平仄平仄。平平仄仄平平仄。平平平仄仄。平平平仄仄。,0,32,27,59,"[5, 5, 7, 5, 5, 4, 4, 7, 7, 5, 5]"
双鸂鶒 ,朱敦儒,仄仄平平平仄。仄仄平平平仄。平仄仄平平仄。平平平仄平仄。仄仄平平平仄。平仄仄平平仄。仄仄平平平仄。平平平仄平仄。,0,26,22,48,"[6, 6, 6, 6, 6, 6, 6, 6]"
鬲溪梅令 ,姜夔,仄平仄仄仄平平。仄平平。仄仄平平平仄、仄平平。仄平平仄平。仄平平仄仄平平。仄平平。仄仄平平平仄、仄平平。仄平平仄平。,0,27,21,48,"[7, 3, 6, 3, 5, 7, 3, 6, 3, 5]"
伊州三台 ,赵师侠,仄平平仄平平。仄仄平平仄平。平仄仄平平。仄平平、仄平仄平。仄平平仄平平。仄仄平平仄平。仄仄仄平平。仄平平、仄平仄平。,0,27,21,48,"[6, 6, 5, 3, 4, 6, 6, 5, 3, 4]"
双头莲令 ,赵师侠,仄平平仄仄平平。仄仄仄平平。平平仄仄仄平平。仄仄仄平平。仄平仄仄仄平平。平仄仄平平。平平仄仄仄平平。平仄仄平平。,0,25,23,48,"[7, 5, 7, 5, 7, 5, 7, 5]"
梅弄影 ,丘崈,仄平平仄。仄仄平平仄。平仄平平仄仄。仄仄平平，仄平平仄仄。仄平平仄。仄仄平平仄。仄仄平平平仄。仄仄平平，平平平仄仄。,0,23,25,48,"[4, 5, 6, 4, 5, 4, 5, 6, 4, 5]"
茅山逢故人 ,张雨,平仄平平平仄。平仄平平平仄。仄仄平平，平平平仄，仄平平仄。平平仄仄平平，平仄平平平仄。仄仄平平，平平平仄，仄平平仄。,0,30,18,48,"[6, 6, 4, 4, 4, 6, 6, 4, 4, 4]"
阳台梦 ,唐庄宗,仄平平仄平平仄。仄平平仄平平仄。仄平平仄仄平平，仄平平仄仄。平平平仄仄，平仄平平仄仄。仄平平仄仄平平，仄仄平平仄。,0,26,23,49,"[7, 7, 7, 5, 5, 6, 7, 5]"
阳台梦 ,解昉,平平仄仄。仄仄平平仄。平仄平平平仄。仄平仄仄仄平平。仄仄平、仄平平。平平仄仄平平仄。平仄平平仄。仄平平仄仄平平。仄仄平平，仄仄仄、仄平平。,0,29,28,57,"[4, 5, 6, 7, 3, 3, 7, 5, 7, 4, 3, 3]"
月宫春 ,毛文锡,仄平平仄仄平平。平平仄仄平。平平平仄仄平平。平平仄仄平。仄仄平平平仄仄，平平仄仄仄平平。平仄平平仄仄，仄平平仄平。,0,28,21,49,"[7, 5, 7, 5, 7, 7, 6, 5]"
月宫春 ,周邦彦,仄平仄仄仄平平。平仄仄平平。仄平仄仄仄平平。仄仄仄平平。平平仄仄平平仄，平仄仄、仄仄平平。平平仄仄仄平平。仄仄仄平平。,0,24,26,50,"[7, 5, 7, 5, 7, 3, 4, 7, 5]"
河渎神 ,温庭筠,平仄仄平平。仄平平仄平平。仄平平仄仄平平。平仄平平仄平。平仄仄平平仄仄。仄平平仄平仄。平仄仄平平仄。仄平平仄平仄。,0,27,22,49,"[5, 6, 7, 6, 7, 6, 6, 6]"
河渎神 ,张泌,仄仄仄平平。仄平平仄平平。仄平平仄仄平平。仄仄平平仄平。平仄仄平平仄仄，平平平仄平平。平仄仄平平仄，仄平平仄平平。,0,28,21,49,"[5, 6, 7, 6, 7, 6, 6, 6]"
归去来 ,柳永,平仄平平平仄。平仄平平仄。平仄平平平平仄。平平仄、仄平仄。平仄平平仄。平平仄、仄平平仄。平平仄仄平平仄。平平仄、仄平仄。,0,29,20,49,"[6, 5, 7, 3, 3, 5, 3, 4, 7, 3, 3]"
归去来 ,柳永,仄仄平平仄。平平仄、仄平平仄。平平仄仄平平仄。仄平平、平仄仄。仄平平仄平平仄。仄平仄、仄平平仄。平平仄仄平平仄。平平仄、仄平仄。,0,27,25,52,"[5, 3, 4, 7, 3, 3, 7, 3, 4, 7, 3, 3]"
惜春郎 ,柳永,仄平平仄平平仄。仄仄平平仄。平平仄仄，仄平平仄，平仄平仄。仄仄平平平仄仄。仄仄仄平仄。仄仄平、仄仄平平，仄仄仄平平仄。,0,21,28,49,"[7, 5, 4, 4, 4, 7, 5, 3, 4, 6]"
极相思 ,无名氏,仄平仄仄平平。平仄仄平平。平平仄仄，仄平仄仄，平仄平平。仄仄仄仄平平仄，平仄仄、仄仄平平。平平仄仄，平平仄仄，平仄平平。,0,24,25,49,"[6, 5, 4, 4, 4, 7, 3, 4, 4, 4, 4]"
双韵子 ,张先,平平仄仄，仄平仄仄，平平平仄。仄平仄仄平平，平仄仄、平平仄。平平仄。平平仄。平平仄、平平仄仄。仄平仄仄平平，平仄仄、平平仄。,0,26,23,49,"[4, 4, 4, 6, 3, 3, 3, 3, 3, 4, 6, 3, 3]"
凤孤飞 ,晏几道,仄仄仄平平仄，仄仄平平仄。仄仄平平仄仄。仄仄仄、平平仄。仄仄平平平仄仄。平平仄、仄平仄仄。平仄平平平仄仄。仄平平平仄。,0,21,28,49,"[6, 5, 6, 3, 3, 7, 3, 4, 7, 5]"
柳梢青 ,秦观,仄仄平平。平平仄仄，仄仄平平。仄仄平平，平平平仄，平仄平平。平平仄仄平平。仄仄仄、平平仄平。平仄平平，平平平仄，平仄平平。,0,30,19,49,"[4, 4, 4, 4, 4, 4, 6, 3, 4, 4, 4, 4]"
柳梢青 ,刘镇,平仄平平，仄平仄仄，平仄平平。仄仄平平，平平仄仄，平仄平平。平平仄仄平平。仄仄仄、平平仄平。仄仄平平，平平仄仄，平仄平平。,0,28,21,49,"[4, 4, 4, 4, 4, 4, 6, 3, 4, 4, 4, 4]"
柳梢青 ,张雨,仄仄平平。平平仄仄，仄仄平平。仄仄平平，仄平平仄，平仄平平。仄平仄仄平平。仄仄仄平平、平仄平。仄仄平平，仄平平仄，仄仄平平。,0,26,24,50,"[4, 4, 4, 4, 4, 4, 6, 5, 3, 4, 4, 4]"
柳梢青 ,贺铸,仄平平仄。仄平仄仄，平平平仄。仄仄平平，仄平平仄，平平平仄。平平仄仄平平，仄仄仄、平平仄仄。仄仄平平，平平平仄，仄平平仄。,0,26,23,49,"[4, 4, 4, 4, 4, 4, 6, 3, 4, 4, 4, 4]"
柳梢青 ,蔡伸,平仄平平，仄平仄仄，平平平仄。仄仄平平，仄平平仄，仄平平仄。平平仄仄平平，平仄仄、平平平仄。仄仄平平，平平仄仄，平平平仄。,0,28,21,49,"[4, 4, 4, 4, 4, 4, 6, 3, 4, 4, 4, 4]"
柳梢青 ,赵彦端,平平仄仄。平仄平仄，平平平仄。仄仄平平，仄平仄仄，仄平平仄。平平仄仄平仄。仄仄仄、平平仄仄。仄仄平平，仄平平仄，平平平仄。,0,24,25,49,"[4, 4, 4, 4, 4, 4, 6, 3, 4, 4, 4, 4]"
柳梢青 ,吴瓘,平仄平平，平平平仄，平平平仄。仄仄平平，仄平仄仄，仄平平仄。仄平平、仄仄平平，仄仄仄、平平仄仄。仄仄平平，平平仄仄，仄平平仄。,0,26,24,50,"[4, 4, 4, 4, 4, 4, 3, 4, 3, 4, 4, 4, 4]"
柳梢青 ,无名氏,平平仄平平仄。仄仄仄、平平仄仄。仄仄平平，平平平仄，仄平平仄。平平仄仄平平，平仄仄、仄平平仄。仄仄平平，平平平仄，仄平平仄。,0,27,23,50,"[6, 3, 4, 4, 4, 4, 6, 3, 4, 4, 4, 4]"
醉乡春 ,秦观,仄仄仄平平仄。平仄仄平平仄。仄仄仄，仄平平，平仄仄平平仄。仄仄仄平平仄。仄仄平平仄仄。仄平仄，仄平平，仄平仄仄平平仄。,0,20,29,49,"[6, 6, 3, 3, 6, 6, 6, 3, 3, 7]"
太常引 ,辛弃疾,平平仄仄仄平平。仄仄仄平平。平仄仄平平。仄平仄、平平仄平。平平仄仄，平平仄仄，仄仄仄平平。仄仄仄平平。仄仄仄、平平仄平。,0,24,25,49,"[7, 5, 5, 3, 4, 4, 4, 5, 5, 3, 4]"
太常引 ,高观国,仄平平仄仄平平。仄平仄、仄平平。平仄仄平平。仄仄仄、平平仄平。仄平平仄，仄平平仄，仄仄仄平平。平仄仄平平。仄仄仄、平平仄平。,0,25,25,50,"[7, 3, 3, 5, 3, 4, 4, 4, 5, 5, 3, 4]"
应天长 ,韦庄,仄平平仄平平仄。平仄平平平仄仄。仄平平，平仄仄。仄仄仄平平仄仄。仄平平，平仄仄。平仄仄平平仄。仄仄仄平平仄。仄平平仄仄。,0,23,27,50,"[7, 7, 3, 3, 7, 3, 3, 6, 6, 5]"
应天长 ,顾夐,仄仄平平平仄仄。平仄平平平仄仄。平平仄，平平仄。仄仄仄平平仄仄。仄平平平仄。仄仄平平平仄。仄仄平平仄仄。仄平平仄仄。,0,23,26,49,"[7, 7, 3, 3, 7, 5, 6, 6, 5]"
应天长 ,冯延巳,仄平平仄平平仄。平仄仄平平仄仄。平平仄。平平仄。平仄仄平平仄仄。仄平平仄仄。平仄仄平平仄。仄仄平平仄仄。平平仄仄仄。,0,23,26,49,"[7, 7, 3, 3, 7, 5, 6, 6, 5]"
应天长 ,毛文锡,平平平仄平平仄。仄仄仄平平仄仄。平平仄仄平平仄。平仄仄平平仄仄。平平平仄仄。平仄平平平仄。平仄平平平仄。平仄仄平仄。,0,27,23,50,"[7, 7, 7, 7, 5, 6, 6, 5]"
应天长 ,柳永,平平平仄仄。仄仄仄平平，仄仄平仄。平仄平平，仄仄平平平仄。平平平仄仄。仄平仄、仄平平仄。仄仄仄，仄仄平平，仄平平仄。仄仄仄平仄。仄仄仄平平，仄仄平仄。平仄平平，平仄平平平仄。平平平仄仄。仄平仄、仄平平仄。平仄仄。平仄平平，仄仄平仄。,0,44,50,94,"[5, 5, 4, 4, 6, 5, 3, 4, 3, 4, 4, 5, 5, 4, 4, 6, 5, 3, 4, 3, 4, 4]"
应天长 ,叶梦得,平平平仄仄，仄仄仄平平，仄平平仄。平仄平平，仄仄仄平平仄。平平平仄仄，仄仄仄、仄平平仄。平仄仄，平仄平平，仄平平仄。平仄仄平仄。仄仄仄平平，仄平平仄。平仄平平，平仄仄平平仄。平平平仄仄，仄仄仄、仄平平仄。仄仄仄，平仄平平，仄平平仄。,0,45,49,94,"[5, 5, 4, 4, 6, 5, 3, 4, 3, 4, 4, 5, 5, 4, 4, 6, 5, 3, 4, 3, 4, 4]"
应天长 ,无名氏,平平平仄仄。仄仄仄平平，仄平平仄。仄仄仄仄，平仄平平平仄。仄平平仄仄。仄仄仄、平平平仄。平仄仄。仄仄平平，仄仄平仄。平平平仄仄。仄仄平平平，仄平仄仄。平仄平平，仄仄平平平仄。平平平仄仄。仄仄仄、仄平平仄。平仄仄。平仄平平，平仄平仄。,0,44,50,94,"[5, 5, 4, 4, 6, 5, 3, 4, 3, 4, 4, 5, 5, 4, 4, 6, 5, 3, 4, 3, 4, 4]"
应天长 ,周邦彦,平平仄仄，平仄仄平，平平仄仄平仄。仄仄仄平平仄，平平仄平仄。平平仄，仄平仄。仄仄仄、仄平平仄。仄平仄，仄仄平平，仄仄平仄。平仄仄平平，仄仄平平，平仄仄平仄。仄仄仄平平仄，平平仄平仄。平平仄，平仄仄。仄仄仄、仄平平仄。仄平仄，仄仄平平，平仄平仄。,0,43,55,98,"[4, 4, 6, 6, 5, 3, 3, 3, 4, 3, 4, 4, 5, 4, 5, 6, 5, 3, 3, 3, 4, 3, 4, 4]"
应天长 ,吴文英,仄平仄仄，平仄仄平，平平平仄平仄。仄仄仄平平仄，平平仄平仄。平平仄，平仄仄。仄仄仄、仄平平仄。仄平仄，仄仄平平，仄仄平仄。平仄仄平仄。仄仄平平，平仄仄平仄。仄仄仄平平仄，平平仄平仄。平平仄，平仄仄。仄仄仄、仄平平仄。仄仄仄，仄仄平平，平仄平仄。,0,41,57,98,"[4, 4, 6, 6, 5, 3, 3, 3, 4, 3, 4, 4, 5, 4, 5, 6, 5, 3, 3, 3, 4, 3, 4, 4]"
应天长 ,康与之,仄平仄仄，平仄仄平，平平仄平平仄。平仄平平，仄仄平平仄平仄。平平仄。平仄仄。仄仄仄、仄平平仄。仄平仄，仄仄平平，平平平仄。仄仄仄平仄。平仄平平，平仄仄平仄。平仄仄平，平仄平平仄平仄。仄平仄。平仄仄。仄仄仄、仄平平仄。仄平仄，仄仄平平，仄平平仄。,0,45,53,98,"[4, 4, 6, 4, 7, 3, 3, 3, 4, 3, 4, 4, 5, 4, 5, 4, 7, 3, 3, 3, 4, 3, 4, 4]"
应天长 ,王沂孙,平平仄仄，平仄仄平，平平仄仄平仄。仄仄仄平平仄。平平仄平仄。平平仄，平仄仄。仄仄仄，仄平平仄。仄平仄、仄仄平平，平仄平仄。平仄仄平平，仄仄平平，平仄仄平仄。仄仄仄平平仄。平平仄平仄。平平仄，平仄仄。仄仄仄、仄平平仄。仄平仄，平仄平平，仄仄平仄。,0,44,54,98,"[4, 4, 6, 6, 5, 3, 3, 3, 4, 3, 4, 4, 5, 4, 5, 6, 5, 3, 3, 3, 4, 3, 4, 4]"
应天长 ,陈允平,平平仄仄，平仄仄平，平平仄仄平仄。仄仄仄平平仄，平平仄平仄。平平仄平仄仄。平仄仄、平平平仄。仄平仄，平仄平平，平仄平仄。平仄仄平平，仄仄平平，平仄仄平仄。仄仄平平平仄，平平仄平仄。平平仄平仄仄。仄平仄、仄平平仄。仄平仄，仄仄平平，平仄平仄。,0,49,49,98,"[4, 4, 6, 6, 5, 6, 3, 4, 3, 4, 4, 5, 4, 5, 6, 5, 6, 3, 4, 3, 4, 4]"
满宫花 ,尹鹗,仄平平，平仄仄。仄仄仄平平仄。仄平仄仄仄平平，仄仄仄平平仄。平仄平，平仄仄。平仄仄平平仄。仄平平仄仄平平，平仄仄平平仄。,0,23,27,50,"[3, 3, 6, 7, 6, 3, 3, 6, 7, 6]"
满宫花 ,张泌,平仄平，平仄仄。仄仄仄平平仄。仄平平仄仄平平，平仄仄平平仄。平仄平平平仄仄。仄仄平平平仄。平平平仄仄平平，平仄平平平仄。,0,28,23,51,"[3, 3, 6, 7, 6, 7, 6, 7, 6]"
少年游 ,晏殊,平平平仄仄平平。平仄仄平平。平平平仄，平平平仄，平仄仄平平。平平仄仄平平仄，平仄仄平平。仄仄平平，仄平平仄，平仄仄平平。,0,31,19,50,"[7, 5, 4, 4, 5, 7, 5, 4, 4, 5]"
少年游 ,李甲,平仄仄平平仄仄，仄仄仄平平。仄平仄仄，仄平平仄，平仄仄平平。平平仄仄平平仄，仄仄仄平平。仄平仄仄，仄平仄仄，平仄仄平平。,0,22,28,50,"[7, 5, 4, 4, 5, 7, 5, 4, 4, 5]"
少年游 ,柳永,仄平平仄仄平平。平仄仄平平。平平仄仄，仄平平仄，平仄仄平平。平平仄仄平平仄，平平仄、仄平平。仄仄平平，仄平平仄，平仄仄平平。,0,29,22,51,"[7, 5, 4, 4, 5, 7, 3, 3, 4, 4, 5]"
少年游 ,柳永,仄平平仄仄平平。平仄仄、仄平平。仄平平仄，平平平仄，平仄仄平平。平平仄仄平平仄，平平仄、仄平平。仄仄平平，仄平平仄，平仄仄平平。,0,30,22,52,"[7, 3, 3, 4, 4, 5, 7, 3, 3, 4, 4, 5]"
少年游 ,周密,平平仄仄仄平平。平仄仄平平。仄仄平平，仄平平仄，仄仄平平。仄平仄仄平平仄，平仄仄平平。平平平仄，仄平平仄，仄仄平平。,0,26,22,48,"[7, 5, 4, 4, 4, 7, 5, 4, 4, 4]"
少年游 ,杜安世,仄平平仄仄平平。平仄仄平平。平平仄仄，仄平平仄，仄仄仄平平。平平平仄平平仄，仄仄仄平平。平平平仄仄平平。仄平仄、仄平平。,0,28,22,50,"[7, 5, 4, 4, 5, 7, 5, 7, 3, 3]"
少年游 ,向子諲,仄平平仄平平仄，仄仄仄平平。平平平仄，平平仄仄，平仄仄平平。仄仄平平平仄仄，平仄仄平平。平仄平平平仄仄，平仄仄、仄平平。,0,27,23,50,"[7, 5, 4, 4, 5, 7, 5, 7, 3, 3]"
少年游 ,姜夔,平平仄仄，平平平仄，平仄仄平平。仄仄平平，平平平仄，平仄仄平平。平平仄仄平平仄，平仄仄平平。平仄平平，平平平仄，平仄仄平平。,0,32,19,51,"[4, 4, 5, 4, 4, 5, 7, 5, 4, 4, 5]"
少年游 ,韩淲,平平平仄，平平仄仄，平仄仄平平。平仄平平，仄平平仄，平仄仄平平。平平仄仄平平仄，平平仄、仄平平。仄仄平平，仄平平仄，平仄仄平平。,0,31,21,52,"[4, 4, 5, 4, 4, 5, 7, 3, 3, 4, 4, 5]"
少年游 ,晏几道,仄平平仄，平平仄仄，平仄仄平平。平平仄仄，平平平仄，平仄仄平平。平平仄仄，平平仄仄，平仄仄平平。仄仄平平，仄平平仄，平仄仄平平。,0,29,23,52,"[4, 4, 5, 4, 4, 5, 4, 4, 5, 4, 4, 5]"
少年游 ,杜安世,仄平平仄仄平平。仄仄仄平平。平平仄仄，仄平平仄，平仄仄平平。仄平平仄，平平仄仄，平仄仄平平。平平仄仄仄平平。仄仄仄、仄平平。,0,26,25,51,"[7, 5, 4, 4, 5, 4, 4, 5, 7, 3, 3]"
少年游 ,苏轼,仄平平仄，平平平仄，平仄仄平平。平平平仄，平平仄仄，平仄仄平平。仄仄仄平平平仄，平仄仄平平。仄仄平平平平仄，平平仄、仄平平。,0,30,21,51,"[4, 4, 5, 4, 4, 5, 7, 5, 7, 3, 3]"
少年游 ,晏几道,平平仄仄，平平仄仄，平仄仄平平。平平仄仄，仄平平仄，仄仄仄平平。平平仄仄，平平仄仄，平仄仄平平。平平平仄仄平平。平仄仄平平。,0,28,23,51,"[4, 4, 5, 4, 4, 5, 4, 4, 5, 7, 5]"
少年游 ,杨亿,平平仄仄，仄平平仄，平仄仄平平。平平仄仄，仄平平仄，平仄仄平平。仄平平仄，平平仄仄，仄仄仄平平。仄平平仄仄平平。仄仄仄、仄平平。,0,26,26,52,"[4, 4, 5, 4, 4, 5, 4, 4, 5, 7, 3, 3]"
少年游 ,晁补之,平平平仄，仄仄平平，平平仄仄。仄仄仄仄平仄，仄仄仄、平平仄仄。仄平平仄，仄平平仄，平平平仄。仄仄仄、仄平平仄，仄仄平仄仄。,0,20,29,49,"[4, 4, 4, 6, 3, 4, 4, 4, 4, 3, 4, 5]"
偷声木兰花 ,冯延巳,仄平仄仄平平仄。平仄平平平仄仄。平仄平平。仄仄平平仄仄平。平平平仄平平仄。平仄仄平平仄仄。仄仄平平。仄仄平平仄仄平。,0,26,24,50,"[7, 7, 4, 7, 7, 7, 4, 7]"
滴滴金 ,李遵勖,仄平仄仄仄平仄。平平仄、仄平仄。平平平仄仄平平，仄平仄平仄。平仄仄平平仄仄。平平仄、仄平仄。仄平平仄仄平平，仄仄平平仄。,0,24,26,50,"[7, 3, 3, 7, 5, 7, 3, 3, 7, 5]"
滴滴金 ,晏殊,平平仄仄平平仄。仄平平、仄平仄。仄仄平平仄平仄。仄平平平仄。平平仄仄平平仄。仄平平、仄平仄。平仄平平仄平仄。仄仄平平仄。,0,26,24,50,"[7, 3, 3, 7, 5, 7, 3, 3, 7, 5]"
滴滴金 ,杨无咎,平平仄仄平平仄。仄平仄、仄平仄。仄仄平平平仄仄。仄平平平仄。平平平仄平平仄。仄平平、仄平仄。仄仄平平仄平平，仄仄平平仄。,0,26,24,50,"[7, 3, 3, 7, 5, 7, 3, 3, 7, 5]"
滴滴金 ,孙道绚,仄平平仄平平仄。平仄仄、仄平仄。仄仄平平仄仄平，仄平平平仄。仄平仄仄平平仄。仄仄平平仄平仄。仄仄平平仄平平，仄平平平仄。,0,25,26,51,"[7, 3, 3, 7, 5, 7, 7, 7, 5]"
忆汉月 ,欧阳修,平仄仄平平仄。仄仄平平平仄。仄平平仄仄平平，仄仄仄平平仄。平平平仄仄，平仄仄、仄平平仄。仄平平仄仄平平，平仄仄平平仄。,0,25,25,50,"[6, 6, 7, 6, 5, 3, 4, 7, 6]"
忆汉月 ,柳永,平仄平仄平仄。平仄仄平平仄。仄平平仄仄平平，平仄平平平仄。仄平平仄仄，仄仄仄平平仄。平仄平平仄平仄，仄仄仄、平平平仄。,0,25,25,50,"[6, 6, 7, 6, 5, 6, 7, 3, 4]"
忆汉月 ,杜安世,平仄仄平平仄。平仄仄平平仄。平平平仄仄平平，仄平平、仄平平仄。仄平平仄仄，仄仄仄、仄平平仄。仄仄平平仄平仄。仄平平、仄平平仄。,0,26,26,52,"[6, 6, 7, 3, 4, 5, 3, 4, 7, 3, 4]"
忆汉月 ,李遵勖,平仄仄平平仄。仄仄仄平平仄。仄平仄仄仄平平，仄平平、仄平平仄。平平平仄仄。仄仄仄、仄平平仄。仄平平仄仄平平，仄仄仄、仄平平仄。,0,23,29,52,"[6, 6, 7, 3, 4, 5, 3, 4, 7, 3, 4]"
西江月 ,柳永,仄仄仄平平仄，仄平平仄平平。仄平平仄仄平平。平仄平平平仄。仄仄仄平平仄，平平平仄平平。仄平仄仄仄平平。仄仄平平仄仄。,0,26,24,50,"[6, 6, 7, 6, 6, 6, 7, 6]"
西江月 ,苏轼,仄仄平平仄仄。平平平仄平平。平平仄仄仄平平。平仄平平平仄。仄仄平平仄仄。仄平平仄平平。仄平仄仄仄平平。仄仄平平平仄。,0,27,23,50,"[6, 6, 7, 6, 6, 6, 7, 6]"
西江月 ,吴文英,平仄仄平仄仄，仄平仄仄平平。仄平仄仄仄平平。平仄平平平仄。平仄平平平仄，仄平平仄平平。仄平平仄仄平平。平仄平平平仄。,0,28,22,50,"[6, 6, 7, 6, 6, 6, 7, 6]"
西江月 ,欧阳炯,仄仄平平平仄。平平仄仄平平。仄平平仄仄平平。仄仄仄平平仄。平平仄仄平平仄。平平仄仄平平。仄平平仄仄平平。仄仄平平仄仄。,0,27,24,51,"[6, 6, 7, 6, 7, 6, 7, 6]"
西江月 ,赵以仁,仄仄平平平仄，仄平平仄平平。仄平平仄仄平平。仄仄平平、平仄仄平平。仄仄平平仄仄，仄平仄仄平平。仄平平仄仄平平。仄仄仄平、平仄仄平平。,0,29,27,56,"[6, 6, 7, 4, 5, 6, 6, 7, 4, 5]"
惜春令 ,杜安世,平仄平平平仄平。平平仄、仄仄平平。仄仄平平平仄仄，平仄仄平平。仄仄平平平。仄平仄、平仄平平。仄仄平平平仄仄，平仄仄平平。,0,28,22,50,"[7, 3, 4, 7, 5, 5, 3, 4, 7, 5]"
惜春令 ,杜安世,平仄平平平仄仄。平仄仄、仄平平平。仄平平仄平平仄，平仄仄平平。平仄平平仄。仄平仄、仄平平平。平平平仄平平仄，平仄仄平平。,0,30,20,50,"[7, 3, 4, 7, 5, 5, 3, 4, 7, 5]"
留春令 ,晏几道,仄平平仄，仄平平仄，仄平平仄。仄仄平平仄平平，仄平仄、平平仄。仄仄平平平仄仄。仄平平平仄。平仄平平仄平平，仄平仄、平平仄。,0,27,23,50,"[4, 4, 4, 7, 3, 3, 7, 5, 7, 3, 3]"
留春令 ,李之仪,仄仄平平，仄平平仄，仄平平仄。平仄平平，平平仄仄，仄仄平平仄。仄仄平平平仄仄。仄仄平平仄。平平仄仄，平平仄仄，仄仄平平仄。,0,24,26,50,"[4, 4, 4, 4, 4, 5, 7, 5, 4, 4, 5]"
留春令 ,沈端节,仄平平仄，平平平仄，平平平仄。仄仄平、仄仄仄平仄，仄仄平平仄。平平仄仄平平仄。平仄仄平平仄。仄仄平、平仄平平平仄，仄仄平平仄。,0,26,26,52,"[4, 4, 4, 3, 5, 5, 7, 6, 3, 6, 5]"
留春令 ,黄庭坚,平平仄仄平平仄。仄仄仄、仄平平仄。平平平仄仄平平，仄仄仄、平平仄。仄仄平平平平仄。平平仄、仄平平仄。仄平平仄仄平平，仄仄仄平平仄。,0,27,27,54,"[7, 3, 4, 7, 3, 3, 7, 3, 4, 7, 6]"
梁州令 ,晏几道,仄仄平平仄。仄仄平平平仄。平平仄仄仄平平，平平仄仄平平仄。平平平仄平平仄。仄仄平平仄。平平仄仄平仄。平平仄仄平平仄。,0,27,23,50,"[5, 6, 7, 7, 7, 5, 6, 7]"
梁州令 ,晁补之,仄仄平平仄。仄平平平平仄。平平平仄仄平平，平平仄仄，仄仄平平仄。平平仄仄平平仄。仄仄平平仄。平平平仄平仄。平平仄仄平平仄。,0,29,23,52,"[5, 6, 7, 4, 5, 7, 5, 6, 7]"
梁州令 ,柳永,仄仄平平仄。平平仄平平仄。平平平仄仄平平，平平仄仄，平仄平平仄。平平仄仄平平仄。仄仄平平仄。仄平平仄平平仄，仄仄平平，平仄仄平仄。,0,30,25,55,"[5, 6, 7, 4, 5, 7, 5, 7, 4, 5]"
梁州令 ,欧阳修,仄仄平平仄。仄仄平平平仄。平平平仄仄平平，仄平平仄，仄仄平平仄。仄平仄仄平平仄。仄仄平平仄。仄平平仄平仄，平平仄仄平平仄。仄仄平平仄。平平仄平平仄。平平平仄仄平平，平平仄仄，仄仄平平仄。平平仄仄平平仄。平仄平平仄。平平仄仄平仄，平平仄仄平平仄。,0,55,49,104,"[5, 6, 7, 4, 5, 7, 5, 6, 7, 5, 6, 7, 4, 5, 7, 5, 6, 7]"
盐角儿 ,晁补之,平平仄仄。仄平仄仄。平平平仄。平平仄仄，平平仄仄，仄平平仄。仄平平，平平仄。平平仄平平平仄。仄平仄、平平仄仄，平仄仄平平仄。,0,27,23,50,"[4, 4, 4, 4, 4, 4, 3, 3, 7, 3, 4, 6]"
归田乐 ,晁补之,平仄仄，仄仄平平平仄仄。平平仄，仄平仄、平仄仄。仄平平仄仄，仄平仄。仄仄仄、平平仄，平平平平仄。仄平仄、平平平仄，仄平平仄仄。,0,23,27,50,"[3, 7, 3, 3, 3, 5, 3, 3, 3, 5, 3, 4, 5]"
归田乐 ,蔡伸,平平平仄平平仄。平仄仄平平仄。仄仄仄平平，平仄平平仄平仄。平平仄仄平平仄。平仄仄平平仄。平仄仄平平，平仄仄平平平仄。,0,28,22,50,"[7, 6, 5, 7, 7, 6, 5, 7]"
归田乐 ,晏几道,仄仄平平仄。仄仄仄、仄平平仄。平仄平平仄。仄平仄仄仄，平仄平仄。仄仄平平仄平仄。平平平仄仄。仄仄仄、平平平仄仄。仄平平仄，仄仄平平仄。仄平仄仄仄，仄平平仄。平仄平平仄平仄。,0,30,41,71,"[5, 3, 4, 5, 5, 4, 7, 5, 3, 5, 4, 5, 5, 4, 7]"
归田乐 ,无名氏,仄仄平平仄。仄平平、仄平平仄。平平仄平仄。仄仄仄仄仄。仄仄平仄。仄仄平平仄平仄。平平平仄仄。仄仄仄、仄平平仄仄。仄平仄仄，仄仄平平仄。仄仄仄仄仄。仄仄平仄。平仄平平仄平仄。,0,26,45,71,"[5, 3, 4, 5, 5, 4, 7, 5, 3, 5, 4, 5, 5, 4, 7]"
归田乐 ,黄庭坚,仄仄平平仄。仄仄平、仄平仄仄，仄仄平平仄。仄仄仄仄仄。仄仄仄仄。仄仄平平仄平仄。平平仄仄仄。仄平平平平平仄。仄平平仄，平仄平平仄。仄仄仄仄仄。仄仄平仄。仄仄平平仄平仄。,0,25,45,70,"[5, 3, 4, 5, 5, 4, 7, 5, 7, 4, 5, 5, 4, 7]"
惜分飞 ,毛滂,仄仄平平平仄仄。平仄平平仄仄。仄仄平平仄。仄平平仄。平平仄。仄仄平平平仄仄。仄仄平平仄仄。平仄平平仄。仄平平仄。平平仄。,0,24,26,50,"[7, 6, 5, 4, 3, 7, 6, 5, 4, 3]"
惜分飞 ,刘弇,平仄仄平平仄仄。平仄仄、平平平仄。仄仄平平仄。仄平仄仄平平仄。仄平平仄平平仄。平仄仄、平平平仄。仄仄平平仄。仄平仄仄平平仄。,0,25,27,52,"[7, 3, 4, 5, 7, 7, 3, 4, 5, 7]"
惜分飞 ,张先,平仄平平平平仄。平仄仄、平平仄仄。平仄仄仄平仄。仄平平仄平平仄。仄仄平平平仄仄。平仄仄、平平仄仄。平仄仄仄平仄。仄平平仄平平仄。,0,26,28,54,"[7, 3, 4, 6, 7, 7, 3, 4, 6, 7]"
惜分飞 ,无名氏,仄仄平平平仄仄。仄仄仄、仄平平仄。仄仄平平仄。平仄平平、平仄平平仄。仄仄平平平仄仄。仄仄仄、平平仄仄。仄仄平平仄。平仄平平、仄仄平平仄。,0,25,31,56,"[7, 3, 4, 5, 4, 5, 7, 3, 4, 5, 4, 5]"
惜分飞 ,无名氏,仄仄平平平仄仄。仄平仄、平平仄仄。仄仄平平仄。仄仄平仄平平、平平仄。仄仄平平平仄仄。仄仄仄、平平仄仄。仄仄仄平仄。仄平仄仄平平、平平仄。,0,24,32,56,"[7, 3, 4, 5, 6, 3, 7, 3, 4, 5, 6, 3]"
孤馆深沉 ,权无染,平平仄仄仄平平。平仄仄平平。仄仄仄平平，仄仄仄平，平仄平平。仄仄仄、仄平平仄，仄仄仄平平。仄平仄，仄平平仄，仄平平仄平平。,0,24,26,50,"[7, 5, 5, 4, 4, 3, 4, 5, 3, 4, 6]"
促拍采桑子 ,朱敦儒,平仄仄平平。仄平平、平仄平平。平平仄仄，平平仄仄，平仄平平。仄仄平平平仄仄，仄平平、平仄平平。平平仄仄，平平仄仄，仄仄平平。,0,29,21,50,"[5, 3, 4, 4, 4, 4, 7, 3, 4, 4, 4, 4]"
怨三三 ,李之仪,平平仄仄仄平平。仄仄平平。仄仄平平仄仄平。仄平仄、仄平平。平平仄仄平平。仄平仄、平平仄平。仄仄仄平平。平平平仄，仄仄平平。,0,27,23,50,"[7, 4, 7, 3, 3, 6, 3, 4, 5, 4, 4]"
使牛子 ,曹冠,仄平仄仄平平仄。平仄仄平仄仄。平仄仄平平，平仄平平仄平仄。仄平仄仄平平仄。平仄平平仄仄。仄仄仄平平，仄仄平平平仄仄。,0,23,27,50,"[7, 6, 5, 7, 7, 6, 5, 7]"
折丹桂 ,王之道,平平仄仄平平仄。仄仄平平仄。仄平平仄仄平平，仄仄仄、平平仄。平平仄仄平平仄。平仄平平仄。仄平平仄仄平平，仄仄仄、平平仄。,0,25,25,50,"[7, 5, 7, 3, 3, 7, 5, 7, 3, 3]"
竹香子 ,刘过,仄仄平平平仄。仄仄仄平仄仄。平平仄仄仄平平，仄仄平平仄。平平仄仄仄仄。仄仄平、仄仄平仄。平平仄仄仄平平，仄仄平平仄仄。,0,20,30,50,"[6, 6, 7, 5, 6, 3, 4, 7, 6]"
城头月 ,马天骥,平平仄仄平平仄。仄仄平平仄。仄仄平平，平平仄仄，仄仄平平仄。仄平平仄平平仄。仄仄平平仄。仄仄平平，平平仄仄，平仄平平仄。,0,25,25,50,"[7, 5, 4, 4, 5, 7, 5, 4, 4, 5]"
四犯令 ,侯寘,仄仄平平平仄仄。仄仄平平仄。仄仄平平平平仄。平仄仄、平平仄。平仄平平平仄仄。平仄平平仄。仄仄平平平仄仄。平仄仄、平平仄。,0,25,25,50,"[7, 5, 7, 3, 3, 7, 5, 7, 3, 3]"
醉高歌 ,姚燧,仄平平仄平平。仄仄平平仄仄。平平平仄平平仄。仄仄平平仄仄。平平仄仄平平。仄仄平平仄仄。平平仄仄平仄仄。仄仄平平仄仄。,0,24,26,50,"[6, 6, 7, 6, 6, 6, 7, 6]"
黄鹤洞仙 ,马钰,平仄仄平平，平仄平平仄。仄仄平平仄仄平，平仄仄。仄仄平平仄。仄仄仄平平，仄仄平平仄。仄仄平平仄仄平，仄仄仄。平仄平平仄。,0,22,28,50,"[5, 5, 7, 3, 5, 5, 5, 7, 3, 5]"
破字令 ,无名氏,仄仄平平仄。仄仄仄、平平平仄。平平平仄仄平平，仄平平仄仄。平平仄仄平平仄。仄平平、仄平平仄。仄平仄仄，平平仄仄，仄平平仄。,0,25,25,50,"[5, 3, 4, 7, 5, 7, 3, 4, 4, 4, 4]"
花前饮 ,无名氏,仄平平仄仄平仄。仄平仄、平平平仄。仄仄平仄平，仄仄仄、平平仄。仄仄平平仄平仄。仄平仄、平平平仄。仄仄平仄平，仄仄仄、仄仄仄。,0,20,30,50,"[7, 3, 4, 5, 3, 3, 7, 3, 4, 5, 3, 3]"
导引 ,无名氏,平平仄仄，平仄仄平平。仄仄仄平平。平平仄仄平平仄，平仄仄平平。平平仄仄仄平平。仄仄仄平平。平平平仄平平仄，平仄仄平平。,0,28,22,50,"[4, 5, 5, 7, 5, 7, 5, 7, 5]"
导引 ,无名氏,仄平仄仄，平仄仄平平。仄仄仄平平。平平仄仄平平仄，平仄仄平平。平平仄仄平平仄，平仄仄平平。平平仄仄平平仄，平仄仄平平。,0,27,23,50,"[4, 5, 5, 7, 5, 7, 5, 7, 5]"
导引 ,无名氏,平平仄仄，仄仄仄平平。仄仄仄平平。平平平仄平平仄，仄仄仄平平。仄平仄仄平平仄，平仄仄平平。平平仄仄平平仄，平仄仄平平。仄平平仄，仄仄仄平平。仄仄仄平平。平平仄仄平平仄，平仄仄平平。平平仄仄仄平平。平仄仄平平。平平仄仄平平仄，平仄仄平平。,0,53,47,100,"[4, 5, 5, 7, 5, 7, 5, 7, 5, 4, 5, 5, 7, 5, 7, 5, 7, 5]"
导引 ,无名氏,平平仄仄，仄仄仄平平。仄仄仄平平。仄平仄仄平平仄，仄仄仄平平。平平仄仄平平仄，仄仄仄平平。平平仄仄平平仄，平仄仄平平。仄平平仄，仄仄仄平平。仄仄仄平平。仄平仄仄平平仄，平仄仄平平。平平仄仄平平仄，仄仄仄平平。平平平仄平平仄，仄仄仄平平。,0,49,51,100,"[4, 5, 5, 7, 5, 7, 5, 7, 5, 4, 5, 5, 7, 5, 7, 5, 7, 5]"
导引 ,无名氏,仄平仄仄，仄仄仄平平。仄仄仄平平。平平仄仄平平仄，仄仄仄平平。仄平仄仄仄平平。仄仄仄平平。平平仄仄平平仄，仄仄仄平平。平平仄仄，平仄仄平平。仄仄仄平平。平平仄仄平平仄，平仄仄平平。平平仄仄仄平平。平仄仄平平。平平仄仄平平仄，仄仄仄平平。,0,49,51,100,"[4, 5, 5, 7, 5, 7, 5, 7, 5, 4, 5, 5, 7, 5, 7, 5, 7, 5]"
思越人 ,孙光宪,仄平平，平仄仄，仄平平仄平平。仄仄平平平仄仄，平平平仄平平。仄平平仄平平仄。仄平仄仄平仄。平仄平平平仄仄。平平仄仄平仄。,0,28,23,51,"[3, 3, 6, 7, 6, 7, 6, 7, 6]"
探春令 ,宋徽宗,平平平仄，仄平平仄，平平平仄。仄平仄仄平平仄。仄平仄、平平仄。平平仄仄平平仄。仄平平平仄。仄仄平、仄仄平平，平仄仄仄平平仄。,0,27,24,51,"[4, 4, 4, 7, 3, 3, 7, 5, 3, 4, 7]"
探春令 ,杨无咎,仄平平仄，仄平平仄，仄平平仄。仄平仄、平仄平平仄。仄仄仄、平平仄。平平平仄平平仄。仄平平平仄。仄仄平、平仄平平平仄。仄仄平平仄。,0,27,25,52,"[4, 4, 4, 3, 5, 3, 3, 7, 5, 3, 6, 5]"
探春令 ,赵长卿,仄平平仄，仄平平仄，平平平仄。仄平平、仄仄平平仄。仄平仄、平平仄。仄平平仄平平仄。仄平平平仄。仄仄平仄仄，平平仄仄，仄仄平平仄。,0,26,26,52,"[4, 4, 4, 3, 5, 3, 3, 7, 5, 5, 4, 5]"
探春令 ,赵长卿,平平平仄，仄平平仄，平平平仄。仄平平仄仄，平平平仄，平仄平平仄。平平仄仄平仄仄。仄平平平仄。仄仄平仄仄，平平仄仄，仄仄平平仄。,0,27,25,52,"[4, 4, 4, 5, 4, 5, 7, 5, 5, 4, 5]"
探春令 ,赵长卿,平平平仄，仄平平仄，仄平平仄。仄平平、平仄平平仄仄，仄仄平平仄。平平仄仄平平仄。仄平平平仄。仄平平、仄仄仄平仄仄，仄仄平平仄。,0,26,26,52,"[4, 4, 4, 3, 6, 5, 7, 5, 3, 6, 5]"
探春令 ,赵长卿,平平平仄，仄平平仄，仄平平仄。仄平仄、仄仄平平平仄。平仄平平仄。平平仄仄平平仄。仄平平仄仄。仄平平、仄仄平平平仄，仄仄平平仄。,0,27,25,52,"[4, 4, 4, 3, 6, 5, 7, 5, 3, 6, 5]"
探春令 ,赵长卿,平平平仄。仄平平仄。平平平仄。仄平平仄仄、平平平仄，仄仄平平仄。仄平平仄平平仄。仄平平仄仄。仄仄平仄仄，平平平仄，仄仄平平仄。,0,27,25,52,"[4, 4, 4, 5, 4, 5, 7, 5, 5, 4, 5]"
探春令 ,赵长卿,平平平仄，仄平平仄，平平平仄。仄平平平仄，平平仄仄，仄平仄、平平仄。平平平仄平平仄。仄平平平仄。仄仄平平仄，平平平仄，仄仄平平仄。,0,31,22,53,"[4, 4, 4, 5, 4, 3, 3, 7, 5, 5, 4, 5]"
探春令 ,杨无咎,平平仄仄，仄平平仄，平平平仄。仄仄平、平仄平平仄。仄平仄、平平仄。平平仄仄平平仄。仄平平平仄。仄仄平、仄仄平平仄。仄平仄、平平仄。,0,27,25,52,"[4, 4, 4, 3, 5, 3, 3, 7, 5, 3, 5, 3, 3]"
探春令 ,晏几道,仄平平仄仄平平，仄平平平仄。仄仄平、平仄平平仄。仄平仄、平平仄。仄平平仄平平仄。仄平平平仄。仄仄平、仄仄平平仄，仄平仄、平平仄。,0,27,25,52,"[7, 5, 3, 5, 3, 3, 7, 5, 3, 5, 3, 3]"
探春令 ,无名氏,仄平平仄仄平平，仄平平仄仄。仄仄平、仄仄平平仄，仄平仄、平平仄。平平平仄平平仄。仄平平平仄。仄仄平、仄仄平平仄，仄平仄、平平仄。,0,26,26,52,"[7, 5, 3, 5, 3, 3, 7, 5, 3, 5, 3, 3]"
探春令 ,赵长卿,仄平平仄仄平平，仄平平平仄。仄平平仄仄，平平仄仄，仄仄平平仄。平平仄仄平平仄。仄平平平仄。仄平平仄仄，平平仄仄，仄仄平平仄。,0,26,26,52,"[7, 5, 5, 4, 5, 7, 5, 5, 4, 5]"
探春令 ,赵长卿,平平仄仄平平仄。仄平平平仄。仄平平仄，平平平仄。平仄仄、平平仄。平平仄平平平仄。仄仄仄仄仄。仄平平仄仄，仄仄仄仄。仄仄平平仄。,0,24,28,52,"[7, 5, 4, 4, 3, 3, 7, 5, 5, 4, 5]"
越江吟 ,苏易简,平平平仄平平仄。仄仄。仄平仄仄平仄。平平仄。平平仄仄。平平仄。平平平、平仄平仄。仄平仄。平平仄仄仄仄。平平仄。平平仄仄。平平仄。,0,27,24,51,"[7, 2, 6, 3, 4, 3, 3, 4, 3, 6, 3, 4, 3]"
越江吟 ,苏轼,平平平仄。平平仄。仄仄。仄平平仄平仄。平平仄。平平仄仄。平平仄。仄平平、平仄平仄。仄平仄。平平仄仄平仄。平平仄。平平仄仄。平平仄。,0,28,23,51,"[4, 3, 2, 6, 3, 4, 3, 3, 4, 3, 6, 3, 4, 3]"
燕归梁 ,晏殊,平仄平平仄仄平。仄平仄平平。平平平仄仄平平。仄平仄、仄平平。平平仄仄，平平仄仄，平仄仄平平。平平平仄仄平平。平平仄、仄平平。,0,31,20,51,"[7, 5, 7, 3, 3, 4, 4, 5, 7, 3, 3]"
燕归梁 ,史达祖,仄仄平平仄仄平。仄仄仄平平。仄平仄仄仄平平。仄仄仄、仄平平。平平平仄平平仄，仄平仄、仄平平。平平仄仄仄平平。仄仄仄、仄平平。,0,24,27,51,"[7, 5, 7, 3, 3, 7, 3, 3, 7, 3, 3]"
燕归梁 ,柳永,仄仄平平仄仄平。仄仄平平。仄平平仄仄平平。平平仄、仄平平。平平仄仄平平仄，平平仄、仄平平。仄平平仄仄平平。仄仄仄、仄平平。,0,27,23,50,"[7, 4, 7, 3, 3, 7, 3, 3, 7, 3, 3]"
燕归梁 ,柳永,平仄平平仄仄平。平平仄、仄平平。仄平平仄仄平平。仄仄仄、仄平平。平平仄仄平平仄，平平仄、仄平平。仄平仄仄仄平平。仄仄仄、仄平平。,0,27,25,52,"[7, 3, 3, 7, 3, 3, 7, 3, 3, 7, 3, 3]"
雨中花令 ,晏殊,仄仄平平仄仄。仄仄平平仄仄。仄仄平平平仄仄，仄仄平平仄。仄仄仄平平仄仄。仄仄仄、仄平平仄。仄仄仄、仄平平仄仄，仄仄平平仄。,0,17,34,51,"[6, 6, 7, 5, 7, 3, 4, 3, 5, 5]"
雨中花令 ,毛滂,平仄平平仄仄。仄仄仄平平仄。平仄平平平仄仄，仄仄平平仄。仄仄仄平平仄仄。仄仄仄仄平仄。平仄仄平平，平平仄仄，仄仄平平仄。,0,21,30,51,"[6, 6, 7, 5, 7, 6, 5, 4, 5]"
雨中花令 ,欧阳修,平仄平平平仄。平仄平平平仄。仄仄平平，平平平仄，仄仄平平仄。仄仄仄平平仄仄。平仄仄平平仄。仄平仄平平，平平仄仄，平仄平平仄。,0,28,24,52,"[6, 6, 4, 4, 5, 7, 6, 5, 4, 5]"
雨中花令 ,毛滂,平仄仄平仄仄。仄仄仄平平仄。仄仄平平，平平仄仄，平仄平平仄。仄仄平平平仄仄。仄平仄、仄平平仄。平仄仄平，平平仄仄，仄仄平平仄。,0,23,29,52,"[6, 6, 4, 4, 5, 7, 3, 4, 4, 4, 5]"
雨中花令 ,赵长卿,仄仄平平平仄仄。仄平仄平平仄。仄仄平平，平平仄仄，仄仄平平仄。平仄平平平仄仄。平平仄平平仄。仄仄平平，平平平仄，仄仄平平仄。,0,27,25,52,"[7, 6, 4, 4, 5, 7, 6, 4, 4, 5]"
雨中花令 ,程垓,仄仄仄平平仄仄。仄仄仄、平平仄仄。仄仄平平，平平仄仄，仄仄平平仄。仄仄仄平平仄仄。仄平仄、仄平平仄。仄仄平平，仄平平仄，仄仄平平仄。,0,21,33,54,"[7, 3, 4, 4, 4, 5, 7, 3, 4, 4, 4, 5]"
雨中花令 ,贺铸,平仄平平平仄仄。仄仄仄、平平仄仄。仄仄平平，仄平平仄，仄仄平平仄。仄仄仄、平平平仄仄。仄平仄、平平仄仄。仄仄平平，平平仄仄，仄仄平平仄。,0,24,31,55,"[7, 3, 4, 4, 4, 5, 3, 5, 3, 4, 4, 4, 5]"
雨中花令 ,杨无咎,仄仄仄、平平仄仄。仄仄仄、仄平平仄。仄仄平平，平平平仄，仄仄平平仄。仄仄平平平仄仄。平仄仄、仄平平仄。仄仄平平，平平仄仄，仄仄平平仄。,0,23,31,54,"[3, 4, 3, 4, 4, 4, 5, 7, 3, 4, 4, 4, 5]"
雨中花令 ,赵长卿,平仄平平平仄。平平仄、仄平平仄。仄仄平平，平平平仄，仄仄平平仄。平仄平平平仄仄。平平仄、仄平仄仄。仄仄平平，平平平仄，仄仄平平仄。,0,29,24,53,"[6, 3, 4, 4, 4, 5, 7, 3, 4, 4, 4, 5]"
雨中花令 ,王	观,仄仄平平平仄仄。仄平仄、仄平仄仄。仄平仄平平，平平平仄，仄仄平平仄。仄仄平平平仄仄。仄仄仄、平平平仄。仄仄仄平平，平平平仄，仄仄平平仄。,0,26,30,56,"[7, 3, 4, 5, 4, 5, 7, 3, 4, 5, 4, 5]"
雨中花令 ,张先,仄仄仄平平仄仄。仄平仄、平平平仄。仄平仄、平平平仄仄。仄仄仄、仄平平仄。仄仄仄、平平平仄仄。仄仄仄、平平仄平仄。仄仄仄仄、仄平平仄仄。仄仄仄、仄平平仄。,0,22,39,61,"[7, 3, 4, 3, 5, 3, 4, 3, 5, 3, 5, 4, 5, 3, 4]"
雨中花令 ,周紫芝,平仄仄、平平平仄，仄仄平平。仄仄平平仄仄，平平仄仄平平。仄平平仄，仄平平仄，仄仄平平。平仄仄、仄平平仄，平仄平平。平仄平平仄仄，平平仄仄平平。仄平平仄，仄平平仄，平仄平平。,0,38,32,70,"[3, 4, 4, 6, 6, 4, 4, 4, 3, 4, 4, 6, 6, 4, 4, 4]"
凤来朝 ,周邦彦,仄仄平平仄。仄平平、仄平仄仄。仄平平仄仄、平平仄。仄仄仄、仄平仄。仄仄平平平仄。仄平平、仄平仄仄。仄仄仄、平平仄。仄仄仄、仄平仄。,0,19,32,51,"[5, 3, 4, 5, 3, 3, 3, 6, 3, 4, 3, 3, 3, 3]"
秋夜雨 ,蒋捷,平平仄仄平平仄。平平平仄平仄。平平平仄仄，仄仄仄、平平平仄。平平仄仄平平仄，仄仄平、平仄平仄。仄仄平仄仄。仄仄仄、平平平仄。,0,25,26,51,"[7, 6, 5, 3, 4, 7, 3, 4, 5, 3, 4]"
伊州令 ,无名氏,平平仄仄平平仄。平仄平平仄。平仄平平平仄平，仄仄仄、平平仄仄。平平平仄平仄。平仄平平仄。平平仄仄仄平平，仄平仄、平平仄仄。,0,28,23,51,"[7, 5, 7, 3, 4, 6, 5, 7, 3, 4]"
木笪 ,白朴,仄平平仄仄。平仄平平仄。仄仄平平平仄仄。平平平仄仄，仄平平仄。仄平平仄。平仄平平仄。仄仄平平平仄仄。平平平仄仄，仄仄平仄。,0,25,26,51,"[5, 5, 7, 5, 4, 4, 5, 7, 5, 4]"
迎春乐 ,柳永,仄平平仄平平仄。仄仄仄、平平仄。仄平平、仄仄平平仄。仄仄仄、平平仄。平仄仄、平平平仄。仄仄仄、平平平仄。仄仄平平平仄，仄仄平平仄。,0,24,28,52,"[7, 3, 3, 3, 5, 3, 3, 3, 4, 3, 4, 6, 5]"
迎春乐 ,晏殊,平平仄仄平平仄。仄平平、仄平仄。仄平平、仄仄平平仄。仄仄仄、平平仄。平仄仄、平平平仄仄。平仄仄、仄平平仄。仄仄平平仄仄，仄仄平平仄。,0,24,29,53,"[7, 3, 3, 3, 5, 3, 3, 3, 5, 3, 4, 6, 5]"
迎春乐 ,秦观,平平仄仄平平仄。平仄仄、平平仄。仄平平仄平平仄。仄仄仄、平平仄。仄仄仄、仄平仄仄。仄平仄、平平平仄。仄仄平平平仄，仄仄平平仄。,0,23,28,51,"[7, 3, 3, 7, 3, 3, 3, 4, 3, 4, 6, 5]"
迎春乐 ,杨无咎,平平仄仄平平仄。平平仄、平平仄。仄平平、仄仄平仄。平仄仄、平平仄。仄仄平平平仄仄。仄平仄、平平平仄。仄仄仄、平平仄，仄仄平平仄。,0,25,26,51,"[7, 3, 3, 3, 4, 3, 3, 7, 3, 4, 3, 3, 5]"
迎春乐 ,贺铸,平平仄仄平平仄。仄平平、仄平仄。平平仄仄平平仄。仄平仄、平平仄。仄仄平平平仄仄。仄平仄、仄平平仄。平仄仄平平，平仄仄、平平仄。,0,26,25,51,"[7, 3, 3, 7, 3, 3, 7, 3, 4, 5, 3, 3]"
迎春乐 ,无名氏,平平仄仄平平仄。平平仄、平平仄。平平平仄平平仄，平仄仄、平平仄。仄仄平平仄仄仄。仄仄仄、仄平平仄。仄仄仄平平，平平仄、平平仄。,0,26,25,51,"[7, 3, 3, 7, 3, 3, 7, 3, 4, 5, 3, 3]"
迎春乐 ,周邦彦,平平仄仄平平仄。仄平仄、仄平仄。仄平平、仄仄平平仄。仄仄仄、平平仄。平仄平平平仄仄。仄平仄、平平平仄。仄仄仄平平，仄仄仄，平平仄。,0,24,28,52,"[7, 3, 3, 3, 5, 3, 3, 7, 3, 4, 5, 3, 3]"
梦仙郎 ,张先,平平平仄。平平仄仄。平仄仄、仄平平仄。平仄仄平平。平仄仄平平。平仄平平平仄。平平仄仄。平仄仄、仄平平仄。平仄仄平平。平仄仄平平。,0,29,23,52,"[4, 4, 3, 4, 5, 5, 6, 4, 3, 4, 5, 5]"
青门引 ,张先,仄仄平平仄。平仄仄平平仄。平平仄仄仄平平，平平仄仄，仄仄仄平仄。平平仄仄平平仄。仄仄平平仄。仄平仄仄平仄，仄平仄仄平平仄。,0,23,29,52,"[5, 6, 7, 4, 5, 7, 5, 6, 7]"
菊花新 ,张先,仄仄平平平仄仄。平仄仄平平仄仄。平仄仄平平，平仄仄、仄平平仄。仄平平仄平平仄。仄平平、仄平平仄。平仄仄平平，平仄仄、仄平平仄。,0,26,26,52,"[7, 7, 5, 3, 4, 7, 3, 4, 5, 3, 4]"
菊花新 ,杜安世,仄仄平平平仄仄。仄仄平平仄平仄。平平仄平仄。平平仄、仄仄平仄。平平平仄平仄仄。平仄平、仄平平仄。仄仄仄平平，平仄仄、仄仄平仄。,0,24,28,52,"[7, 7, 5, 3, 4, 7, 3, 4, 5, 3, 4]"
醉红妆 ,张先,平平仄仄仄平平。仄平平，仄仄平。仄平平仄仄平平。平平仄，仄平平。平平平仄仄平平。仄平仄，仄平平。仄仄平平平仄仄，平仄仄，仄平平。,0,29,23,52,"[7, 3, 3, 7, 3, 3, 7, 3, 3, 7, 3, 3]"
思远人 ,晏几道,平仄平平平仄仄，平仄仄平仄。仄平平仄仄，平平平仄，平仄仄平仄。仄平仄仄平平仄。仄仄仄平仄。仄仄仄仄平，仄平平仄，平平仄平仄。,0,23,29,52,"[7, 5, 5, 4, 5, 7, 5, 5, 4, 5]"
醉花阴 ,毛滂,平仄仄平平仄仄。平仄平平仄。平仄仄平平，仄仄平平，平仄平平仄。仄平仄仄平平仄。平仄平平仄。平仄仄平平，仄仄平平，仄仄平平仄。,0,27,25,52,"[7, 5, 5, 4, 5, 7, 5, 5, 4, 5]"
望江东 ,黄庭坚,平仄平平仄平仄。仄仄仄、平平仄。平平仄仄仄平仄。仄仄仄、平平仄。平平仄仄平平仄。仄仄仄、平平仄。仄平平仄仄平仄。仄平仄、平平仄。,0,23,29,52,"[7, 3, 3, 7, 3, 3, 7, 3, 3, 7, 3, 3]"
入塞 ,程垓,仄平平。仄平平、仄仄平。仄平平仄仄，仄仄仄平平。平仄平。仄仄平。仄平平平仄仄平。仄仄平、平仄仄平。平平平仄仄平平。平仄平。仄仄平。,0,27,25,52,"[3, 3, 3, 5, 5, 3, 3, 7, 3, 4, 7, 3, 3]"
品令 ,曹组,仄仄仄。平平仄、仄仄平平平仄。平平仄、仄仄平平仄，仄仄仄、仄仄仄。仄仄平平仄仄，仄仄平平平仄。仄仄平、平仄平仄仄，仄平平、仄仄仄。,0,19,33,52,"[3, 3, 6, 3, 5, 3, 3, 6, 6, 3, 5, 3, 3]"
品令 ,赵长卿,平平仄。平平仄，仄平仄仄平仄。仄平仄仄仄平平，平仄平、仄仄仄。仄仄平平平仄仄，仄仄平平平仄。仄平仄仄平平仄，平平仄、仄平仄。,0,23,28,51,"[3, 3, 6, 7, 3, 3, 7, 6, 7, 3, 3]"
品令 ,周邦彦,仄平平仄。仄平仄、平平平仄。平仄仄仄平平仄。仄平仄仄，平仄平平仄。平仄仄平平仄仄。仄平平平仄。仄平平仄平平仄。仄平平仄。平仄平平仄。,0,28,27,55,"[4, 3, 4, 7, 4, 5, 7, 5, 7, 4, 5]"
品令 ,陈允平,仄平平仄。平平仄、仄平平仄。平仄仄仄平平仄。仄平仄仄，平仄平平仄。平仄仄平平仄仄。仄平平平仄。仄平平仄平平仄。仄平平仄，平仄平平仄。,0,28,27,55,"[4, 3, 4, 7, 4, 5, 7, 5, 7, 4, 5]"
品令 ,王行,平平平仄。仄仄仄、平平仄仄。平平平仄平平仄。平平仄仄。仄仄平平仄。仄仄平平平仄仄。仄平平平仄。仄仄平平平仄仄。仄平平仄。平仄平平仄。,0,28,27,55,"[4, 3, 4, 7, 4, 5, 7, 5, 7, 4, 5]"
品令 ,无名氏,平平平仄。仄平仄、平平仄。仄平平仄，仄平平仄，平平仄仄。平仄平平，平仄仄平平仄。平平平仄。仄仄仄、平平仄。仄平平仄，仄平仄仄，平平仄仄。仄仄平平，仄仄仄平平仄。,0,32,32,64,"[4, 3, 3, 4, 4, 4, 4, 6, 4, 3, 3, 4, 4, 4, 4, 6]"
品令 ,周紫芝,平平平仄。仄仄仄、平平仄。仄平平仄，仄平平仄，仄平平仄。平仄平平平仄，仄平仄仄。平平平仄。仄仄仄、平平仄。平平仄仄，仄平平仄，仄平平仄。仄仄平平平仄，仄平平仄。,0,32,32,64,"[4, 3, 3, 4, 4, 4, 6, 4, 4, 3, 3, 4, 4, 4, 6, 4]"
品令 ,曾纡,平平仄仄。平仄平平仄。仄平平仄，仄平平仄，仄平平仄。仄仄平平，仄仄仄平仄仄。平平仄仄。仄平仄、平平仄。平平平仄，平仄平仄，平平平仄。平仄平平，平仄仄平平仄。,0,33,30,63,"[4, 5, 4, 4, 4, 4, 6, 4, 3, 3, 4, 4, 4, 4, 6]"
品令 ,卓田,仄平仄仄，仄仄仄、平平仄。平平仄仄，仄仄平平仄仄。仄仄平平，平仄仄平平仄。平平仄仄，仄平仄、平平仄。仄平仄仄，平仄平平仄仄。仄仄平平，平仄仄平平仄。,0,26,34,60,"[4, 3, 3, 4, 6, 4, 6, 4, 3, 3, 4, 6, 4, 6]"
品令 ,李清照,仄仄平平仄。平仄仄、平平仄。仄平仄仄，仄平仄仄、仄平平仄。仄仄平平仄仄，平平仄仄。平平仄仄。仄仄仄、平平仄。仄平平仄，仄仄仄仄、平平仄仄。仄仄平平，平仄仄平仄仄。,0,25,40,65,"[5, 3, 3, 4, 4, 4, 6, 4, 4, 3, 3, 4, 4, 4, 4, 6]"
品令 ,黄庭坚,仄仄平平仄。仄平仄、平平仄。平平仄仄，仄平仄仄，仄平平仄。平仄平平，仄仄仄仄平仄仄。仄平平仄。仄平仄、平平仄。仄平平仄，仄平仄仄，平平仄仄。仄仄平平，平仄仄仄仄仄。,0,27,39,66,"[5, 3, 3, 4, 4, 4, 4, 7, 4, 3, 3, 4, 4, 4, 4, 6]"
品令 ,黄庭坚,仄仄平平仄。仄仄仄、平平仄。平平平仄仄平，仄仄平平平仄。仄仄平平平仄，仄仄平仄。仄平仄仄。仄仄仄、仄平仄。仄平平仄仄平，仄仄平平平仄。仄仄平平平仄，仄平仄仄。,0,27,38,65,"[5, 3, 3, 6, 6, 6, 4, 4, 3, 3, 6, 6, 6, 4]"
引驾行 ,晁补之,平平平仄，平平仄仄平平仄。仄平平、仄平仄，平仄仄平平仄。平仄。仄仄仄、平平平平，仄仄仄平仄。仄平仄、平平仄仄，仄平平、仄平仄。仄仄。平平平仄，仄仄平平仄。仄仄仄、平平平平，仄仄仄平平仄。平仄。仄平平仄仄，平平平仄仄平仄。仄平仄、平平仄仄，仄平平仄。,0,48,51,99,"[4, 7, 3, 3, 6, 2, 3, 4, 5, 3, 4, 3, 3, 2, 4, 5, 3, 4, 6, 2, 5, 7, 3, 4, 4]"
引驾行 ,柳永,平平平仄，平平仄仄平平仄。仄平平、仄平仄，平平仄平平仄。平仄。仄仄仄平平，平平仄仄仄平仄。仄平仄、平平仄仄，仄平平、仄平仄。仄仄。平平仄仄，仄仄平平平仄。仄仄仄平平，平平仄仄，仄平平仄。平仄。仄平平仄仄，平平平仄仄平仄。仄仄仄、平平仄仄，仄平平仄。,0,48,52,100,"[4, 7, 3, 3, 6, 2, 5, 7, 3, 4, 3, 3, 2, 4, 6, 5, 4, 4, 2, 5, 7, 3, 4, 4]"
引驾行 ,晁补之,平平平仄，平平仄仄平平仄。仄平平、仄平仄平平，仄平平仄。平仄。仄仄仄平平，平平平仄仄平仄。仄仄仄、平平仄仄，仄平平、仄仄仄。平仄。平平仄仄，仄仄平平平仄。仄仄仄平平，平平仄仄，仄平平仄。仄仄。仄平平平仄，平平平仄仄平仄。仄仄仄、平平仄仄，仄平平仄。,0,48,52,100,"[4, 7, 3, 5, 4, 2, 5, 7, 3, 4, 3, 3, 2, 4, 6, 5, 4, 4, 2, 5, 7, 3, 4, 4]"
引驾行 ,柳永,平平仄仄，平平仄仄平平仄，仄平平、仄平仄，平平仄仄平平。平平。平平平仄，平平仄仄平仄仄，仄平平、仄仄仄，平平平仄平平。平平。平仄平平仄，仄平平仄仄平平。仄仄仄平平，仄仄仄、平仄平平。平平。平平仄仄，仄仄仄仄平平。仄仄平仄仄，平平仄仄，仄仄平平。平平。平仄平平仄，平平平仄仄平平。仄仄平、平仄仄仄，仄平仄平平。,0,68,57,125,"[4, 7, 3, 3, 6, 2, 4, 7, 3, 3, 6, 2, 5, 7, 5, 3, 4, 2, 4, 6, 5, 4, 4, 2, 5, 7, 3, 4, 5]"
玉团儿 ,周邦彦,平平仄仄平平仄。仄平仄、平平仄仄。仄仄平平，平平平仄，平仄平仄。平平仄仄平平仄。仄仄仄、平平仄仄。仄仄平平，仄平平仄，平仄仄仄。,0,25,27,52,"[7, 3, 4, 4, 4, 4, 7, 3, 4, 4, 4, 4]"
倾杯令 ,吕渭老,平仄平平，平平仄仄，仄仄仄平平仄。平仄平平平仄。平仄平平平仄。平平仄仄平平仄。仄平平、平平平仄。平平仄仄平仄，仄仄平平仄仄。,0,29,23,52,"[4, 4, 6, 6, 6, 7, 3, 4, 6, 6]"
锯解令 ,杨无咎,仄平平仄仄平平，仄仄仄、平平仄仄。平平仄仄仄平平，仄仄仄、仄平仄仄。仄平仄仄。仄仄平平仄仄。平平仄仄仄平平，仄仄仄、仄平仄仄。,0,19,33,52,"[7, 3, 4, 7, 3, 4, 4, 6, 7, 3, 4]"
双雁儿 ,杨无咎,平平仄仄仄平平。仄仄仄、仄平平。仄平平仄仄平平。仄平平、仄仄平。仄平平仄仄平平。仄仄仄、仄平平。仄平平仄仄平平。仄平平、仄仄平。,0,26,26,52,"[7, 3, 3, 7, 3, 3, 7, 3, 3, 7, 3, 3]"
寻芳草 ,辛弃疾,仄仄仄平仄。仄平仄、仄平平仄。仄平平、仄仄平仄仄。仄平平、仄平仄。仄仄仄平平，仄平仄、仄平平仄。仄平平、仄仄平平仄。平仄仄、平平仄。,0,22,30,52,"[5, 3, 4, 3, 5, 3, 3, 5, 3, 4, 3, 5, 3, 3]"
恨来迟 ,王灼,仄仄平平，仄平平仄，仄仄平平。仄仄仄平平，仄平平仄，仄仄平平。仄仄平、仄仄仄平平。仄平平仄平平。仄仄仄平平，平平仄仄，平仄平平。,0,26,26,52,"[4, 4, 4, 5, 4, 4, 3, 5, 6, 5, 4, 4]"
恨来迟 ,无名氏,仄仄平平，仄仄平平，仄仄平平。仄仄仄、平平仄平平仄，仄仄平平。仄仄仄、平仄仄平平。仄仄仄、平仄平平。仄仄仄、平平仄平平仄，仄仄平平。,0,24,29,53,"[4, 4, 4, 3, 6, 4, 3, 5, 3, 4, 3, 6, 4]"
珍珠令 ,张炎,平平仄仄平平仄。平平仄。仄仄仄、平平平仄。平仄仄平平，仄平平仄仄。仄仄平平平仄仄。仄平仄、仄平平仄。平仄。仄仄仄平平，平平平仄。,0,26,26,52,"[7, 3, 3, 4, 5, 5, 7, 3, 4, 2, 5, 4]"
寿延长破字令 ,无名氏,平平仄仄平平仄。仄平平仄仄。仄仄平平平平仄。仄平平、平平仄仄。仄仄平平平平仄。仄平平仄仄。平仄仄仄平平仄。仄仄平、仄平仄仄。,0,25,27,52,"[7, 5, 7, 3, 4, 7, 5, 7, 3, 4]"
献天寿令 ,无名氏,仄仄平平平仄，平平仄仄平平。平平平仄仄平平。平仄平仄平平。仄仄平平平平仄，平仄仄、仄仄仄平。平平平仄仄平平。平仄仄仄平平。,0,30,22,52,"[6, 6, 7, 6, 7, 3, 4, 7, 6]"
折花令 ,无名氏,仄仄平平，平平仄仄平平仄。仄仄仄、平平仄。平仄仄平平，仄平平仄。仄仄平仄，平平仄仄平平仄。平仄仄、平平仄。仄仄仄平平，平平仄仄。,0,25,27,52,"[4, 7, 3, 3, 5, 4, 4, 7, 3, 3, 5, 4]"
红窗听 ,晏殊,仄仄平平平仄仄。平仄仄、仄平平仄。平平平仄平平仄，仄平平平仄。仄仄平平平仄仄。平平仄、平平仄仄，平平仄仄。仄平平仄，仄平平平仄。,0,28,25,53,"[7, 3, 4, 7, 5, 7, 3, 4, 4, 4, 5]"
上林春令 ,毛滂,平仄平平平仄。仄仄仄、平平仄仄。仄平平仄平平，平仄仄、仄平仄仄。平平仄仄仄仄仄。仄仄仄、仄平平仄。仄平仄仄平平，仄平平、仄平平仄。,0,23,30,53,"[6, 3, 4, 6, 3, 4, 7, 3, 4, 6, 3, 4]"
红窗迥 ,周邦彦,平仄平，平仄仄。仄平仄仄平，仄平仄仄。平仄仄平平仄。仄平平仄仄。仄仄平平平仄仄，仄仄平仄仄，平平仄仄。平仄仄平平仄。仄仄平仄仄。,0,21,32,53,"[3, 3, 5, 4, 6, 5, 7, 5, 4, 6, 5]"
红窗迥 ,欧良,平仄仄。仄仄仄。仄仄仄平仄，仄平平仄。平仄仄平仄仄。仄仄平仄仄。平仄仄平平仄仄。仄仄平、仄仄平仄平仄。仄仄平平平仄。仄仄平仄仄。,0,17,36,53,"[3, 3, 5, 4, 6, 5, 7, 3, 6, 6, 5]"
红罗袄 ,周邦彦,仄仄平平仄，平仄仄平平。仄仄仄平平，平平平仄，仄平平仄，平仄平平。仄平仄、平仄平平。平平仄仄平平。仄仄仄平平。仄仄仄、仄仄仄平平。,0,27,26,53,"[5, 5, 5, 4, 4, 4, 3, 4, 6, 5, 3, 5]"
折桂令 ,倪瓒,仄平平、仄仄平平。平仄平平，仄仄平平。仄仄平平，平平仄仄，平仄平平。仄平仄、平平仄仄。仄平平、仄仄平平。平仄平平。平仄平平，平仄平平。,0,32,21,53,"[3, 4, 4, 4, 4, 4, 4, 3, 4, 3, 4, 4, 4, 4]"
折桂令 ,张可久,平平仄仄平平。平仄平平，仄仄平平。仄仄平平，平平仄仄，仄仄平平。平仄平平仄平。仄平平仄平平。平仄平平，平仄平平，仄仄平平。,0,31,19,50,"[6, 4, 4, 4, 4, 4, 6, 6, 4, 4, 4]"
折桂令 ,张可久,仄平平、仄仄仄平。仄仄平平，仄仄平平。仄仄平平，平平仄仄，仄仄平平。仄仄平，平仄平，平平仄仄。仄平平，平平仄，平仄平平。仄仄平平。平仄平平。仄仄平平，平仄平平。,0,35,28,63,"[3, 4, 4, 4, 4, 4, 4, 3, 3, 4, 3, 3, 4, 4, 4, 4, 4]"
折桂令 ,白无咎,仄平平仄仄平平，平平仄仄平平。平仄平平，仄仄仄平平。仄平平、平平仄仄，平仄平平。平仄仄仄，仄仄平平。平平仄平，仄平平仄仄，仄仄平平。仄仄平平，仄仄平、平仄平平仄平。仄平平仄，仄平平、仄平平仄平平。仄平仄仄，平仄平平。仄仄平平平仄，平平仄仄平平。,0,56,44,100,"[7, 6, 4, 5, 3, 4, 4, 4, 4, 4, 5, 4, 4, 3, 6, 4, 3, 6, 4, 4, 6, 6]"
荔子丹 ,无名氏,仄仄平平仄仄平。平仄仄平平。仄平平仄仄平仄，平平仄、仄仄仄平平。平平仄仄仄平平。仄仄仄平平。仄仄平平平仄仄，仄平平、仄仄平平。,0,26,27,53,"[7, 5, 7, 3, 5, 7, 5, 7, 3, 4]"
临江仙 ,和凝,仄平平仄平平仄，仄平仄仄平平。仄平平仄仄平平。仄平平仄仄平平。仄仄平平平仄仄，仄平平仄平平。平平平仄仄平平。仄平平仄仄平平。,0,31,23,54,"[7, 6, 7, 7, 7, 6, 7, 7]"
临江仙 ,张泌,平平平仄平平仄，平平仄仄平平。仄平平仄仄平平。仄平平仄，平仄仄平平。仄仄仄平平仄仄，平平仄仄平平。平平仄仄仄平平。仄平平仄，平仄仄平平。,0,33,25,58,"[7, 6, 7, 4, 5, 7, 6, 7, 4, 5]"
临江仙 ,牛希济,仄仄平平仄仄平。平平仄仄平平。平平仄仄仄平平。仄平平仄，平仄仄平平。平仄仄平平仄仄，平平平仄平平。仄平平仄仄平平。平平平仄，仄仄仄平平。,0,33,25,58,"[7, 6, 7, 4, 5, 7, 6, 7, 4, 5]"
临江仙 ,（南唐）李煜,平平仄仄平平仄，仄平仄仄平平。平平仄仄仄平平。仄平平仄，平仄仄平平。平平仄仄平平仄，平平仄仄平平。平平仄仄仄平平。仄平平仄，平仄仄平平。,0,33,25,58,"[7, 6, 7, 4, 5, 7, 6, 7, 4, 5]"
临江仙 ,顾夐,仄仄平平平仄仄，仄平平仄平平。仄平平仄仄平平。仄平平仄，平仄仄，仄平平。仄仄仄平平仄仄，平平平仄平平。仄平平仄仄平平。平平平仄，平仄仄，仄平平。,0,33,27,60,"[7, 6, 7, 4, 3, 3, 7, 6, 7, 4, 3, 3]"
临江仙 ,徐昌图,仄仄平平平仄，平平平仄平平。平平平仄仄平平。仄平平仄仄，平仄仄平平。平仄仄平平仄，平平平仄平平。仄平平仄仄平平。平平平仄仄，平仄仄平平。,0,36,22,58,"[6, 6, 7, 5, 5, 6, 6, 7, 5, 5]"
临江仙 ,向子諲,平仄平平平仄，仄平仄仄平平。平平平仄仄平平。平平仄仄，仄仄仄平平。仄仄仄平平仄，平平仄仄平平。平平平仄仄平平。仄平平仄，仄仄仄平平。,0,31,25,56,"[6, 6, 7, 4, 5, 6, 6, 7, 4, 5]"
临江仙 ,贺铸,仄仄仄平平仄仄，平平平仄平平。仄平仄仄仄平平。仄平平仄仄，平仄仄平平。仄仄平仄平仄仄，平平平仄平平。仄平仄仄仄平平。平平仄仄仄，仄仄仄平平。,0,29,31,60,"[7, 6, 7, 5, 5, 7, 6, 7, 5, 5]"
临江仙 ,晏几道,平仄平平平仄仄，平平仄仄仄平平。平平仄仄仄平平。仄平平仄仄，平仄仄平平。仄仄平平平仄仄，平平平仄仄平平。仄平平仄仄平平。平平平仄仄，仄仄仄平平。,0,34,28,62,"[7, 7, 7, 5, 5, 7, 7, 7, 5, 5]"
临江仙 ,冯延巳,仄平平仄平平仄，平平仄仄平平。仄平平仄仄平平。仄平平仄仄，仄仄仄平平。仄平平仄平平仄，平平平仄平平。平平平仄仄平平。仄平平仄，平仄仄平平。,0,35,24,59,"[7, 6, 7, 5, 5, 7, 6, 7, 4, 5]"
临江仙 ,王观,仄仄平平平仄仄，平平仄仄平平。仄平平仄仄平平。仄平平仄仄，平仄仄平平。仄仄平平平仄仄，仄平平仄平平。平平仄仄仄平平。仄平平仄，平仄仄平平。,0,32,27,59,"[7, 6, 7, 5, 5, 7, 6, 7, 4, 5]"
浪淘沙令 ,（南唐）李煜,平仄仄平平。平仄平平。平平仄仄仄平平。仄仄仄平平仄仄，仄仄平平。仄仄仄平平。平仄平平。仄平平仄仄平平。平仄仄平平仄仄，平仄平平。,0,29,25,54,"[5, 4, 7, 7, 4, 5, 4, 7, 7, 4]"
浪淘沙令 ,杜安世,仄仄平平。仄仄平平。平平仄仄仄平平。仄仄平平平仄仄，平仄平平。平仄仄平平。平仄平平。平平平仄仄平平。仄仄仄平平仄仄，平仄平平。,0,30,23,53,"[4, 4, 7, 7, 4, 5, 4, 7, 7, 4]"
浪淘沙令 ,杜安世,平仄平平。平仄平平。平平仄仄仄平平。仄仄平平，平仄平仄，仄仄平平。仄仄仄平平。仄仄平平。仄平平仄仄平平。平仄仄平平仄仄，仄仄仄平平。,0,29,26,55,"[4, 4, 7, 4, 4, 4, 5, 4, 7, 7, 5]"
浪淘沙令 ,柳永,仄仄平平。平仄平平。仄平平仄仄平平。仄仄仄平平仄仄，平仄平平。仄仄平平。仄仄平平。仄平仄仄仄平平。平仄仄平平仄仄，平仄平平。,0,27,25,52,"[4, 4, 7, 7, 4, 4, 4, 7, 7, 4]"
浪淘沙令 ,宋祁,仄平仄仄。平平平仄。平平仄仄平平仄。仄平平、仄仄仄仄平仄仄仄。平平仄仄平平仄。仄平平仄。仄平平仄平平仄。仄平平、仄仄仄平仄平仄。,0,25,29,54,"[4, 4, 7, 3, 8, 7, 4, 7, 3, 7]"
浪淘沙令 ,杜安世,仄仄平仄。仄平平仄。仄平平仄仄平平，平平平仄，平平仄仄，仄平平仄。仄仄平平仄。仄平平仄。仄平平仄仄平平，平平平仄平平仄。仄平仄平仄。,0,29,26,55,"[4, 4, 7, 4, 4, 4, 5, 4, 7, 7, 5]"
金错刀 ,冯延巳,平仄仄，仄平平。平平平仄仄平平。平平仄仄平平仄，平仄平平仄仄平。平仄仄，仄平平。平平平仄仄平平。仄平仄仄平平仄，平仄平平仄仄平。,0,31,23,54,"[3, 3, 7, 7, 7, 3, 3, 7, 7, 7]"
金错刀 ,冯延巳,仄平平，仄平平。平平平仄平平平。仄平仄仄平平仄。平仄平平仄仄平。平仄仄，仄平平。平平仄仄平平平。平平平仄平平仄。仄仄平平仄仄平。,0,33,21,54,"[3, 3, 7, 7, 7, 3, 3, 7, 7, 7]"
金错刀 ,叶李,平平仄。平平仄。平仄平平平仄仄。平平平仄仄平平，仄仄平平平仄仄。平平仄。平平仄。平平仄仄平平仄。仄平仄仄仄平平，平仄仄平平仄仄。,0,30,24,54,"[3, 3, 7, 7, 7, 3, 3, 7, 7, 7]"
端正好 ,杜安世,仄仄平平平平仄。平平仄、平仄平仄。仄平平仄仄平仄。仄仄平、平平仄。仄平平平平平仄。平平仄、平平平仄。平平仄仄仄平仄。仄仄平、平平仄。,0,30,24,54,"[7, 3, 4, 7, 3, 3, 7, 3, 4, 7, 3, 3]"
端正好 ,杨无咎,平平仄仄平平仄。仄平仄、仄平平仄。仄平仄仄平平仄。仄平仄、平平仄。平平仄仄平平仄。仄平仄、仄平平仄。平平平仄平平仄。仄仄仄、平平仄。,0,27,27,54,"[7, 3, 4, 7, 3, 3, 7, 3, 4, 7, 3, 3]"
杏花天 ,朱敦儒,仄平平仄平平仄。仄仄仄、平平平仄。平平仄仄平平仄。平仄仄平仄仄。平仄仄、仄平仄仄。仄仄仄、平平平仄。仄平仄仄平平仄。平仄平平仄仄。,0,24,30,54,"[7, 3, 4, 7, 6, 3, 4, 3, 4, 7, 6]"
杏花天 ,侯寘,仄平仄仄平平仄。仄平仄、平平平仄。仄平仄仄平平仄。仄仄仄、平平平仄。仄平仄仄平平仄。仄仄仄、平平平仄。平平仄仄平平仄。仄仄平平仄仄。,0,25,30,55,"[7, 3, 4, 7, 3, 4, 7, 3, 4, 7, 6]"
杏花天 ,卢炳,仄平仄仄平平仄。仄仄仄、平平仄仄。仄平平仄平平仄。仄仄仄、平平仄仄。仄仄仄、平平仄仄。仄平仄、平平仄仄。平平平仄平平仄。仄平仄、平平仄仄。,0,24,32,56,"[7, 3, 4, 7, 3, 4, 3, 4, 3, 4, 7, 3, 4]"
天下乐 ,杨无咎,仄仄仄平仄仄仄。仄仄仄、平仄仄。平平平平仄仄仄。平平仄、仄平平仄。仄仄仄、平平仄仄仄。仄仄仄、平平仄。仄平仄仄平仄仄。仄平平、平仄仄。,0,19,35,54,"[7, 3, 3, 7, 3, 4, 3, 5, 3, 3, 7, 3, 3]"
恋绣衾 ,朱敦儒,仄仄平平仄仄平。仄平平、平仄仄平。仄仄仄、平平仄，仄平平、平仄仄平。仄平仄仄平平仄，仄平平、平仄仄平。仄仄仄、平平仄，仄平平、仄仄仄平。,0,25,29,54,"[7, 3, 4, 3, 3, 3, 4, 7, 3, 4, 3, 3, 3, 4]"
恋绣衾 ,周密,仄平平仄平仄平。仄平平、平仄仄平。仄仄仄平平仄，仄仄平、平仄仄平。平平仄仄平平仄，仄平平、平仄仄平。平仄仄平平仄，仄平平、平仄仄平。,0,28,26,54,"[7, 3, 4, 6, 3, 4, 7, 3, 4, 6, 3, 4]"
恋绣衾 ,辛弃疾,平仄平仄平仄平。仄平平、平仄仄平。仄仄仄、仄仄平仄，仄平平、平仄仄平。平平仄仄平平仄，仄仄仄、仄仄仄平。仄仄仄、平平仄，仄平仄、平仄仄平。,0,23,32,55,"[7, 3, 4, 3, 4, 3, 4, 7, 3, 4, 3, 3, 3, 4]"
恋绣衾 ,韩淲,平平仄仄仄仄平。仄平平、平仄仄平。仄仄仄、平平仄，仄平平、平仄仄平。平平仄仄平平仄，仄平平仄、仄仄仄平。仄仄仄、平平仄，仄仄平平仄仄平。,0,25,30,55,"[7, 3, 4, 3, 3, 3, 4, 7, 4, 4, 3, 3, 7]"
恋绣衾 ,赵汝茪,仄平平仄仄平平。仄仄仄、平平仄平。仄平平、仄仄平仄，仄平平、平仄仄平。仄平平仄平平仄，仄平平、平仄仄平。仄仄平、平平平仄，仄平平、平仄仄平。,0,30,26,56,"[7, 3, 4, 3, 4, 3, 4, 7, 3, 4, 3, 4, 3, 4]"
钗头凤 ,无名氏,平平仄。仄平仄。仄平平仄平平仄。平平仄。平平仄。仄仄平平，仄平平仄。平平仄。平平仄。仄平平仄平平仄。平平仄。仄平仄。仄平平仄，仄平平仄。,0,30,24,54,"[3, 3, 7, 3, 3, 4, 4, 3, 3, 7, 3, 3, 4, 4]"
钗头凤 ,史达祖,平平仄。平仄仄。仄平仄仄平平仄。平平仄。平平仄。仄仄平平，仄平平仄。仄。仄。平平仄。平平仄。仄平仄仄平平仄。平平仄。平平仄。仄仄平平，仄平平仄。仄。仄。,0,29,29,58,"[3, 3, 7, 3, 3, 4, 4, 1, 1, 3, 3, 7, 3, 3, 4, 4, 1, 1]"
钗头凤 ,吕渭老,平平仄。平平仄。仄平平仄平平仄。仄平平。仄平平。仄仄平平，平仄平平。平。平。平平仄。平平仄。仄平仄仄平平仄。仄平平。仄平平。仄仄平平，平仄平平。平。平。,0,37,21,58,"[3, 3, 7, 3, 3, 4, 4, 1, 1, 3, 3, 7, 3, 3, 4, 4, 1, 1]"
钗头凤 ,程垓,平平仄。平平仄。仄平平仄平平仄。平仄仄。平平仄。仄仄平平，仄平平仄。仄。仄。仄。平平仄。平平仄。仄平平仄平平仄。平平仄。仄平仄。平仄平平，仄平平仄。仄。仄。仄。,0,31,29,60,"[3, 3, 7, 3, 3, 4, 4, 1, 1, 1, 3, 3, 7, 3, 3, 4, 4, 1, 1, 1]"
钗头凤 ,宋媛唐氏,仄平仄。平平仄。仄仄平平平仄仄。仄平平。仄平平。仄平平仄，仄仄平平。平。平。平。平平仄。平平仄。仄平平仄平平仄。仄平平。仄平平。仄平平仄，仄仄平平。平。平。平。,0,36,24,60,"[3, 3, 7, 3, 3, 4, 4, 1, 1, 1, 3, 3, 7, 3, 3, 4, 4, 1, 1, 1]"
鬓边华 ,无名氏,仄平平仄仄仄。平仄仄、平平仄仄。仄平平、平仄平平，仄平仄、平平仄仄。平平平仄平平，仄仄仄、平平仄仄。仄平仄、平仄平平，仄平仄、平平仄仄。,0,27,27,54,"[6, 3, 4, 3, 4, 3, 4, 6, 3, 4, 3, 4, 3, 4]"
玉楼人 ,无名氏,仄平平仄平平仄。平仄仄、平平仄仄。平平平仄平平，仄平平、平仄仄仄。平平仄仄平平仄。仄仄平、仄仄平仄。仄平仄仄平平，仄平平、仄仄平仄。,0,27,27,54,"[7, 3, 4, 6, 3, 4, 7, 3, 4, 6, 3, 4]"
江月晃重山 ,陆游,平仄平平仄仄，仄平平仄平平。仄平平仄仄平平。平平仄，平仄仄平平。仄仄平平仄仄，平平平仄平平。平平平仄仄平平。平平仄，仄仄仄平平。,0,32,22,54,"[6, 6, 7, 3, 5, 6, 6, 7, 3, 5]"
南乡一剪梅 ,虞集,平仄仄平平。仄仄平平仄仄平。仄仄平平平仄仄，平仄平平。仄仄平平。平仄仄平平。仄仄平平仄仄平。仄仄平平平仄仄，平仄平平。平仄平平。,0,29,25,54,"[5, 7, 7, 4, 4, 5, 7, 7, 4, 4]"
鹦鹉曲 ,白无咎,平平平仄平平仄。仄仄仄仄仄平仄。仄平平、仄仄平平，仄仄平平平仄。仄平平、仄仄平平，仄仄仄平平仄。仄平平、仄仄平平，仄仄仄、平平仄仄。,0,25,29,54,"[7, 7, 3, 4, 6, 3, 4, 6, 3, 4, 3, 4]"
一七令 ,白居易,平。仄仄，平平。平仄仄，仄平平。平仄平仄，仄平仄平。仄平平仄仄，平仄仄平平。平仄仄平仄仄，仄平平仄平平。仄平平仄仄平仄，仄仄平平仄仄平。,0,27,28,55,"[1, 2, 2, 3, 3, 4, 4, 5, 5, 6, 6, 7, 7]"
一七令 ,韦式,仄。平平，仄仄。仄仄仄，平平仄。仄仄平仄，平平仄仄。仄仄仄平平，平平平仄仄。平仄仄平平仄，仄仄平平仄仄。平平平仄仄平平，平仄仄平仄仄仄。,0,24,31,55,"[1, 2, 2, 3, 3, 4, 4, 5, 5, 6, 6, 7, 7]"
一七令 ,张南史,平。平。平仄，平平。平平仄，仄平平。平平仄仄，仄仄平平。仄平平仄仄，平仄仄平平。平仄仄平平仄，平平仄仄平平。仄仄平平平仄仄，仄平仄仄仄平平。,0,31,25,56,"[1, 1, 2, 2, 3, 3, 4, 4, 5, 5, 6, 6, 7, 7]"
一七令 ,张南史,仄。仄。仄平，平仄。仄平平，平仄仄。仄仄平仄，平平仄仄。平平仄仄平，平仄平平仄。平平仄仄平仄，平仄平平仄仄。仄平仄仄仄平平，平仄仄平平仄仄。,0,26,30,56,"[1, 1, 2, 2, 3, 3, 4, 4, 5, 5, 6, 6, 7, 7]"
河传 ,温庭筠,平仄。平仄。仄平平。平仄平平仄平。仄平仄平平仄平。平平。仄平平仄平。仄仄平平平仄仄。平仄仄。平仄平平仄。仄平平。平仄平。仄平。仄平平仄平。,0,32,23,55,"[2, 2, 3, 6, 7, 2, 5, 7, 3, 5, 3, 3, 2, 5]"
河传 ,孙光宪,平仄。平仄。仄平平仄。仄仄平平。仄平平仄仄平平。平平。平平平仄平。仄平平仄平平仄。平平仄。平仄平平仄。仄平平。平仄平。平平。仄平平仄平。,0,34,20,54,"[2, 2, 4, 4, 7, 2, 5, 7, 3, 5, 3, 3, 2, 5]"
河传 ,顾夐,仄仄。平仄。平平仄仄，仄平平仄。仄平平仄仄平平。仄平。仄平平仄平。平平平仄平平仄。平平仄。仄仄仄平仄。仄平平。仄平平。平平。仄平平仄平。,0,30,24,54,"[2, 2, 4, 4, 7, 2, 5, 7, 3, 5, 3, 3, 2, 5]"
河传 ,辛弃疾,平仄。平仄。平平仄仄。仄平平仄。仄平平仄仄平平。仄平。仄平平仄平。仄平仄仄平平仄。仄平仄。仄仄平平仄。仄平平。仄仄平。仄平。仄平平仄平。,0,27,27,54,"[2, 2, 4, 4, 7, 2, 5, 7, 3, 5, 3, 3, 2, 5]"
河传 ,张泌,平仄。平仄。平平平仄。仄仄平平。仄平平仄仄平平。平平。仄平平。平平仄仄平平仄。仄平仄。仄仄平平仄。平平平仄仄平平。平平。平平仄仄平。,0,32,21,53,"[2, 2, 4, 4, 7, 2, 3, 7, 3, 5, 7, 2, 5]"
河传 ,阎选,平仄。平仄。平仄平仄，仄仄平平。仄平平仄仄平平。平平。仄平平。平平仄仄平平仄。平仄仄。仄仄平平仄。仄平平仄仄平平。平平。仄平平仄平。,0,30,23,53,"[2, 2, 4, 4, 7, 2, 3, 7, 3, 5, 7, 2, 5]"
河传 ,韦庄,仄仄。平仄。仄平平仄。平仄平平。平平仄仄，平仄仄仄平平。仄平平。仄平平仄平平仄。平平仄。仄仄平平仄。平平仄仄，平仄仄仄平平。仄平平。,0,28,25,53,"[2, 2, 4, 4, 4, 6, 3, 7, 3, 5, 4, 6, 3]"
河传 ,张先,仄仄，平仄。仄平平仄。平仄平平。仄平平仄，平仄仄仄平平。仄平平。平平仄仄平平仄。平平仄。仄仄平平仄。平平仄仄，平仄仄仄平平。仄平平。,0,28,25,53,"[2, 2, 4, 4, 4, 6, 3, 7, 3, 5, 4, 6, 3]"
河传 ,李清照,仄仄，平仄。平平平仄。仄仄平平。仄平仄仄。平仄仄仄平平。仄平平。平平仄仄平平仄。平平仄。仄仄平仄仄。平平仄仄，平仄仄仄平平。仄平平。,0,26,27,53,"[2, 2, 4, 4, 4, 6, 3, 7, 3, 5, 4, 6, 3]"
河传 ,张元干,仄仄，平仄。平平平仄。仄仄平平，仄平仄仄。平仄仄仄平平。仄平平。平平仄仄平平仄。平平仄。仄仄平平仄。平平仄仄，仄仄平仄平平。仄平平。,0,27,26,53,"[2, 2, 4, 4, 4, 6, 3, 7, 3, 5, 4, 6, 3]"
河传 ,陆游,仄仄平仄。仄平平仄。仄仄平平，仄平仄仄。平仄平仄平平。仄平平。平平仄仄平平仄。仄平仄仄。仄仄平平仄。平平仄仄，平仄仄仄平平。仄平平。,0,26,28,54,"[4, 4, 4, 4, 6, 3, 7, 4, 5, 4, 6, 3]"
河传 ,陆游,仄仄，平仄，平平平仄。仄仄平平，仄平仄仄。平仄仄仄平平。仄平平。平平平仄平平仄。仄平仄仄。仄仄平平仄。平平仄仄平仄，仄仄平平。仄平平。,0,27,27,54,"[2, 2, 4, 4, 4, 6, 3, 7, 4, 5, 6, 4, 3]"
河传 ,黄昇,仄仄。平仄。平平平仄。仄仄平平，平平仄仄。平仄平仄平平。仄平平。平平仄仄平平仄。仄平仄仄。仄仄平平仄。仄平平仄平仄，平仄平平。仄平平。,0,29,25,54,"[2, 2, 4, 4, 4, 6, 3, 7, 4, 5, 6, 4, 3]"
河传 ,李珣,平仄。平仄。仄平平仄。平仄平平。仄平平仄。平仄仄仄平平。仄平平仄平。平平仄仄平平仄。平仄仄。仄仄平平仄。仄平平仄，平仄仄仄平平。仄平平。,0,29,26,55,"[2, 2, 4, 4, 4, 6, 5, 7, 3, 5, 4, 6, 3]"
河传 ,李珣,仄仄。平仄。平平平仄。平仄平平。平平仄仄。平仄仄仄平平。平平仄仄平。平平仄仄平平仄。平平仄。仄仄平平仄。仄平平平仄，仄平仄平平。仄平平。,0,31,24,55,"[2, 2, 4, 4, 4, 6, 5, 7, 3, 5, 5, 5, 3]"
河传 ,孙光宪,平仄。平仄。平平仄仄。平平仄仄。仄平平仄，平仄平平仄仄。仄平平仄仄。仄平平仄平平仄。平平仄。仄仄平平仄。平仄平。平仄平。平平。仄平平仄平。,0,30,25,55,"[2, 2, 4, 4, 4, 6, 5, 7, 3, 5, 3, 3, 2, 5]"
河传 ,顾夐,仄仄。平仄。仄平平仄，仄平平仄。仄平平，仄平平，平仄。仄平平仄仄。仄仄平平仄平仄。平平仄。仄仄平平仄。仄平平。仄平平。仄平。仄平平仄平。,0,27,26,53,"[2, 2, 4, 4, 3, 3, 2, 5, 7, 3, 5, 3, 3, 2, 5]"
河传 ,顾夐,仄仄，平仄。仄平平仄，平平平仄。平平仄仄仄平平，平仄。仄平平仄仄。仄平平仄平平仄。平平仄。平仄平平仄。仄平平。平仄平。平平。仄平平仄平。,0,31,23,54,"[2, 2, 4, 4, 7, 2, 5, 7, 3, 5, 3, 3, 2, 5]"
河传 ,孙光宪,仄平平仄。仄平平仄。平平平仄。仄平平，平仄仄平平仄。平平平仄仄。平平仄仄平平仄。平平仄。平仄平平仄。仄平平。平仄平。平平。平平仄仄平。,0,33,21,54,"[4, 4, 4, 3, 6, 5, 7, 3, 5, 3, 3, 2, 5]"
河传 ,孙光宪,仄平平仄。仄平平仄。平平仄仄。仄平平仄仄仄。仄仄。平平平仄仄。平平仄仄平平仄。平平仄。平仄平平仄。仄平平。仄仄平。平平。平平平仄平。,0,29,24,53,"[4, 4, 4, 6, 2, 5, 7, 3, 5, 3, 3, 2, 5]"
河传 ,张泌,仄仄，平仄。平仄仄平，仄平平仄。仄平平仄，平仄仄仄。仄平平仄仄。仄平仄仄平平仄。平平仄。平仄平仄仄。仄平平仄平仄。仄平平仄仄。,0,22,29,51,"[2, 2, 4, 4, 4, 4, 5, 7, 3, 5, 6, 5]"
河传 ,柳永,平仄。仄仄。平平仄仄，平平平仄。平平仄仄，仄仄平平平仄。平平平仄仄。仄平仄仄平平仄。平平仄。仄仄平平仄。仄仄仄平，仄仄平平平仄。仄平平仄仄。,0,27,30,57,"[2, 2, 4, 4, 4, 6, 5, 7, 3, 5, 4, 6, 5]"
河传 ,柳永,仄平平仄。平平仄仄，平平平仄。平平仄仄，仄仄仄平平仄。平平平仄仄。仄平仄仄平平仄。平平仄。仄仄平平仄。仄仄仄平平仄，平平平仄。平平平仄仄。,0,29,28,57,"[4, 4, 4, 4, 6, 5, 7, 3, 5, 6, 4, 5]"
河传 ,徐昌图,平平仄仄。平平仄仄，平平仄仄。平仄仄平，仄平仄仄平平，仄平平、平仄仄。仄平仄仄平平仄。平平仄仄，仄仄平平仄。平仄仄平，仄平平仄平平，仄平平、平仄仄。,0,30,30,60,"[4, 4, 4, 4, 6, 3, 3, 7, 4, 5, 4, 6, 3, 3]"
河传 ,吕渭老,平平仄仄。仄平平仄仄。平平平仄。仄仄仄平，仄仄仄平平仄。仄仄平、平仄仄。平平仄仄平平仄。仄仄平平，仄仄平平仄。平仄仄平，仄仄平平平仄。仄平平、仄仄仄。,0,27,34,61,"[4, 5, 4, 4, 6, 3, 3, 7, 4, 5, 4, 6, 3, 3]"
河传 ,黄庭坚,平平仄仄。仄平仄仄，平仄平平仄。仄仄仄平，仄仄平平平仄，仄平仄、仄仄仄。平平仄仄平平仄。平仄平平，仄仄平平仄。仄仄平平，仄仄仄平平仄。仄仄平、平仄仄。,0,26,35,61,"[4, 4, 5, 4, 6, 3, 3, 7, 4, 5, 4, 6, 3, 3]"
河传 ,无名氏,平平仄仄。平仄仄、平平平仄。平仄仄平，仄平平平平仄。仄平平、平仄仄。仄平仄仄平平仄。仄仄平平，平仄平平仄。平仄仄仄，平仄平仄平平，仄平平、平仄仄。,0,31,28,59,"[4, 3, 4, 4, 6, 3, 3, 7, 4, 5, 4, 6, 3, 3]"
望远行 ,南唐李璟,仄仄平平仄仄平。平平平仄仄平平。平平仄仄仄平平。平平平仄仄平平。平平仄，仄平平。仄平平仄仄平平。平平平仄仄平平。平平平仄仄平平。,0,35,20,55,"[7, 7, 7, 7, 3, 3, 7, 7, 7]"
望远行 ,李珣,平仄平平仄仄平。平仄平平仄平。平平平仄仄平平。仄平平仄仄平平。平仄仄，仄平平。仄仄平平仄平。平平平仄仄平平。仄平平仄仄平平。,0,32,21,53,"[7, 6, 7, 7, 3, 3, 6, 7, 7]"
望远行 ,韦庄,仄仄平平仄仄平。平仄仄平平。仄平平仄仄平平。平仄仄平平。平仄仄，仄平平。仄平平仄平平。仄平平仄仄平平。平仄仄平仄平平。仄仄仄平仄，仄仄仄平平。,0,31,29,60,"[7, 5, 7, 5, 3, 3, 6, 7, 7, 5, 5]"
望远行 ,无名氏,平平平仄仄，仄仄仄平平。仄平平、平平仄仄仄平平。仄平平平仄，仄仄仄平仄平。仄仄仄平平平仄平。平平平仄仄，平仄仄平平。仄平平平仄，平仄仄平平。仄平平平仄，仄仄平平仄平。仄仄仄平平平仄平。,0,42,36,78,"[5, 5, 3, 7, 5, 6, 8, 5, 5, 5, 5, 5, 6, 8]"
望远行 ,柳永,仄平仄仄，平平仄、平仄平平平仄。仄仄平平，平平平仄，仄仄仄平仄仄。平仄平平，平平仄仄，仄仄仄平，平平仄仄。仄仄平、平仄平平仄平仄。平仄。平仄平平平仄。仄仄仄、平平仄仄。仄仄仄仄，平仄平平，平仄仄平平仄。仄平平仄平平，仄仄仄仄，仄仄平平平仄。仄平平平仄，仄平平仄。,0,51,56,107,"[4, 3, 6, 4, 4, 6, 4, 4, 4, 4, 3, 7, 2, 6, 3, 4, 4, 4, 6, 6, 4, 6, 5, 4]"
望远行 ,柳永,平平仄仄，平平仄、仄仄平平平仄。仄平平仄，仄仄平平，平仄仄平平仄。仄仄平平，平仄仄平平仄，平仄仄平平仄。仄平平、平仄平平仄仄。平仄。平仄仄平仄仄，仄仄仄、仄平平仄。仄仄仄平，仄平仄仄，平仄仄平平仄。平仄平平平仄，平平平仄，仄仄平平平仄。仄仄平平仄，平平平仄。,0,52,54,106,"[4, 3, 6, 4, 4, 6, 4, 6, 6, 3, 6, 2, 6, 3, 4, 4, 4, 6, 6, 4, 6, 5, 4]"
望远行 ,无名氏,平平仄仄，仄仄仄、平平平平平仄。仄平平仄，平仄平平，仄仄仄平平仄。仄仄平平，仄仄仄平平仄，仄仄平平仄仄。仄平平、平仄平平平仄。平仄。平仄仄平仄仄，仄仄平、平平仄仄。仄平仄仄，平平仄仄，仄仄仄平平仄。仄仄平平，平仄平平平仄，平仄平平仄仄。仄仄平、平仄平平平仄。,0,51,55,106,"[4, 3, 6, 4, 4, 6, 4, 6, 6, 3, 6, 2, 6, 3, 4, 4, 4, 6, 4, 6, 6, 3, 6]"
木兰花令 ,韦庄,仄仄仄平平仄仄。平仄仄平平仄仄。平仄仄，仄平平，仄仄仄平平仄仄。仄仄仄平平仄仄。平仄仄平平仄仄。平平仄仄仄平平，平仄仄平平仄仄。,0,22,33,55,"[7, 7, 3, 3, 7, 7, 7, 7, 7]"
木兰花令 ,毛熙震,仄平平，平仄仄。仄仄平平平仄仄。平仄仄，仄平平，仄仄仄平平仄仄。仄平平，平仄仄。平仄仄平平仄仄。平仄仄，仄平平，仄仄平平平仄仄。,0,23,29,52,"[3, 3, 7, 3, 3, 7, 3, 3, 7, 3, 3, 7]"
木兰花令 ,魏承班,仄平平，平仄仄。仄仄平平平仄仄。平仄仄，仄平平，仄平平仄平平仄。平平仄仄平平仄。仄仄平平平仄仄。平平平仄仄平平，仄平仄仄平平仄。,0,28,26,54,"[3, 3, 7, 3, 3, 7, 7, 7, 7, 7]"
金莲绕凤楼 ,宋徽宗,仄仄平平平平仄。平仄仄、平平平仄。仄平平仄平平仄。仄平平、仄平平仄。平平仄平仄仄。平仄仄、平平仄仄。仄平平仄平平仄。平平平、仄平平仄。,0,31,24,55,"[7, 3, 4, 7, 3, 4, 6, 3, 4, 7, 3, 4]"
睿恩新 ,晏殊,平平仄仄平平仄。平仄仄、平平平仄。仄平平、仄仄平平，仄平仄、仄平平仄。仄仄平平仄仄。平仄仄、仄平平仄。仄平平、仄仄平平，仄平仄、平平仄仄。,0,27,28,55,"[7, 3, 4, 3, 4, 3, 4, 6, 3, 4, 3, 4, 3, 4]"
芳草渡 ,欧阳修,平平仄，仄平平。平平仄，仄平平。平平平仄仄平平。平仄仄，平仄仄，仄平平。平平仄。平仄仄。仄仄平平仄仄。平平仄，仄平平。平平仄。平仄仄。仄平平。,0,31,24,55,"[3, 3, 3, 3, 7, 3, 3, 3, 3, 3, 6, 3, 3, 3, 3, 3]"
芳草渡 ,张先,仄平仄仄仄平平。平平仄，仄平平。平平平仄仄平平。平平仄，平平仄，仄平平。平仄仄，仄平平。仄平平仄平平。平平仄仄仄平平。平仄仄，平仄仄，仄平平。,0,33,24,57,"[7, 3, 3, 7, 3, 3, 3, 3, 3, 6, 7, 3, 3, 3]"
芳草渡 ,张先,平平仄仄仄平平。平仄仄，仄平平。平平仄仄仄平平。平平仄，平仄仄，仄平平。平平仄，仄平平。平仄仄，仄平平。仄平平仄仄平平。平平仄，仄平仄，仄平平。,0,32,25,57,"[7, 3, 3, 7, 3, 3, 3, 3, 3, 3, 3, 7, 3, 3, 3]"
芳草渡 ,周邦彦,仄仄仄，仄仄仄平平，仄平平仄。仄仄平平仄，平平仄仄平仄。平仄平仄仄。平平平平仄。仄仄仄，仄仄平平，仄仄平仄。平仄。仄平仄仄，仄仄平平平仄仄。仄平仄、平平仄仄，平平仄平仄。仄平仄仄，仄仄仄、平平平仄。仄仄仄，仄仄平平仄仄。,0,35,54,89,"[3, 5, 4, 5, 6, 5, 5, 3, 4, 4, 2, 4, 7, 3, 4, 5, 4, 3, 4, 3, 6]"
芳草渡 ,陈允平,平仄仄，仄平仄平平，平平仄仄。仄仄平平仄，平平仄仄平仄。仄仄平仄仄。平平平平仄。仄仄仄，仄仄平平，仄仄平仄。仄平仄仄，仄仄平平平仄仄。仄平仄、平平仄仄，平平仄平仄。仄平仄仄，仄仄仄、仄平平仄。仄仄仄，仄仄平平仄仄。,0,34,53,87,"[3, 5, 4, 5, 6, 5, 5, 3, 4, 4, 4, 7, 3, 4, 5, 4, 3, 4, 3, 6]"
夜行船 ,欧阳修,仄仄平平平仄。仄仄仄、仄平平仄。平平平仄仄平平，仄平平、仄平平仄。平仄平平平仄仄。平平仄、仄平平仄。仄仄平平平仄仄，仄平平、仄平平仄。,0,29,26,55,"[6, 3, 4, 7, 3, 4, 7, 3, 4, 7, 3, 4]"
夜行船 ,毛滂,平仄仄平平仄。仄平平、仄平平仄。仄平平仄仄平平，仄仄平、仄平仄仄。仄平仄、平平仄仄。平平仄、仄平仄仄。仄平平仄仄平平，仄平平、仄平仄仄。,0,26,29,55,"[6, 3, 4, 7, 3, 4, 3, 4, 3, 4, 7, 3, 4]"
夜行船 ,史达祖,仄仄平平平仄仄。仄平平、仄平平仄。仄仄平平，平平平仄，仄仄仄平平仄。仄仄平平平仄仄。仄平平、仄平平仄。仄仄平平，平平仄仄，平仄仄平平仄。,0,28,28,56,"[7, 3, 4, 4, 4, 6, 7, 3, 4, 4, 4, 6]"
夜行船 ,周密,平仄平平平仄仄。平平仄、仄平平仄。仄仄平平，仄平仄仄，平仄仄平平仄。平仄仄、平平平仄。平平仄、仄平平仄。仄仄平平，仄平平仄，平仄仄平平仄。,0,29,27,56,"[7, 3, 4, 4, 4, 6, 3, 4, 3, 4, 4, 4, 6]"
夜行船 ,赵长卿,仄仄平平平仄仄。仄平平、仄平平仄。仄仄平平，平平仄仄，平仄仄平平仄。仄仄仄平平仄仄。平平仄、仄平仄仄。平仄平平，平平仄仄。仄仄仄平平仄。,0,26,30,56,"[7, 3, 4, 4, 4, 6, 7, 3, 4, 4, 4, 6]"
夜行船 ,赵长卿,仄仄平平平仄仄。平平仄、仄平平仄。仄仄平平，平平平仄，平平仄、仄平平仄。仄仄平平平仄仄。仄平平、仄平平仄。仄仄平平，仄平平仄，仄平仄、仄平仄仄。,0,29,29,58,"[7, 3, 4, 4, 4, 3, 4, 7, 3, 4, 4, 4, 3, 4]"
夜行船 ,杨无咎,仄仄平平平仄仄。仄平平、仄平平仄。平仄平平，平平平仄，平仄仄平平仄。仄仄仄平平仄仄。仄平平、仄平平仄。仄仄平平，平平仄仄，仄平平、平平仄。,0,30,26,56,"[7, 3, 4, 4, 4, 6, 7, 3, 4, 4, 4, 3, 3]"
夜行船 ,王嵎,仄仄平平平仄仄。仄平平、仄平平仄。平仄平平，仄平平仄，平仄仄平平仄。仄仄平平平仄仄。仄平平、仄平平仄。仄仄平平，仄仄仄平平仄，平仄仄平平仄。,0,29,29,58,"[7, 3, 4, 4, 4, 6, 7, 3, 4, 4, 6, 6]"
夜行船 ,杨无咎,仄仄平平平仄。仄平平、仄平平仄。平仄平平，平平平仄，平仄仄平平仄。平仄平平平仄仄。仄平平、仄平平仄。仄仄平平，平平平仄，平仄仄平平仄。,0,32,23,55,"[6, 3, 4, 4, 4, 6, 7, 3, 4, 4, 4, 6]"
夜行船 ,孙浩然,平仄仄平平仄。仄平平、平平平仄。仄平平仄仄平平，仄平平、仄平平仄。仄仄平平平仄仄。平平仄、仄平平仄。平仄平平，平平平仄。平平仄平平仄。,0,33,22,55,"[6, 3, 4, 7, 3, 4, 7, 3, 4, 4, 4, 6]"
夜行船 ,杨无咎,仄仄仄平平仄。仄平平、仄平平仄。平仄平平，仄平平仄，平仄仄平平仄。平仄平平，仄平仄仄。仄平平、仄平平仄。仄仄平平仄平仄，仄平平、仄平平仄。,0,29,27,56,"[6, 3, 4, 4, 4, 6, 4, 4, 3, 4, 7, 3, 4]"
金凤鈎 ,晁补之,平平仄，仄平仄。仄仄仄、仄平平仄。仄平平仄，仄平平仄，平仄仄平仄仄。平平平仄平平仄。仄仄仄、仄平平仄。仄平平仄，仄平平仄。平仄仄平平仄。,0,25,30,55,"[3, 3, 3, 4, 4, 4, 6, 7, 3, 4, 4, 4, 6]"
金凤鈎 ,晁补之,仄平平仄平仄。仄仄仄、仄平平仄。平平平仄仄平仄，仄仄仄平平仄。仄平仄仄平平仄。仄仄仄、仄平平仄。仄平平仄仄平平，仄平仄仄平平仄。,0,23,31,54,"[6, 3, 4, 7, 6, 7, 3, 4, 7, 7]"
鹧鸪天 ,晏几道,仄仄平平仄仄平。平平平仄仄平平。仄平平仄平平仄，平仄平平仄仄平。平仄仄，仄平平。仄平平仄仄平平。平平仄仄平平仄，平仄平平仄仄平。,0,31,24,55,"[7, 7, 7, 7, 3, 3, 7, 7, 7]"
鼓笛令 ,黄庭坚,仄平仄仄平平仄。仄仄平、仄平平仄。仄仄平平平仄仄。仄平仄、仄平平仄。仄仄仄平平仄。仄平平、仄平平仄。仄仄平平平平仄。仄平仄、平平仄仄。,0,25,30,55,"[7, 3, 4, 7, 3, 4, 6, 3, 4, 7, 3, 4]"
徵招调中腔 ,王安中,平平仄仄平平仄。仄仄仄、平平平仄。仄仄仄平仄平平，仄仄平，仄平仄。平平仄仄平平仄。仄仄仄、平平平仄。仄仄仄平仄平平，平仄仄仄仄平仄。,0,24,31,55,"[7, 3, 4, 7, 3, 3, 7, 3, 4, 7, 7]"
虞美人 ,（南唐）李煜,平平仄仄平平仄。仄仄平平仄。平平仄仄仄平平。平仄仄平平仄、仄平平。平平仄仄平平仄。平仄平平仄。仄平平仄仄平平。仄仄平平平仄、仄平平。,0,31,25,56,"[7, 5, 7, 6, 3, 7, 5, 7, 6, 3]"
虞美人 ,张炎,平平仄仄平平仄。平仄平平仄。仄平平仄仄平平。仄仄仄平平仄、仄平平。仄平仄仄平平仄。仄仄平平仄。仄平平仄仄平平。仄仄平平仄仄、仄平平。,0,28,28,56,"[7, 5, 7, 6, 3, 7, 5, 7, 6, 3]"
虞美人 ,冯延巳,仄平平仄平平仄。仄仄平平仄。平平仄仄仄平平。仄仄平平平仄、仄平平。平平仄仄平平仄。仄仄平平仄。仄平平仄仄平平。平仄平平平仄、仄平平。,0,31,25,56,"[7, 5, 7, 6, 3, 7, 5, 7, 6, 3]"
虞美人 ,毛文锡,仄平平仄平平仄。仄仄平平仄。仄平平仄仄平平。平平仄仄仄平平。仄平平。仄平平仄平平仄。仄仄平平仄。平平仄仄仄平平。平平平仄仄平平。仄平平。,0,33,25,58,"[7, 5, 7, 7, 3, 7, 5, 7, 7, 3]"
虞美人 ,晁补之,平平平仄平平仄。平仄平平仄。平平仄仄仄平平。平平仄仄仄平平。仄平平。平平仄仄平平仄。仄仄平平仄。仄平仄仄仄平平。平平仄仄仄平平。仄平平。,0,33,25,58,"[7, 5, 7, 7, 3, 7, 5, 7, 7, 3]"
虞美人 ,顾夐,仄平平仄仄平平。平仄仄平平。仄平平仄仄平平。仄平仄仄仄平平。仄平平。仄平平仄仄平平。仄仄仄平平。仄平平仄仄平平。仄平仄仄仄平平。仄平平。,0,31,27,58,"[7, 5, 7, 7, 3, 7, 5, 7, 7, 3]"
虞美人 ,顾夐,仄平仄仄仄平平。仄仄仄平平。平平仄仄仄平平。平平平仄仄平平。仄平平。平平仄仄平平仄。仄仄平平仄。仄平平仄仄平平。仄平仄仄仄平平。仄平平。,0,31,27,58,"[7, 5, 7, 7, 3, 7, 5, 7, 7, 3]"
瑞鹧鸪 ,冯延巳,平仄平平仄仄平。仄平仄仄仄平平。仄平仄仄平平仄，平仄平平平仄平。仄仄平平平仄仄，平平平仄仄平平。仄平仄仄平平仄，仄仄平平平仄平。,0,30,26,56,"[7, 7, 7, 7, 7, 7, 7, 7]"
瑞鹧鸪 ,贺铸,仄平平仄仄平平。平仄平平仄仄平。平仄仄平平仄仄，仄平平仄仄平平。平平仄仄平平仄，仄仄平平仄仄平。平仄仄平平仄仄，仄平平仄仄平平。,0,29,27,56,"[7, 7, 7, 7, 7, 7, 7, 7]"
瑞鹧鸪 ,柳永,平平平仄仄平平。仄平仄仄仄平平。平仄平平，仄仄平平仄，平仄平平仄仄平。仄平平仄平平仄，仄平仄仄平平。仄仄仄仄平平，平仄平平仄、仄平平。平仄平平仄仄平。,0,35,29,64,"[7, 7, 4, 5, 7, 7, 6, 6, 5, 3, 7]"
瑞鹧鸪 ,无名氏,平平平仄仄平平。平平平仄仄平平。仄仄平平，仄仄平平仄，仄仄平平仄仄平。仄平平仄平平仄，平平平仄平平。仄平平仄，平平仄仄，平仄仄、仄平平。仄仄平平仄仄平。,0,36,28,64,"[7, 7, 4, 5, 7, 7, 6, 4, 4, 3, 3, 7]"
瑞鹧鸪 ,柳永,仄仄平平。平平仄，平平仄仄平平。仄平平仄，仄仄平平。仄仄平平仄仄，平仄仄平平。平仄仄、平平仄仄，仄仄平平。平仄仄平平。仄仄仄平平，仄仄平平。平仄仄，仄仄平仄平平。平仄平平仄仄，平仄仄平平。平仄仄、平平仄仄，仄仄平平。,0,44,44,88,"[4, 3, 6, 4, 4, 6, 5, 3, 4, 4, 5, 5, 4, 3, 6, 6, 5, 3, 4, 4]"
瑞鹧鸪 ,柳永,平仄平平。平平仄，平仄仄仄平平。平平仄仄，平仄平平。仄仄平平仄仄，平仄仄平平。仄仄平平仄仄，平仄平平。平仄仄平平。仄仄仄平平，仄仄平平。平平仄仄，仄仄平平。仄仄平平仄仄，平仄仄平平。平仄平、平平仄仄，平仄平平。,0,46,40,86,"[4, 3, 6, 4, 4, 6, 5, 6, 4, 5, 5, 4, 4, 4, 6, 5, 3, 4, 4]"
玉楼春 ,顾夐,仄仄平平平仄仄。仄仄仄平平仄仄。平平平仄仄平平，仄仄仄平平仄仄。仄仄平平平仄仄。仄仄平平平仄仄。仄平仄仄仄平平，仄仄平平平仄仄。,0,24,32,56,"[7, 7, 7, 7, 7, 7, 7, 7]"
玉楼春 ,顾夐,仄仄仄平平仄仄。仄仄平平平仄仄。仄平平仄仄平平，平仄仄平平仄仄。平仄仄平平仄仄，仄仄仄平平仄仄。仄平平仄仄平平，仄仄平平平仄仄。,0,24,32,56,"[7, 7, 7, 7, 7, 7, 7, 7]"
玉楼春 ,牛峤,平仄平平平仄仄。平仄仄平平平仄。仄平平仄仄平平，仄仄平平平仄仄。仄仄平平平仄仄。平仄仄平平仄仄。仄平仄仄仄平平，仄仄仄平平仄仄。,0,26,30,56,"[7, 7, 7, 7, 7, 7, 7, 7]"
玉楼春 ,（南唐）李煜,仄平平仄平平仄。平仄平平平仄仄。仄平平仄仄平平，平仄平平平仄仄。平平平仄平平仄。仄仄平平平仄仄。平平平仄仄平平，仄仄仄平平仄仄。,0,31,25,56,"[7, 7, 7, 7, 7, 7, 7, 7]"
凤衔杯 ,晏殊,平平仄仄平平仄。平仄仄、仄平平仄。仄仄平平、平仄平平仄。平仄仄、平平仄。仄平平，仄平仄。平仄仄、仄平平仄。仄仄平平仄仄、平平仄。仄仄平平仄。,0,27,29,56,"[7, 3, 4, 4, 5, 3, 3, 3, 3, 3, 4, 6, 3, 5]"
凤衔杯 ,柳永,平仄平平平平仄。平平仄、仄平平仄。仄仄仄平平，仄平平仄平平仄。仄仄仄、平平仄。仄平平、仄平仄。平平平、仄平平仄。仄平仄平平，仄平平仄平平仄。仄平仄、平平仄。,0,35,28,63,"[7, 3, 4, 5, 7, 3, 3, 3, 3, 3, 4, 5, 7, 3, 3]"
凤衔杯 ,晏殊,仄平平仄仄平平。仄仄平、平仄平平。仄仄仄平平仄、仄平平。平仄仄、仄平平。平仄仄，仄平平。仄平平、平仄平平。平仄仄平平仄、仄平平。仄仄仄平平。,0,30,26,56,"[7, 3, 4, 6, 3, 3, 3, 3, 3, 3, 4, 6, 3, 5]"
凤衔杯 ,杜安世,平平仄仄仄平平。仄平平、平仄平平。仄仄平平平仄、仄平平。平仄仄、仄平平。平平仄，仄平平。仄平平、平仄平平。平仄仄平平仄、仄平平。平仄仄、仄平平。,0,34,23,57,"[7, 3, 4, 6, 3, 3, 3, 3, 3, 3, 4, 6, 3, 3, 3]"
鹊桥仙 ,欧阳修,仄平平仄，平平平仄，平仄仄平平仄。仄平平仄仄平平，仄仄仄、平平平仄。平平仄仄，平平平仄，平仄仄平平仄。平平平仄仄平平，仄仄仄、平平平仄。,0,31,25,56,"[4, 4, 6, 7, 3, 4, 4, 4, 6, 7, 3, 4]"
鹊桥仙 ,卢炳,平平仄仄，平平平仄。仄仄仄平平仄。平平仄仄仄平平，仄仄仄、平平平仄。仄平平仄，平平平仄。仄仄平平仄仄。仄平仄仄仄平平，平仄仄、仄平平仄。,0,27,29,56,"[4, 4, 6, 7, 3, 4, 4, 4, 6, 7, 3, 4]"
鹊桥仙 ,辛弃疾,平平仄仄。平平仄仄。平仄平平平仄。仄平平仄仄平平，仄仄仄、平平仄仄。仄平仄仄。平平仄仄。仄仄平平平仄。仄平平仄仄平平，仄平仄、平平仄仄。,0,27,29,56,"[4, 4, 6, 7, 3, 4, 4, 4, 6, 7, 3, 4]"
鹊桥仙 ,辛弃疾,仄平平仄，仄平平仄，仄仄平平平仄。仄仄平、仄仄仄平平，仄仄仄、平平仄仄。平平仄仄，平平仄仄，平仄平平仄仄。仄平平、仄仄仄平平，仄仄仄、平平仄仄。,0,25,33,58,"[4, 4, 6, 3, 5, 3, 4, 4, 4, 6, 3, 5, 3, 4]"
鹊桥仙 ,黄庭坚,仄平仄仄，平平仄仄，仄平仄、平平仄仄。平平平仄仄平平，仄仄仄、平平平仄。仄平平仄，平平仄仄，仄仄平平平仄。仄平平仄仄平平，仄仄仄、平平仄仄。,0,27,30,57,"[4, 4, 3, 4, 7, 3, 4, 4, 4, 6, 7, 3, 4]"
鹊桥仙 ,方岳,平平仄仄，平平平仄。仄仄仄、平平平仄。仄平平仄仄平平，仄仄仄仄平平仄。平平仄仄，平平平仄。仄仄仄、平平平仄。仄平仄仄仄平平，仄平仄仄平平仄。,0,28,30,58,"[4, 4, 3, 4, 7, 7, 4, 4, 3, 4, 7, 7]"
鹊桥仙 ,柳永,仄平平，平平仄，平平仄仄平平仄。仄平平，平仄平仄平平仄。平平平仄仄仄，仄仄平平仄。平仄仄，仄仄仄平平，仄平平仄。仄仄仄平仄仄。仄平平、仄平平仄。平仄仄、仄平仄平平仄。平平仄仄平仄。仄仄平平仄。仄平平仄。仄平平平仄。,0,43,45,88,"[3, 3, 7, 3, 7, 6, 5, 3, 5, 4, 6, 3, 4, 3, 6, 6, 5, 4, 5]"
玉阑干 ,杜安世,平平仄仄平平仄。仄仄仄平平仄仄。平平仄仄仄平平，平平仄、仄平平仄。仄平平仄平平仄。仄仄平、平仄平仄。仄平仄仄仄平平，平平平、仄仄平仄。,0,28,28,56,"[7, 7, 7, 3, 4, 7, 3, 4, 7, 3, 4]"
思归乐 ,柳永,平仄平平平仄仄。平仄仄、平平平仄。仄仄仄平平仄仄。仄仄仄、仄平平仄。仄仄平平平仄仄。仄仄仄、仄平平仄。仄仄仄平平仄仄。仄仄平、仄平平仄。,0,22,34,56,"[7, 3, 4, 7, 3, 4, 7, 3, 4, 7, 3, 4]"
遍地锦 ,毛滂,仄仄平平仄平仄。仄平平、仄平平仄。仄平平、仄仄平平，仄仄仄、平平仄仄。仄平平、仄仄平平，仄平平、仄平平仄。仄仄平、平仄平平，仄仄仄、平平仄仄。,0,27,29,56,"[7, 3, 4, 3, 4, 3, 4, 3, 4, 3, 4, 3, 4, 3, 4]"
翻香令 ,苏轼,平平平仄仄平平。仄平仄仄仄平平。平平仄，平平仄，仄仄平、仄仄仄平平。仄平平仄仄平平。仄平平仄仄平平。仄平仄，平平仄，仄平平、平仄仄平平。,0,31,25,56,"[7, 7, 3, 3, 3, 5, 7, 7, 3, 3, 3, 5]"
茶瓶儿 ,李元膺,仄平平平平仄仄。仄平仄、平平平仄。平仄平平仄。仄平平仄，仄仄平平仄。平仄平平平仄仄。平仄仄平平平仄。平仄平平仄。仄平平仄。平仄平平仄。,0,31,25,56,"[7, 3, 4, 5, 4, 5, 7, 7, 5, 4, 5]"
茶瓶儿 ,赵彦端,仄仄平平平仄。仄平平、仄平平仄。仄平平仄平平仄。仄仄仄、仄平平仄。仄平仄平平仄。仄平平、仄平平仄。平平平仄平平仄。仄仄仄、仄平平仄。,0,27,27,54,"[6, 3, 4, 7, 3, 4, 6, 3, 4, 7, 3, 4]"
茶瓶儿 ,石孝友,平仄平平仄仄。平平仄、仄平仄仄。平平仄仄平平仄。平仄仄、仄平平仄。平平仄。平平仄。仄平平、仄平仄仄。平平仄仄平平仄。仄仄仄、仄平仄仄。,0,25,29,54,"[6, 3, 4, 7, 3, 4, 3, 3, 3, 4, 7, 3, 4]"
柳摇金 ,沈会宗,平平平仄仄平仄。仄仄仄、平平仄仄。仄仄平平平仄仄。仄平平、仄平仄仄。平平平仄仄平平，仄仄平、平平仄仄。仄仄平平平仄仄。仄平平、仄平平仄。,0,27,29,56,"[7, 3, 4, 7, 3, 4, 7, 3, 4, 7, 3, 4]"
卓牌子 ,杨无咎,平平平平仄。平仄仄、平平仄仄。平仄仄仄平平，仄平平仄平平，仄平平仄。平平平仄仄。仄仄仄、平平仄仄。仄仄仄仄平平，仄平平仄，平平仄平平仄。,0,29,27,56,"[5, 3, 4, 6, 6, 4, 5, 3, 4, 6, 4, 6]"
卓牌子 ,万俟咏,平平仄平平，平仄仄、平平仄仄。仄仄仄仄，平平仄仄，平平平仄，仄平平仄。平平仄平平，平仄仄、平平仄仄。平仄仄仄平平，仄平仄、平仄平平，仄平平仄。仄平仄仄。仄平仄、平平平仄。仄平平仄。平仄仄平仄。平仄平平平平仄，仄仄平平仄仄。平仄。仄仄平平仄。,0,49,48,97,"[5, 3, 4, 4, 4, 4, 4, 5, 3, 4, 6, 3, 4, 4, 4, 3, 4, 4, 5, 7, 6, 2, 5]"
卓牌子 ,无名氏,平平仄平平，平仄仄、平平仄。平仄仄仄，平平仄平，平平平仄，仄平平仄。平平仄平平，平仄平、平平仄仄。平仄仄仄，平平仄平，平平仄平平仄。仄平仄仄。仄仄仄、平平平仄。仄平平仄，平平仄平仄。仄仄平平平平仄，仄仄平平仄仄。平仄。仄仄平平仄。,0,50,43,93,"[5, 3, 3, 4, 4, 4, 4, 5, 3, 4, 4, 4, 6, 4, 3, 4, 4, 5, 7, 6, 2, 5]"
清江曲 ,苏庠,仄仄平平仄仄平。平平平仄仄平平。仄平仄仄平平仄，平仄平平仄仄平。平平仄仄平平仄。平平仄仄平平仄。仄仄仄仄仄仄平，平仄平平仄平仄。,0,28,28,56,"[7, 7, 7, 7, 7, 7, 7, 7]"
楼上曲 ,张元干,平仄仄平平仄仄。平平平仄平平仄。平仄仄平仄仄平。平平仄仄平平平。平仄平平平仄仄。平仄平平仄平仄。平平仄仄仄平平。平平平仄仄平平。,0,33,23,56,"[7, 7, 7, 7, 7, 7, 7, 7]"
厅前柳 ,赵师侠,仄平平。仄仄仄，平平仄，仄平平。仄平仄平平仄，仄平平。仄平仄，仄平平。仄仄仄、平平平仄仄，仄平平仄仄平平。仄仄平平仄，仄平平。仄平仄，仄平平。,0,28,28,56,"[3, 3, 3, 3, 6, 3, 3, 3, 3, 5, 7, 5, 3, 3, 3]"
厅前柳 ,朱雍,仄仄平平仄，仄平平、仄仄平平。平仄平平仄，仄平平。平仄仄，仄平平。平仄仄、平平平仄仄，仄平平、平仄平平。平仄平平仄，仄平平。仄平仄，仄平平。,0,31,24,55,"[5, 3, 4, 5, 3, 3, 3, 3, 5, 3, 4, 5, 3, 3, 3]"
厅前柳 ,朱雍,仄仄平平仄，仄平仄、仄仄平平。平仄平平仄，仄平平。平平仄，仄平平。平仄仄平平仄仄，平平仄、仄仄平平。平仄平平仄，仄平平。平仄仄，仄平平。,0,29,25,54,"[5, 3, 4, 5, 3, 3, 3, 7, 3, 4, 5, 3, 3, 3]"
二色宫桃 ,无名氏,仄仄平平平仄仄。仄仄仄、平平平仄。平仄仄平仄仄平，平平仄、仄平平仄。平平仄仄平平仄。仄平平、仄平平仄。仄仄仄平仄仄平，平平仄、仄平平仄。,0,27,29,56,"[7, 3, 4, 7, 3, 4, 7, 3, 4, 7, 3, 4]"
市桥柳 ,蜀妓,仄仄仄、平平仄仄。仄仄仄平平仄。平平仄仄平平，仄平平、仄平仄平仄。仄仄仄平平仄仄。仄平平、平仄仄平平仄。仄仄仄、平平平，仄平平、仄平仄仄。,0,25,31,56,"[3, 4, 6, 6, 3, 5, 7, 3, 6, 3, 3, 3, 4]"
一斛珠 ,（南唐）李煜,仄平平仄。平平平仄平平仄。仄平平仄平平仄。仄仄平平，仄仄平平仄。平仄仄平平仄仄。平平仄仄平平仄。仄平平仄平平仄。仄仄平平，仄仄平平仄。,0,30,27,57,"[4, 7, 7, 4, 5, 7, 7, 7, 4, 5]"
一斛珠 ,张先,平平仄仄。平平仄仄平平仄。仄平平仄平平仄。仄仄平平，仄仄平平仄。仄平仄仄平平仄。平平平仄平平仄。平平仄仄平平仄。平仄平平，仄仄平平仄。,0,31,26,57,"[4, 7, 7, 4, 5, 7, 7, 7, 4, 5]"
一斛珠 ,周邦彦,平平仄仄。平平仄、仄平平仄。仄平平仄平平仄。平仄平平，平仄仄平仄。平平仄仄平平仄。仄平平仄仄平仄。仄平平仄平平仄。平仄平平，仄仄仄平仄。,0,30,27,57,"[4, 3, 4, 7, 4, 5, 7, 7, 7, 4, 5]"
夜游宫 ,毛滂,平仄平平仄仄。仄平仄、平平平仄。平仄平平仄仄仄。仄平平，仄平平，平仄仄。仄仄平平仄。仄平仄、平平平仄。平仄平平仄平仄。仄平平，仄平平，平仄仄。,0,30,27,57,"[6, 3, 4, 7, 3, 3, 3, 5, 3, 4, 7, 3, 3, 3]"
夜游宫 ,贺铸,平仄平平仄仄。平平仄仄平平仄。仄仄平平平仄仄。仄平平，仄平平，平仄仄。平仄平平仄。仄平仄、仄平平仄。平仄平平平仄仄。仄平平，仄平平，平仄仄。,0,30,27,57,"[6, 7, 7, 3, 3, 3, 5, 3, 4, 7, 3, 3, 3]"
梅花引 ,贺铸,平仄仄。平平仄。平平平平仄平仄。仄平平。仄平平。仄仄仄平，平仄平平平。平平仄仄平平仄。仄仄平平仄平仄。平平平。仄平平。平仄平平，仄仄仄平平。,0,34,23,57,"[3, 3, 7, 3, 3, 4, 5, 7, 7, 3, 3, 4, 5]"
梅花引 ,万俟咏,仄平平。仄平平。仄仄平平平仄平。仄平平。仄平平。平仄仄平，平平平仄平。平平平仄平平仄。平平平仄平平仄。仄平平。仄平平。平仄仄平，仄平平仄平。,0,37,20,57,"[3, 3, 7, 3, 3, 4, 5, 7, 7, 3, 3, 4, 5]"
梅花引 ,贺铸,仄仄仄。平平仄。平平平平仄平仄。仄平平。仄平平。仄平仄仄，仄仄平平平。平平仄仄平平仄。平仄仄平平仄仄。仄平平。仄平平。平仄平平，仄仄仄仄平。仄仄仄。仄平仄。平仄平平仄平仄。仄平平。仄平平。平平平仄，仄仄仄平平。平平平仄平平仄。仄仄平平平仄仄。仄平平。仄平平。平仄平平，仄仄仄平平。,0,61,53,114,"[3, 3, 7, 3, 3, 4, 5, 7, 7, 3, 3, 4, 5, 3, 3, 7, 3, 3, 4, 5, 7, 7, 3, 3, 4, 5]"
梅花引 ,无名氏,平平仄。平仄仄。平平仄仄平平仄。仄平平。仄平平。仄平仄仄，平平仄平平。平平仄。平仄仄。平平仄仄平平仄。仄平平。仄平平。仄平平仄，仄仄仄平平。平平平仄平平仄。平仄平平仄平仄。仄平平。仄平平。平平仄仄，仄仄仄平平。仄平仄仄平平仄。平仄仄平平仄仄。仄平平。仄平平。平仄仄平，平仄仄平平。,0,63,51,114,"[3, 3, 7, 3, 3, 4, 5, 3, 3, 7, 3, 3, 4, 5, 7, 7, 3, 3, 4, 5, 7, 7, 3, 3, 4, 5]"
荷叶铺水面 ,康与之,平平仄仄，平平仄仄平。平平仄仄仄平平。仄平仄仄仄，仄仄仄平仄仄平。平平仄仄平。平平仄仄仄，仄仄仄仄平平。仄仄仄平平。仄仄仄平平，平仄平。,0,25,32,57,"[4, 5, 7, 5, 7, 5, 5, 6, 5, 5, 3]"
家山好 ,无名氏,仄平平仄仄平平。平平仄，仄平平。平平仄仄平平仄，仄平平。仄平仄，仄平平。仄平平仄平平仄，仄仄仄平平。平平仄仄，平平仄仄仄平平。平平仄仄平。,0,32,25,57,"[7, 3, 3, 7, 3, 3, 3, 7, 5, 4, 7, 5]"
步虚子令 ,无名氏,仄平平仄仄平平。平仄仄平平。仄平平仄，仄平平仄平平。仄仄仄，仄平平。仄平仄仄平平仄，平仄仄，仄平平。仄平仄仄，仄平平仄平平。仄仄仄，仄平平。,0,28,29,57,"[7, 5, 4, 6, 3, 3, 7, 3, 3, 4, 6, 3, 3]"
小重山 ,薛昭蕴,平仄平平平仄平。仄平平仄仄、仄平平。平平平仄仄平平。平仄仄、平仄仄平平。平仄仄平平。平平平仄仄、仄平平。仄平平仄仄平平。平平仄、平仄仄平平。,0,35,23,58,"[7, 5, 3, 7, 3, 5, 5, 5, 3, 7, 3, 5]"
小重山 ,赵长卿,仄仄平平仄仄平。仄平平仄仄、仄平平。平平仄仄仄平平。平平仄，平仄仄、仄平平。仄仄仄平平。平平平仄仄、仄平平。仄平平仄仄平平。平平仄，平仄仄、仄平平。,0,32,28,60,"[7, 5, 3, 7, 3, 3, 3, 5, 5, 3, 7, 3, 3, 3]"
小重山 ,无名氏,仄仄平平仄仄平。仄平平仄仄平平。平平平仄仄平平。平平仄、平仄仄平平。仄仄仄平平。仄平平仄仄、仄平平。仄平仄仄仄平平。仄仄仄、仄仄仄平平。,0,28,29,57,"[7, 7, 7, 3, 5, 5, 5, 3, 7, 3, 5]"
小重山 ,黄子行,仄仄平平平仄仄。仄平平仄仄、仄平仄。平平平仄仄平仄。仄平平、平仄仄平仄。平仄仄平仄。平平平仄仄、仄平仄。平平平仄仄平仄。仄平平、平仄仄平仄。,0,28,30,58,"[7, 5, 3, 7, 3, 5, 5, 5, 3, 7, 3, 5]"
踏莎行 ,晏殊,仄仄平平，平平仄仄。平平仄仄平平仄。仄平平仄仄平平，平平仄仄平平仄。仄仄平平，平平仄仄。平平仄仄平平仄。平平仄仄仄平平，平平仄仄平平仄。,0,32,26,58,"[4, 4, 7, 7, 7, 4, 4, 7, 7, 7]"
踏莎行 ,曾觌,仄仄平平，平平平仄。仄平平仄仄、平平仄。平平平仄，仄平平仄仄。平平仄仄仄平平仄。仄仄平平，平平平仄。平平平仄仄、仄平仄。平平平仄，仄平平平仄。平仄仄仄仄平平仄。,0,36,30,66,"[4, 4, 5, 3, 4, 5, 8, 4, 4, 5, 3, 4, 5, 8]"
踏莎行 ,陈亮,仄仄平平，平平仄仄。平平平仄仄、平平仄。平平仄仄，平平仄仄。平仄仄仄、平平平仄。仄仄平平，仄平仄仄。仄平平仄仄、仄平仄。平平仄仄，平平仄仄。仄平仄仄、仄平平仄。,0,30,34,64,"[4, 4, 5, 3, 4, 4, 4, 4, 4, 4, 5, 3, 4, 4, 4, 4]"
宜男草 ,范成大,仄仄平平仄平仄。仄平平、平平平仄。仄仄平、仄仄平平，平仄平仄平平平仄。平平平仄仄平仄。仄平平、仄平平仄。平仄平、平仄平平，平仄平仄平平仄仄。,0,33,25,58,"[7, 3, 4, 3, 4, 8, 7, 3, 4, 3, 4, 8]"
宜男草 ,范成大,平仄平平仄平仄。仄平平、仄平平仄。平仄平、仄仄平平仄仄，平仄仄、平平仄仄。仄平平仄仄平仄。仄平平、仄平平仄。平仄平、仄仄平平仄仄，平仄平、平平仄仄。,0,30,30,60,"[7, 3, 4, 3, 6, 3, 4, 7, 3, 4, 3, 6, 3, 4]"
花上月令 ,吴文英,平平平仄仄平平。仄平仄，仄平平。仄平平仄平平仄，仄平平。平仄仄，仄平平。平仄仄平平仄仄，平仄仄，仄平平。仄平仄仄平平仄，仄平平。仄平仄，仄平平。,0,31,27,58,"[7, 3, 3, 7, 3, 3, 3, 7, 3, 3, 7, 3, 3, 3]"
倚西楼 ,韦彦温,仄仄平平平仄仄。平仄平平平仄仄。仄平平仄仄平平，平仄仄平平仄仄。平仄平平平仄平，仄仄平平平仄仄。平平平仄仄平平，平仄仄仄仄平仄仄仄。,0,29,29,58,"[7, 7, 7, 7, 7, 7, 7, 9]"
扫地舞 ,无名氏,平仄仄。仄仄仄。仄平仄平平仄仄。平仄仄。平仄仄。仄仄平平平仄仄。仄平仄。仄仄仄。仄仄仄。仄平仄平仄仄仄。平仄仄。仄仄仄。仄仄平平平仄仄。仄平仄。,0,17,41,58,"[3, 3, 7, 3, 3, 7, 3, 3, 3, 7, 3, 3, 7, 3]"
接贤宾 ,毛文锡,平平仄仄仄平平。仄平仄平平。平平平仄仄仄，仄仄平平。仄平平仄平平仄，平平仄仄平平。仄仄平平平仄仄，平平仄仄平平。仄平平，平仄仄，仄仄仄平平。,0,32,27,59,"[7, 5, 6, 4, 7, 6, 7, 6, 3, 3, 5]"
接贤宾 ,柳永,仄平平仄平平仄，平仄平平。仄平平平仄仄，仄仄平平。仄仄平平仄仄，平平仄仄平平。仄平仄仄平平仄，平平仄、仄仄平平。仄仄平平平仄，平仄仄平平。仄平平仄仄平平。仄仄仄平平。仄平平平仄仄，平仄平平。平仄平平平仄，仄平仄仄平平。仄平平仄平平仄，平平仄、仄仄平平。仄仄平仄仄仄，平仄仄平平。,0,62,55,117,"[7, 4, 6, 4, 6, 6, 7, 3, 4, 6, 5, 7, 5, 6, 4, 6, 6, 7, 3, 4, 6, 5]"
步蟾宫 ,黄庭坚,平平平仄仄平仄。仄仄仄、仄平平仄。仄平平、仄仄仄平平，仄仄仄、仄平平仄。仄平平仄平平仄。仄仄仄、仄平仄仄。仄平平，平仄仄，仄平平，仄平仄、平平平仄。,0,26,33,59,"[7, 3, 4, 3, 5, 3, 4, 7, 3, 4, 3, 3, 3, 3, 4]"
步蟾宫 ,杨无咎,仄平仄仄平平仄。仄平仄、仄平平仄。仄平平、平仄仄平平，仄平仄、仄平仄仄。仄平仄仄平平仄。仄仄仄、仄平平仄。仄仄平、仄仄仄平平，仄平仄、平平仄仄。,0,24,34,58,"[7, 3, 4, 3, 5, 3, 4, 7, 3, 4, 3, 5, 3, 4]"
步蟾宫 ,蒋捷,仄平仄仄平平仄。仄仄仄、平平平仄。平平仄仄仄平平，仄平仄、平平仄仄。平平仄仄平平仄。仄平仄、平平平仄。平平平仄仄平平，仄平仄、仄平平仄。,0,29,27,56,"[7, 3, 4, 7, 3, 4, 7, 3, 4, 7, 3, 4]"
步蟾宫 ,汪存,仄平仄仄平平仄。仄仄仄、仄平平仄。平平仄仄仄平平，仄平仄、平平仄仄。平平仄仄平平仄。仄平仄、仄平平仄。平平仄仄仄平平，仄仄仄、平平仄仄。,0,25,31,56,"[7, 3, 4, 7, 3, 4, 7, 3, 4, 7, 3, 4]"
步蟾宫 ,无名氏,仄平仄平仄平仄。平仄仄、平平仄仄。平平仄仄仄平平，仄平仄、仄平平仄。仄平仄仄平平仄。仄平仄、平平仄仄。仄平平仄仄平平，平平仄、仄仄平平仄。,0,27,30,57,"[7, 3, 4, 7, 3, 4, 7, 3, 4, 7, 3, 5]"
恨春迟 ,张先,仄仄平平平仄仄，平仄仄、平仄平平。仄仄仄平平，仄仄平平仄，仄平仄平平。平仄平平平平仄，仄仄仄、仄仄平平。仄仄平平仄仄，平仄平平，平平平仄平平。,0,31,28,59,"[7, 3, 4, 5, 5, 5, 7, 3, 4, 6, 4, 6]"
冉冉云 ,卢炳,仄仄平平仄平仄。平仄平、仄平平仄。平仄仄、平仄平平平仄。仄仄仄、平平仄仄。仄仄平平仄平仄。仄平平、仄平仄仄。平仄平、仄仄平平平仄。仄仄平平平仄。,0,28,31,59,"[7, 3, 4, 3, 6, 3, 4, 7, 3, 4, 3, 6, 6]"
冉冉云 ,韩淲,仄仄平平仄平仄。仄平平、仄平平仄。平仄仄、仄仄平平平仄，仄仄仄、平平仄仄。仄平平仄平平仄。仄平平、仄平平仄。平仄仄、仄仄平平平仄。平仄平平仄仄。,0,28,31,59,"[7, 3, 4, 3, 6, 3, 4, 7, 3, 4, 3, 6, 6]"
蝶恋花 ,冯延巳,仄仄平平平仄仄。平仄平平，仄仄平平仄。平仄仄平平仄仄。平平仄仄平平仄。仄仄平平平仄仄。平仄平平，仄仄平平仄。平仄仄平平仄仄。平平仄仄平平仄。,0,30,30,60,"[7, 4, 5, 7, 7, 7, 4, 5, 7, 7]"
蝶恋花 ,沈会宗,仄仄平平平仄仄。仄仄平平，平仄平平仄。仄仄平平仄平仄。平平仄仄平平仄。仄平仄仄平平仄。仄仄平平，仄仄平平仄。仄仄平平仄平仄。平平仄仄平平仄。,0,29,31,60,"[7, 4, 5, 7, 7, 7, 4, 5, 7, 7]"
蝶恋花 ,石孝友,仄平平平平仄平。仄仄平平，仄仄平平仄。仄仄平平平仄平。平平仄仄平平仄。仄仄平平平仄仄。仄仄平平，仄仄平平仄。平仄平平平仄仄。仄平仄仄平平仄。,0,31,29,60,"[7, 4, 5, 7, 7, 7, 4, 5, 7, 7]"
寿山曲 ,冯延巳,平平仄仄平仄，平仄平平仄平。平仄仄平平仄，平平平仄平平。平平仄仄平仄，仄仄平平仄平。平仄仄平仄仄，平平仄仄平平。仄平仄仄平仄，仄仄平平仄平。,0,32,28,60,"[6, 6, 6, 6, 6, 6, 6, 6, 6, 6]"
秋蕊香引 ,柳永,平仄仄。平平平仄，仄平平仄，仄平仄，平仄仄。仄平仄仄平平仄，仄平仄平仄。平仄仄，仄仄平平仄仄。仄平仄。仄平仄仄，仄仄平平仄。仄平仄，平平仄，仄平平仄。,0,25,35,60,"[3, 4, 4, 3, 3, 7, 5, 3, 6, 3, 4, 5, 3, 3, 4]"
惜琼花 ,张先,平平仄。平仄仄。仄平平仄仄，平仄平仄。仄平平仄平平仄。平仄平平，平仄平仄。仄平平，平仄仄。仄平平仄仄，平仄平仄。仄平平仄平平仄。平仄平平，平仄平仄。,0,32,28,60,"[3, 3, 5, 4, 7, 4, 4, 3, 3, 5, 4, 7, 4, 4]"
朝玉阶 ,杜安世,平仄平平仄仄平。仄平平仄仄，仄平平。平平平仄仄平平。平平平仄仄、仄平平。仄平平仄仄平平。平平平仄仄，仄平平。平平平仄仄平平。仄平平仄仄、仄平平。,0,36,24,60,"[7, 5, 3, 7, 5, 3, 7, 5, 3, 7, 5, 3]"
散天花 ,舒亶,平仄平平仄仄平。平平平仄仄，仄平平。平平平仄仄平平。平平平仄仄、仄平平。平仄平平仄仄平。平平平仄仄，仄平平。平平仄仄仄平平。仄平平仄仄、仄平平。,0,36,24,60,"[7, 5, 3, 7, 5, 3, 7, 5, 3, 7, 5, 3]"
荷华媚 ,苏轼,平平仄平仄。平平仄、仄仄平平平仄。平平平仄仄，平平仄仄，仄平平仄仄。仄仄仄、平仄平平仄，仄平平仄仄，平平平仄。平平仄、平平仄，平平平仄，仄仄平平仄。,0,32,28,60,"[5, 3, 6, 5, 4, 5, 3, 5, 5, 4, 3, 3, 4, 5]"
少年心 ,黄庭坚,仄仄仄仄平仄。仄平平、仄平平仄。仄仄平平仄仄，仄平仄仄。仄仄仄、仄仄平平。仄仄平平平仄。仄仄仄、仄平仄仄。仄仄平平仄，平平平仄。平平仄、仄仄仄平平。,0,23,37,60,"[6, 3, 4, 6, 4, 3, 4, 6, 3, 4, 5, 4, 3, 5]"
七娘子 ,毛滂,平平仄仄平平仄。仄仄平、平仄平平仄。仄仄平平，仄平平仄。仄平仄仄平仄仄。平平仄仄平平仄。仄平平、仄仄平平仄。平仄平平，平平仄仄。平平平仄平平仄。,0,32,28,60,"[7, 3, 5, 4, 4, 7, 7, 3, 5, 4, 4, 7]"
七娘子 ,蔡伸,平平仄仄平平仄。平平仄仄平平仄。仄仄平平，平平平仄。平平仄仄平平仄。平平仄仄平平仄。平平平仄平平仄。仄仄平平，仄平平仄。平平仄仄平平仄。,0,34,24,58,"[7, 7, 4, 4, 7, 7, 7, 4, 4, 7]"
七娘子 ,无名氏,仄平平仄仄平平。仄仄平、平仄平平仄。平仄平仄，仄平仄仄。仄平仄仄平平仄。平平仄仄平平仄。仄平平、仄仄平平仄。仄平平仄，仄平仄仄。仄平仄仄平平仄。,0,28,32,60,"[7, 3, 5, 4, 4, 7, 7, 3, 5, 4, 4, 7]"
一剪梅 ,周邦彦,仄仄平平仄仄平。平仄平平，仄仄平平。平平平仄仄平平，平仄平平，仄仄平平。仄仄平平仄仄平。仄仄平平，仄仄平平。平平平仄仄平平，平仄平平，仄仄平平。,0,35,25,60,"[7, 4, 4, 7, 4, 4, 7, 4, 4, 7, 4, 4]"
一剪梅 ,吴文英,仄仄平平平仄平。平仄平平，仄仄平平。仄平平仄仄平平。平仄平平，平仄平平。仄仄平平平仄平。仄仄平平，仄仄平平。仄平平仄仄平平。平仄平平，平仄平平。,0,37,23,60,"[7, 4, 4, 7, 4, 4, 7, 4, 4, 7, 4, 4]"
一剪梅 ,卢炳,平仄平平仄仄平。平平仄仄，仄仄平平。仄平仄仄仄平平。仄仄平平。仄仄平平。仄仄平平仄仄平。仄平平仄，仄仄平平。平平仄仄仄平平。仄仄平平。仄仄平平。,0,30,30,60,"[7, 4, 4, 7, 4, 4, 7, 4, 4, 7, 4, 4]"
一剪梅 ,张炎,仄仄平平仄仄平。平仄平平。仄仄平平。仄平平仄仄平平。平仄平平。仄仄平平。平仄平平仄仄平。仄仄平平。仄仄平平。仄平仄仄仄平平。平仄平平。平仄平平。,0,34,26,60,"[7, 4, 4, 7, 4, 4, 7, 4, 4, 7, 4, 4]"
一剪梅 ,蒋捷,仄仄平平仄仄平。平仄平平。平仄平平。平平平仄仄平平。平仄平平。仄仄平平。平仄平平仄仄平。平仄平平。平仄平平。平平平仄仄平平。平仄平平。仄仄平平。,0,39,21,60,"[7, 4, 4, 7, 4, 4, 7, 4, 4, 7, 4, 4]"
一剪梅 ,曹勛,仄仄平平仄平平。平仄平平仄仄平。仄平仄仄仄平平，仄仄平平，平仄平平。仄仄平平仄仄平。平平平仄仄平平。仄平仄仄仄平平，平仄平平，平仄平平。,0,33,25,58,"[7, 7, 7, 4, 4, 7, 7, 7, 4, 4]"
一剪梅 ,赵长卿,仄仄平平仄仄平。平仄平平，仄仄平平。平平仄仄平平仄，仄仄平平仄仄平。仄仄仄平仄仄平。平平平仄，平仄平平。平平仄仄仄平平，平仄平平，仄仄平平。,0,32,27,59,"[7, 4, 4, 7, 7, 7, 4, 4, 7, 4, 4]"
寻梅 ,沈会宗,平平仄仄平仄仄。仄平平、仄平仄仄。仄仄平仄仄平仄。仄平平平仄，仄平平仄。仄平仄仄平平仄。仄仄仄、仄平平仄。平平仄仄平仄仄。仄平平平仄，平仄仄仄。,0,25,35,60,"[7, 3, 4, 7, 5, 4, 7, 3, 4, 7, 5, 4]"
寻梅 ,沈会宗,平平仄仄仄仄仄。仄仄仄、平平仄仄。仄平仄仄平平仄。仄平平，仄仄仄平平仄。平平仄仄平平仄。仄平平、平平平仄。仄平仄仄平平仄。仄仄平，仄仄仄平平仄。,0,26,34,60,"[7, 3, 4, 7, 3, 6, 7, 3, 4, 7, 3, 6]"
锦帐春 ,辛弃疾,平仄平平，仄平平仄。仄仄仄平平平仄。仄平平，平仄仄，仄平平仄仄。仄平平仄。仄仄平平，仄平平仄。仄平仄平平仄仄。仄平平，平仄仄。仄平平仄仄。仄平平仄。,0,29,31,60,"[4, 4, 7, 3, 3, 5, 4, 4, 4, 7, 3, 3, 5, 4]"
锦帐春 ,程珌,仄仄平平，仄平平仄。仄仄仄、平平平仄。仄平平，平仄仄，仄平平平仄，仄平平仄。仄仄平平，仄平平仄。仄仄仄、平平仄仄。仄平平，平仄仄。仄仄平仄仄，仄平平仄。,0,27,33,60,"[4, 4, 3, 4, 3, 3, 5, 4, 4, 4, 3, 4, 3, 3, 5, 4]"
锦帐春 ,戴复古,仄仄平平，平平仄仄。仄平仄平平平仄。仄仄平平仄，仄仄平平仄。平平平仄。仄仄平平，仄平平仄。仄仄仄、仄平平仄。仄平平仄仄，仄仄平平仄。仄平平仄。,0,27,31,58,"[4, 4, 7, 5, 5, 4, 4, 4, 3, 4, 5, 5, 4]"
锦帐春 ,邱崈,仄仄平平，仄平平仄。仄平仄、平平仄仄。仄平平平仄，仄平平仄。仄平平仄。仄仄平平，仄平平仄。仄仄仄、平平仄仄。仄平平仄仄，仄平平仄。平平仄仄。,0,26,30,56,"[4, 4, 3, 4, 5, 4, 4, 4, 4, 3, 4, 5, 4, 4]"
唐多令 ,刘过,平仄仄平平。平平仄仄平。仄仄平、平仄平平。仄仄仄平平仄仄，平仄仄、仄平平。平仄仄平平。仄平平仄平。仄平平、平仄平平。仄仄仄平平仄仄，平仄仄、仄平平。,0,31,29,60,"[5, 5, 3, 4, 7, 3, 3, 5, 5, 3, 4, 7, 3, 3]"
唐多令 ,吴文英,平仄仄平平。平平平仄平。仄平平、仄仄仄平平。平仄仄平平仄仄，仄平仄、仄平平。平仄仄平平。平平平仄平。仄平平、仄仄平平。平仄仄平平仄仄，仄平仄、仄平平。,0,34,27,61,"[5, 5, 3, 5, 7, 3, 3, 5, 5, 3, 4, 7, 3, 3]"
唐多令 ,周密,平仄仄平平。平平仄仄平。仄平平、平仄仄平平。平仄仄平平仄仄，平仄仄、仄平平。平仄仄平平。平平仄仄平。仄平平、平仄仄平平。平仄仄平平仄仄，平仄仄、仄平平。,0,34,28,62,"[5, 5, 3, 5, 7, 3, 3, 5, 5, 3, 5, 7, 3, 3]"
摊破采桑子 ,赵长卿,仄平平仄平平仄，仄仄平平。仄仄平平。仄仄平平仄仄平。仄，平，平仄仄、仄平平。平平仄仄平平仄，仄仄平平。仄仄平平。仄仄平平仄仄平。仄，平，平仄仄、仄平平。,0,30,30,60,"[7, 4, 4, 7, 1, 1, 3, 3, 7, 4, 4, 7, 1, 1, 3, 3]"
后庭宴 ,无名氏,平仄仄平，仄平平仄。仄平平仄平平仄。仄平平仄仄平平，平平平仄平平仄。平平仄仄平平，平仄仄平平仄。仄平平仄，平仄平平仄。仄仄仄平平，仄平平仄仄。,0,33,27,60,"[4, 4, 7, 7, 7, 6, 6, 4, 5, 5, 5]"
鞓红 ,无名氏,仄平平仄，平平仄仄。仄仄仄、平平仄仄。仄平仄仄，仄平平仄。仄仄仄、平平仄仄。仄仄平平，平平平仄。仄仄仄、平平仄仄。仄平仄仄，仄平平仄。仄仄仄、平平仄仄。,0,23,37,60,"[4, 4, 3, 4, 4, 4, 3, 4, 4, 4, 3, 4, 4, 4, 3, 4]"
贺熙朝 ,欧阳炯,仄仄平平平仄仄。仄平平仄。仄平平仄。平平仄仄，仄平平仄，仄平平仄。平仄平仄。仄平平仄仄平仄。仄仄仄平平，平仄仄平仄。仄平平平仄。平仄仄平，仄仄平仄。,0,28,33,61,"[7, 4, 4, 4, 4, 4, 4, 7, 5, 5, 5, 4, 4]"
贺熙朝 ,欧阳炯,仄仄平平平仄仄。平仄仄平，平仄平仄。仄平平仄，仄平平平，仄仄平仄。平仄平仄。仄平平仄平平仄。平仄仄仄平，平仄平仄仄。仄平平平仄。平仄仄平，平仄平仄。,0,30,31,61,"[7, 4, 4, 4, 4, 4, 4, 7, 5, 5, 5, 4, 4]"
拨棹子 ,尹鹗,平仄仄。平平仄。仄仄平平平仄仄。平仄仄、仄平平仄。平平仄、仄仄平平平仄仄。仄平仄仄平平仄。平平仄仄平平仄。平仄仄、仄平平仄。平仄仄、仄仄平平平仄仄。,0,28,33,61,"[3, 3, 7, 3, 4, 3, 7, 7, 7, 3, 4, 3, 7]"
拨棹子 ,黄庭坚,平仄平。平仄平。平仄仄平平仄平。仄平仄、仄仄平平。平仄平、仄仄平平仄仄仄。平仄仄。平仄仄。平仄仄、仄平平仄仄。仄平仄、仄平平仄。平仄平仄仄，平平平仄仄。,0,28,33,61,"[3, 3, 7, 3, 4, 3, 7, 3, 3, 3, 5, 3, 4, 5, 5]"
拨棹子 ,无名氏,平平仄，平平仄。平平仄，仄仄平平平仄。仄仄平平仄仄，平平平仄，仄平平平仄。仄平仄平平平仄仄。仄平仄，仄仄平平平仄。平平仄平仄仄，平平平仄，仄平平平仄。,0,34,28,62,"[3, 3, 3, 6, 6, 4, 5, 8, 3, 6, 6, 4, 5]"
玉堂春 ,晏殊,仄平平仄。仄仄平平平仄。仄仄平平，仄仄平平。仄仄平平，仄仄平平仄，仄仄平平仄仄平。仄仄平平平仄，平平平仄平。仄仄平平，仄仄平平仄，平仄平平仄仄平。,0,31,30,61,"[4, 6, 4, 4, 4, 5, 7, 6, 5, 4, 5, 7]"
系裙腰 ,张先,平平平仄仄平平。平平仄、仄平平。平平仄仄平平仄，仄仄平平。仄平仄，仄平平。仄仄平平平仄仄，平仄仄、仄平平。平平仄仄平平仄，仄仄平平。仄平仄仄，仄平平。,0,33,28,61,"[7, 3, 3, 7, 4, 3, 3, 7, 3, 3, 7, 4, 4, 3]"
系裙腰 ,刘儗,平平仄仄仄平平。平平仄、仄平平。平平仄仄平平。仄平平。平仄仄，仄平平。仄平仄仄仄平平。平平仄、仄平平。平平仄、仄平仄仄平平。仄平平。仄平仄、仄平平。,0,34,25,59,"[7, 3, 3, 6, 3, 3, 3, 7, 3, 3, 3, 6, 3, 3, 3]"
系裙腰 ,宋媛魏氏,平平仄仄仄平平。平仄仄、仄平平。平平平仄仄平平。平仄仄，仄平仄，仄平平。仄平仄仄仄平平。平仄仄、仄平平。仄平平仄仄平平。仄仄仄，仄仄仄，仄平平。,0,28,30,58,"[7, 3, 3, 7, 3, 3, 3, 7, 3, 3, 7, 3, 3, 3]"
赞成功 ,毛文锡,仄平仄仄，仄仄平平。平平平仄仄平平。仄平平仄，平仄平平。平平仄仄，仄仄平平。仄仄平仄，平仄平平。仄平平仄仄平平。仄平平仄，仄仄平平。仄平仄仄，仄仄平平。,0,32,30,62,"[4, 4, 7, 4, 4, 4, 4, 4, 4, 7, 4, 4, 4, 4]"
定风波 ,欧阳炯,仄仄平平仄仄平。仄平平仄仄平平。仄仄仄平平仄仄。平仄。仄平平仄仄平平。仄仄仄平平仄仄。平仄。仄平平仄仄平平。平仄仄平平仄仄。平仄。平平平仄仄平平。,0,30,32,62,"[7, 7, 7, 2, 7, 7, 2, 7, 7, 2, 7]"
定风波 ,孙光宪,平仄平平仄仄平。仄平平仄仄平平。仄仄仄平平仄仄。平仄。仄平仄仄仄平平。平仄仄平平仄仄。平仄。平平平仄仄平平。平仄平平平仄仄。平仄。仄平平、平仄仄平平。,0,33,30,63,"[7, 7, 7, 2, 7, 7, 2, 7, 7, 2, 3, 5]"
定风波 ,蔡伸,仄仄平平仄仄平。仄平仄仄仄平平。仄仄平平平仄仄。平仄。仄平平仄仄平平。仄仄平平平仄仄。仄仄。平平仄仄仄平平。仄仄仄平平仄仄，仄仄平平，仄仄仄平平。,0,27,35,62,"[7, 7, 7, 2, 7, 7, 2, 7, 7, 4, 5]"
定风波 ,李泳,仄仄平平仄仄平。平平平仄仄平平。仄仄仄平平仄仄。平仄。平平仄仄仄平平。平仄仄平平仄仄，平平平仄仄平平。仄仄仄平平仄仄。平仄。仄平平仄仄平平。,0,30,30,60,"[7, 7, 7, 2, 7, 7, 7, 7, 2, 7]"
定风波 ,曹冠,仄仄平平平仄仄，仄平平仄仄平平。平仄仄平平仄仄。平仄。仄平平仄仄平平。仄仄平平平仄仄，平平仄仄仄平平。仄仄平平平仄仄。仄仄。仄平仄仄仄平平。,0,28,32,60,"[7, 7, 7, 2, 7, 7, 7, 7, 2, 7]"
定风波 ,苏轼,仄仄平平仄仄平。仄平平仄仄平平。仄仄仄平平仄仄，平仄，仄平平仄仄平平。平仄平平平仄仄，平仄，仄平平仄仄平平。平仄仄平平仄仄，平仄，仄平仄仄仄平平。,0,30,32,62,"[7, 7, 7, 2, 7, 7, 2, 7, 7, 2, 7]"
定风波 ,京镗,平仄平平仄仄平。仄平仄仄仄平平。平仄平平平仄仄，平仄平平，仄仄仄平平。仄仄仄平平仄仄，平仄仄平平仄仄平平。仄仄仄平平仄仄，仄仄平平，仄仄仄平平。,0,29,33,62,"[7, 7, 7, 4, 5, 7, 9, 7, 4, 5]"
定风波 ,陈允平,平仄平平仄仄平。仄平平仄仄平平。平仄平平平仄仄，平仄仄平，仄仄仄平平。仄仄仄平平仄仄，平平仄仄仄平平。仄仄平平平仄仄，仄仄平平，平仄仄平平。,0,30,30,60,"[7, 7, 7, 4, 5, 7, 7, 7, 4, 5]"
破阵子 ,晏殊,仄仄平平仄仄，平平平仄平平。平仄仄平平仄仄，平仄平平仄仄平。仄平平仄平。仄仄仄平平仄，平平仄仄平平。仄仄平平平仄仄，仄仄平平仄仄平。平平仄仄平。,0,32,30,62,"[6, 6, 7, 7, 5, 6, 6, 7, 7, 5]"
金蕉叶 ,柳永,平平仄仄平平仄。平平仄、仄平平仄。仄仄平平，仄平平仄平平仄。仄仄仄平仄仄。平平仄仄平平仄。仄平平、仄仄平仄。仄平仄仄，平平仄仄平平仄。仄仄仄平平仄。,0,29,33,62,"[7, 3, 4, 4, 7, 6, 7, 3, 4, 4, 7, 6]"
金蕉叶 ,袁去华,平平仄仄。仄平平、仄平仄仄。仄平仄、平平仄仄。仄平仄仄仄。仄仄平平仄仄。仄平平、仄平仄仄。仄仄仄、平平仄仄。仄仄平仄仄。,0,17,31,48,"[4, 3, 4, 3, 4, 5, 6, 3, 4, 3, 4, 5]"
金蕉叶 ,袁去华,平平仄仄。平平仄、仄平仄仄。平仄平平仄仄。仄平仄仄仄。仄仄平平仄仄。仄平平、仄平仄仄。仄仄平平仄仄。仄仄仄仄仄。,0,16,30,46,"[4, 3, 4, 6, 5, 6, 3, 4, 6, 5]"
金蕉叶 ,蒋捷,平平仄仄。仄平平、仄平仄仄。平平平仄仄仄，平平仄仄仄。仄仄平平仄仄。仄平平、仄平仄仄。仄平仄仄仄仄，平平仄仄仄。,0,18,28,46,"[4, 3, 4, 6, 5, 6, 3, 4, 6, 5]"
渔家傲 ,晏殊,仄仄平平平仄仄。平平仄仄平平仄。平仄仄平平仄仄。平仄仄。平平仄仄平平仄。仄仄平平平仄仄。平平仄仄平平仄。仄仄仄平平仄仄。平仄仄。平平仄仄平平仄。,0,29,33,62,"[7, 7, 7, 3, 7, 7, 7, 7, 3, 7]"
渔家傲 ,周紫芝,仄仄平平平仄仄。平平仄仄平平仄。平仄平平平仄仄。平仄仄。仄平平仄平平仄。仄仄平平平仄仄。平平平仄平平仄。仄仄平平平仄仄。平仄仄。平平仄仄平平仄。,0,32,30,62,"[7, 7, 7, 3, 7, 7, 7, 7, 3, 7]"
渔家傲 ,杜安世,平仄平平仄仄平。平平仄仄仄平平。平仄仄平平仄仄。平平仄。仄平仄仄平平仄。平仄平平仄仄平。仄平平仄仄平平。仄仄平平平仄仄。平平仄。仄平平仄平平仄。,0,33,29,62,"[7, 7, 7, 3, 7, 7, 7, 7, 3, 7]"
渔家傲 ,蔡伸,平仄平平平仄仄。仄仄平平，仄仄平平仄。仄仄平平平仄仄。平平仄。平平仄仄平平仄。仄仄平平平仄仄。平仄平平，仄仄平平仄。仄仄平平平仄仄。平平仄。平平仄仄平平仄。,0,34,32,66,"[7, 4, 5, 7, 3, 7, 7, 4, 5, 7, 3, 7]"
苏幕遮 ,范仲淹,仄平平，平仄仄。平仄平平，平仄平平仄。平仄平平平仄仄。平仄平平，仄仄平平仄。仄平平，平仄仄。仄仄平平，仄仄平平仄。平仄平平平仄仄。仄仄平平，仄仄平平仄。,0,33,29,62,"[3, 3, 4, 5, 7, 4, 5, 3, 3, 4, 5, 7, 4, 5]"
摊破南乡子 ,程垓,平仄仄平平。平平仄、仄仄平平。仄平仄仄平平仄，仄平仄仄，仄平仄仄，仄仄平平。仄仄仄平平。平仄仄、仄仄平平。平平平仄平平仄，平平仄仄，仄平平仄，平仄平平。,0,31,31,62,"[5, 3, 4, 7, 4, 4, 4, 5, 3, 4, 7, 4, 4, 4]"
摊破南乡子 ,赵长卿,仄仄仄平平。平仄仄、仄仄平平。仄平仄仄平平仄，平平仄仄，平平仄仄，平仄平平。仄仄仄平平。平仄仄、平仄平平。仄平仄仄平平仄，仄平仄仄平平，仄平仄仄平平。,0,30,32,62,"[5, 3, 4, 7, 4, 4, 4, 5, 3, 4, 7, 6, 6]"
明月逐人来 ,李持正,平平平仄。平平平仄。平平仄、仄平平仄。仄平平仄，仄平平仄仄。仄仄平平仄仄。平仄平平，平仄仄平平仄。平平仄、平平仄仄。仄仄仄平，平仄平平仄。仄仄平平仄仄。,0,32,30,62,"[4, 4, 3, 4, 4, 5, 6, 4, 6, 3, 4, 4, 5, 6]"
甘州遍 ,毛文锡,平平仄，平仄仄平平。仄平平。平平仄仄，平平仄仄，平平仄仄仄平平。平仄仄，仄平平。平平仄仄平仄，平仄仄平平。仄平仄、仄仄仄平平。仄平平。平平仄仄，仄仄仄平平。,0,33,30,63,"[3, 5, 3, 4, 4, 7, 3, 3, 6, 5, 3, 5, 3, 4, 5]"
别怨 ,赵长卿,平仄平平。仄平平、平仄平平。仄平平仄仄，平平仄仄仄平平。仄仄平平仄仄平。仄仄平平仄，平平仄、仄仄平平。平平仄仄，平平平仄平平。仄平平仄仄，平仄仄、仄平平。,0,35,28,63,"[4, 3, 4, 5, 7, 7, 5, 3, 4, 4, 6, 5, 3, 3]"
麦秀两岐 ,和凝,平仄平平仄。平仄仄平仄。仄平平，平仄仄。平仄平平仄。仄平平仄平平仄。仄平平仄。平仄平平仄。仄仄平平仄。仄平平，平仄仄。仄仄平平仄。平平仄仄平平仄。仄平平仄。,0,33,31,64,"[5, 5, 3, 3, 5, 7, 4, 5, 5, 3, 3, 5, 7, 4]"
献衷心 ,欧阳炯,仄仄平平仄，平仄平平。平仄仄，仄平平。仄仄平平仄，平仄平平。平仄仄，平仄仄，仄平平。平仄仄，仄平平。仄平平仄仄平平。仄仄平平仄，平仄平平。平仄仄，平仄仄，仄平平。,0,33,31,64,"[5, 4, 3, 3, 5, 4, 3, 3, 3, 3, 3, 7, 5, 4, 3, 3, 3]"
献衷心 ,顾夐,仄平平仄仄，仄仄仄平平。平仄仄，仄平平。仄仄平平仄，仄平仄平平。平平仄，平仄仄，仄平平。仄平平仄，平仄平平。仄平平仄，仄仄平平。仄平平平仄，平仄平平。平平仄，平仄仄，仄平平。,0,37,32,69,"[5, 5, 3, 3, 5, 5, 3, 3, 3, 4, 4, 4, 4, 5, 4, 3, 3, 3]"
黄钟乐 ,魏承班,平平平仄仄平平。平仄平平平仄，平仄仄平平。平仄仄平平仄仄，平平平仄仄平平。平仄平平平仄平。平仄平平平仄，平仄仄平平。平仄平平平仄仄，仄平平仄仄平平。,0,40,24,64,"[7, 6, 5, 7, 7, 7, 6, 5, 7, 7]"
醉春风 ,赵德仁,仄仄平平仄。平平平仄仄。平平平仄仄平平，仄。仄。仄。平仄平平，仄平平仄，仄平平仄。仄仄平平仄。平仄平平仄。仄平平仄仄平平，仄。仄。仄。平仄平平，仄平平仄，仄平平仄。,0,33,31,64,"[5, 5, 7, 1, 1, 1, 4, 4, 4, 5, 5, 7, 1, 1, 1, 4, 4, 4]"
握金钗 ,吕渭老,平仄仄平平，平平仄平仄。仄平平仄平仄。仄仄平平仄平仄。平仄仄，仄平平，平仄仄。平仄仄平平，平平仄平仄。仄平仄仄平仄。仄仄平平仄仄仄。平仄仄，仄平平，平仄仄。,0,30,34,64,"[5, 5, 6, 7, 3, 3, 3, 5, 5, 6, 7, 3, 3, 3]"
握金钗 ,无名氏,平仄仄平平，平平平仄仄。平仄仄、仄平平仄。仄仄平平仄平仄。平仄仄，仄平平仄仄。仄仄仄平平，平平平仄仄。平仄仄、仄平平仄。仄仄平平仄平仄。平仄仄，仄平平仄仄。,0,29,35,64,"[5, 5, 3, 4, 7, 3, 5, 5, 5, 3, 4, 7, 3, 5]"
侍香金童 ,无名氏,仄平平仄，仄仄平平仄。仄仄平平平仄仄。平仄仄平平仄仄。仄仄平平，仄仄平仄。仄平平仄仄，仄平平仄仄。仄平仄、平平平仄仄。仄仄仄平平仄仄。平仄平平，仄平平仄。,0,28,36,64,"[4, 5, 7, 7, 4, 4, 5, 5, 3, 5, 7, 4, 4]"
侍香金童 ,蔡伸,仄仄平平，仄仄平平仄。仄仄仄、平平平仄仄。平仄仄平平仄仄。仄仄平平，仄平平仄。仄平平仄仄，平平平仄仄。仄仄仄、平平平仄。仄仄平平平仄仄。仄仄平平，仄平平仄。,0,29,35,64,"[4, 5, 3, 5, 7, 4, 4, 5, 5, 3, 4, 7, 4, 4]"
侍香金童 ,赵长卿,仄仄平平，仄仄平平仄。仄平仄、平平平仄仄。仄仄平平平仄仄。平仄平平，仄平平仄。仄仄平仄仄，平平平仄仄。仄仄仄、平平平仄仄。仄仄平平平仄仄。仄仄平平，仄平平仄。,0,30,35,65,"[4, 5, 3, 5, 7, 4, 4, 5, 5, 3, 5, 7, 4, 4]"
缑山月 ,梁寅,仄仄仄平平。平平仄仄平。平平平仄仄平平。仄平平仄仄，平仄仄，平平仄，仄平平。平平平仄平平仄，平仄仄平平。平平平仄仄平平。仄平平仄仄，平仄仄，平平仄，仄平平。,0,37,27,64,"[5, 5, 7, 5, 3, 3, 3, 7, 5, 7, 5, 3, 3, 3]"
喝火令 ,黄庭坚,仄仄平平仄，平平仄仄平。仄平平仄仄平平。平仄仄平平仄，平仄仄平平。仄仄平平仄，平平仄仄平。仄平平仄仄平平。仄仄平平，仄仄仄平平。仄仄仄平平仄，仄仄仄平平。,0,32,33,65,"[5, 5, 7, 6, 5, 5, 5, 7, 4, 5, 6, 5]"
芭蕉雨 ,程垓,仄仄平平仄仄。仄平平仄仄、平平仄。仄仄仄平平仄。仄仄仄仄平平，平平仄仄。仄平平仄仄仄。平仄仄平仄。平仄仄仄平、平平仄。仄仄仄、仄平平，平仄仄仄平平，平平仄仄。,0,27,38,65,"[6, 5, 3, 6, 6, 4, 6, 5, 5, 3, 3, 3, 6, 4]"
淡黄柳 ,姜夔,平平仄仄。平仄平平仄。仄仄平平平仄仄。仄仄平平仄仄。平仄平平仄平仄。仄平仄。平平仄平仄。仄平仄、仄平仄。仄平平、仄仄平平仄。仄仄平平，仄平平仄，平仄平平仄仄。,0,31,34,65,"[4, 5, 7, 6, 7, 3, 5, 3, 3, 3, 5, 4, 4, 6]"
淡黄柳 ,张炎,仄平仄仄。平仄平平仄。仄仄平平平仄仄。仄仄平平仄仄。平仄平平仄平仄。仄平仄。平平仄平仄。平仄仄、仄平仄。平平仄仄平平仄，平仄仄平平，仄平平仄，平仄平平仄仄。,0,31,34,65,"[4, 5, 7, 6, 7, 3, 5, 3, 3, 7, 5, 4, 6]"
淡黄柳 ,王沂孙,平平仄仄。平仄平平仄。仄仄平平平仄仄。仄仄平平平仄，平仄平平仄平仄。仄平仄。平平仄平仄。仄平仄、仄平仄。仄平平、仄仄平平仄，仄仄平平，仄平平仄，平仄平平仄仄。,0,32,33,65,"[4, 5, 7, 6, 7, 3, 5, 3, 3, 3, 5, 4, 4, 6]"
辊绣毬 ,赵长卿,平仄仄平平，平仄仄、平平平仄。仄平平仄，平平平仄，仄平平仄，仄平仄仄，仄平平仄。仄仄仄平平仄。平仄仄、仄平平仄。仄平平仄，仄平平仄，平平仄仄，平平仄仄，仄平平仄。,0,32,33,65,"[5, 3, 4, 4, 4, 4, 4, 4, 6, 3, 4, 4, 4, 4, 4, 4]"
锦缠道 ,宋祁,仄仄平平，仄仄仄平平仄。仄平平、仄平平仄。仄平平仄平平仄。仄仄平平，仄仄平平仄。仄平平仄平，仄平平仄。仄平平、仄平平仄。仄仄平、平仄平平仄，仄平平仄，仄仄平平仄。,0,33,33,66,"[4, 6, 3, 4, 7, 4, 5, 5, 4, 3, 4, 3, 5, 4, 5]"
锦缠道 ,无名氏,仄仄平平，仄仄仄平平仄。仄平仄、平平平仄。平平仄仄平平仄。仄仄平平，仄仄平平仄。仄平平仄平，仄平平仄。仄平平、仄平平仄。仄仄平、仄仄仄平平，仄平平仄仄，仄仄平平仄。,0,32,35,67,"[4, 6, 3, 4, 7, 4, 5, 5, 4, 3, 4, 3, 5, 5, 5]"
锦缠道 ,江衍,仄仄平平，仄仄仄平平仄。仄平仄平平平仄。仄平仄仄仄平平，仄平平仄，平仄平平仄。仄平平仄，平仄平平仄仄。仄平平、仄平平仄。仄平平仄仄平平，仄平平仄，平仄平平仄。,0,34,32,66,"[4, 6, 7, 7, 4, 5, 4, 6, 3, 4, 7, 4, 5]"
厌金杯 ,贺铸,平仄平平，平平仄仄。仄平平、仄平平仄。仄平平仄，仄仄仄平平，平仄仄。仄仄平平仄仄。仄仄平平，仄平平仄。仄平仄、仄平平仄。仄平仄仄，仄仄仄平平，平仄仄。平仄平平仄仄。,0,30,36,66,"[4, 4, 3, 4, 4, 5, 3, 6, 4, 4, 3, 4, 4, 5, 3, 6]"
庆春泽 ,张先,平仄平平平仄。平仄仄平平，仄平平仄。平仄仄平平，平平平仄。仄仄平平，仄平仄平仄。平平仄仄平仄。平平仄平平，平平平仄。平仄仄平平，平平平仄。仄仄平平，仄平仄平仄。,0,39,27,66,"[6, 5, 4, 5, 4, 4, 5, 6, 5, 4, 5, 4, 4, 5]"
庆春泽 ,张先,仄仄仄平平仄。平仄仄平平，仄平平仄。平仄仄平平，仄平平仄。仄仄平平，仄平仄平仄。平平仄仄平仄。平仄仄平平，仄平平仄。平仄仄，平平平平平仄。仄仄平仄，平平仄平仄。,0,34,32,66,"[6, 5, 4, 5, 4, 4, 5, 6, 5, 4, 3, 6, 4, 5]"
庆春泽 ,无名氏,仄平平，仄平平仄平，仄仄平仄。平仄仄仄，仄平平平仄。平平仄仄平平仄，仄平平、仄仄平仄。仄仄平平平，仄仄平平，仄平平仄。平仄仄平平，仄平平仄仄，平平平仄。平仄仄仄，仄平平平仄。平平仄仄平平仄，仄仄平、仄平平仄。仄仄平平平，平仄平平，仄平平仄。,0,51,47,98,"[3, 5, 4, 4, 5, 7, 3, 4, 5, 4, 4, 5, 5, 4, 4, 5, 7, 3, 4, 5, 4, 4]"
行香子 ,晁补之,平仄平平，平仄平平。仄平平仄仄平平。平平平仄，仄仄平平。仄平平仄，平平仄，仄平平。平平仄仄，平平平仄，仄平平平仄平平。平平平仄，仄仄平平。仄仄平平，仄平仄，仄平平。,0,41,25,66,"[4, 4, 7, 4, 4, 4, 3, 3, 4, 4, 7, 4, 4, 4, 3, 3]"
行香子 ,苏轼,平仄平平。平仄平平。平平仄、仄仄平平。仄平仄仄，仄仄平平。仄仄平平，平平仄，仄平平。平平平仄，平平平仄，仄平平、仄仄平平。仄平平仄，平仄平平。仄平平仄，平平仄，仄平平。,0,40,26,66,"[4, 4, 3, 4, 4, 4, 4, 3, 3, 4, 4, 3, 4, 4, 4, 4, 3, 3]"
行香子 ,苏轼,仄仄平平。平仄平平。仄平平、平仄平平。仄平平仄，平仄平平。仄平平仄，平平仄，仄平平。仄平仄仄，平仄平平。仄平平、仄仄平平。仄平平仄，仄仄平平。仄平平仄，平仄仄，仄平平。,0,38,28,66,"[4, 4, 3, 4, 4, 4, 4, 3, 3, 4, 4, 3, 4, 4, 4, 4, 3, 3]"
行香子 ,秦观,仄仄平平。仄仄平平。仄平平、平仄平平。仄平仄仄，平仄平平。仄平平平，仄平仄，仄平平。仄仄平平。仄仄平平。仄平平、平仄平平。仄平平仄，仄仄平平。仄平平平，仄平仄，仄平平。,0,38,28,66,"[4, 4, 3, 4, 4, 4, 4, 3, 3, 4, 4, 3, 4, 4, 4, 4, 3, 3]"
行香子 ,韩玉,仄仄平平，仄仄平平。仄平平、仄仄平平。平平仄仄，平仄平平。仄仄平平，平仄仄，仄平平。平仄平平。平仄平平。仄平平、仄仄平平。平平仄仄，平仄平平。仄仄平平，仄平仄，仄平平。,0,38,28,66,"[4, 4, 3, 4, 4, 4, 4, 3, 3, 4, 4, 3, 4, 4, 4, 4, 3, 3]"
行香子 ,杜安世,平平仄仄，仄仄平平。平仄仄、平仄平平。仄仄平平仄，平平仄平平。平平仄，平仄仄，仄平平。仄平平仄，仄仄平平。仄平平、仄仄平平。仄平平仄仄，仄平仄平平。平仄仄，仄平仄，仄平平。,0,36,32,68,"[4, 4, 3, 4, 5, 5, 3, 3, 3, 4, 4, 3, 4, 5, 5, 3, 3, 3]"
行香子 ,赵长卿,平仄平平。仄仄平平。仄平平、仄仄平平。仄平平仄，仄仄平平。仄平平，仄仄仄，仄平平。仄仄平平。平仄平平。仄平平、仄仄平平。仄平仄仄，平仄平平。仄平平，仄平仄，仄平平。,0,35,29,64,"[4, 4, 3, 4, 4, 4, 3, 3, 3, 4, 4, 3, 4, 4, 4, 3, 3, 3]"
行香子 ,李清照,仄仄平平。平仄平平。仄平平平仄平平。平平仄仄，平仄平平。仄平平平，平平仄，仄平平。平平仄仄，平平平仄，仄平平仄仄平平。平平仄仄，仄仄平平。仄仄仄平平，仄仄平仄，仄仄平平。,0,40,29,69,"[4, 4, 7, 4, 4, 4, 3, 3, 4, 4, 7, 4, 4, 5, 4, 4]"
酷相思 ,程垓,仄仄平平平仄仄。仄平仄、平平仄。仄平仄、平平平仄仄。仄仄仄、平平仄。仄仄仄、平平仄。仄仄平平平仄仄。仄仄仄、平平仄。仄平仄、平平平仄仄。平仄仄、平平仄。平仄仄、平平仄。,0,29,37,66,"[7, 3, 3, 3, 5, 3, 3, 3, 3, 7, 3, 3, 3, 5, 3, 3, 3, 3]"
解佩令 ,晏几道,仄平平仄，平平仄仄。平仄仄、平仄平仄。仄仄平平，仄仄仄、平平平仄。仄平平、仄平平仄。平平平仄，平平仄仄，仄平平、平平平仄。仄仄平平，仄平仄、平平平仄。仄平平、仄平平仄。,0,36,30,66,"[4, 4, 3, 4, 4, 3, 4, 3, 4, 4, 4, 3, 4, 4, 3, 4, 3, 4]"
解佩令 ,许冲元,仄平平仄，平仄平仄。平仄仄、平平平仄。仄仄平平，平仄平、仄平平仄。平平仄、平平平仄。平平仄仄，平平仄仄。仄平平、仄平仄仄。仄仄平平，仄仄仄、平平平仄。仄平平、仄平仄仄。,0,34,32,66,"[4, 4, 3, 4, 4, 3, 4, 3, 4, 4, 4, 3, 4, 4, 3, 4, 3, 4]"
解佩令 ,王庭珪,平平平仄，仄平平仄。仄平平、平平平仄。平仄平平，仄平仄、平平平仄。仄平平、仄平平仄。平平平仄。平平平仄。仄平平、仄平平仄。平仄平平，仄平仄、平平仄仄。仄平平、仄平平仄。,0,41,25,66,"[4, 4, 3, 4, 4, 3, 4, 3, 4, 4, 4, 3, 4, 4, 3, 4, 3, 4]"
解佩令 ,史达祖,平平平仄。平平平仄。仄平平、平平平仄。仄仄平平，仄仄仄、仄平平仄。仄平平、仄平仄仄。平平仄仄。平平仄仄。仄平平、平平平仄。仄仄平平，仄仄平、平平平仄。仄平平、仄平仄仄。,0,36,30,66,"[4, 4, 3, 4, 4, 3, 4, 3, 4, 4, 4, 3, 4, 4, 3, 4, 3, 4]"
解佩令 ,蒋捷,平平仄仄。平平仄仄。仄平平、平仄仄仄。平仄平平，仄仄平平平仄。仄平平、仄平仄仄。平平平仄。仄平平仄。仄平平、仄仄平仄。仄仄平平，仄仄仄仄平平仄。仄平平、仄仄仄仄。,0,30,35,65,"[4, 4, 3, 4, 4, 6, 3, 4, 4, 4, 3, 4, 4, 7, 3, 4]"
垂丝钓 ,周邦彦,仄平仄仄。平平平仄平仄。仄仄仄平，平仄平仄。平仄仄。仄仄平仄仄。平平仄。仄平平仄仄。仄平仄仄，平平平仄平仄。仄平仄仄。平仄平平仄。平仄平平仄。平仄仄。仄仄平仄仄。,0,28,38,66,"[4, 6, 4, 4, 3, 5, 3, 5, 4, 6, 4, 5, 5, 3, 5]"
垂丝钓 ,杨无咎,仄平仄仄。平平平仄平仄。仄仄仄平平，平仄仄。平仄仄。仄仄平仄仄。平平仄。仄平平仄仄。仄平仄仄，平平仄仄平仄。仄平仄仄。仄仄平平仄。平仄平平仄。平仄仄。仄仄平仄仄。,0,26,40,66,"[4, 6, 5, 3, 3, 5, 3, 5, 4, 6, 4, 5, 5, 3, 5]"
垂丝钓 ,吴文英,仄平仄仄，平平平仄平仄。仄仄仄平，仄仄平仄。平仄仄。仄仄平平仄。平平仄。仄仄平仄仄。仄平平仄，平平平仄平仄。仄平仄仄。平仄平平仄。平仄平平仄。平仄仄。仄仄平仄仄。,0,28,38,66,"[4, 6, 4, 4, 3, 5, 3, 5, 4, 6, 4, 5, 5, 3, 5]"
垂丝钓 ,袁去华,平平平仄。仄平平仄平仄。仄仄平平，仄仄平平仄。平平仄。仄仄平平仄。平平仄。仄平平仄仄，平平仄仄，平平平仄平仄。仄平仄仄。仄仄平平仄。平仄平平仄。平仄仄。仄仄平仄仄。,0,32,35,67,"[4, 6, 4, 5, 3, 5, 3, 5, 4, 6, 4, 5, 5, 3, 5]"
谢池春 ,陆游,仄仄平平，平仄仄平平仄。仄平平、平平仄仄。平平平仄，仄平平平仄。仄平平、仄平平仄。平平仄仄，仄仄平平平仄。仄平平、平平仄仄。平平平仄，仄平平平仄。仄平平、仄平平仄。,0,38,28,66,"[4, 6, 3, 4, 4, 5, 3, 4, 4, 6, 3, 4, 4, 5, 3, 4]"
谢池春 ,刘因,仄仄平平，仄仄仄平平仄。仄平平、平平仄仄。仄平平仄。平平平仄。仄平平、仄平平仄。平平仄仄，仄仄仄平平仄。仄平平、平平仄仄。平平平仄。平平平仄。仄平平、仄平平仄。,0,35,29,64,"[4, 6, 3, 4, 4, 4, 3, 4, 4, 6, 3, 4, 4, 4, 3, 4]"
谢池春 ,无名氏,仄仄平平，仄平平仄。仄平仄、仄平平仄。仄平仄仄仄，平平平仄。仄平平、仄平平仄。仄平仄仄，仄平仄、平平仄。仄仄仄、平平平仄。仄平仄仄仄，平平平仄。仄仄平、仄平仄仄。,0,28,36,64,"[4, 4, 3, 4, 5, 4, 3, 4, 4, 3, 3, 3, 4, 5, 4, 3, 4]"
胜胜令 ,曹勛,平平平仄，仄仄平平。仄平平仄仄平平。平平仄仄，仄平平，仄平平。仄仄仄、平仄仄平。仄仄平平，仄仄仄，仄平平。仄平平仄仄平平。平平仄仄，仄平平，仄平平。仄仄平、平仄仄平。,0,34,32,66,"[4, 4, 7, 4, 3, 3, 3, 4, 4, 3, 3, 7, 4, 3, 3, 3, 4]"
胜胜令 ,俞克成,平平仄仄，平仄平平。仄平平仄仄平平。平平仄仄，仄平仄，仄平平。仄仄平、平仄仄平。平仄平平。平仄仄，仄平平。仄平平仄仄平平。平平仄仄，仄平平。仄平平。仄仄平、仄仄仄平。,0,35,31,66,"[4, 4, 7, 4, 3, 3, 3, 4, 4, 3, 3, 7, 4, 3, 3, 3, 4]"
玉梅令 ,姜夔,平平仄仄。仄仄平平仄。平平仄、仄平平仄。仄仄平仄仄，仄仄仄平平，平仄仄，仄平仄仄。平平仄仄，平仄平平仄。平平仄、仄平仄仄。仄仄平平仄，仄仄仄平平，平仄仄、仄平平仄。,0,28,38,66,"[4, 5, 3, 4, 5, 5, 3, 4, 4, 5, 3, 4, 5, 5, 3, 4]"
青玉案 ,贺铸,平平仄仄平平仄。仄仄仄、平平仄。仄仄平平平仄仄。仄平平仄，仄平平仄。平仄平平仄。仄平仄仄平平仄。仄仄平平仄平仄。仄仄平平平仄仄。仄平平仄，仄平平仄。平仄平平仄。,0,32,35,67,"[7, 3, 3, 7, 4, 4, 5, 7, 7, 7, 4, 4, 5]"
青玉案 ,苏轼,平平仄仄平平仄。仄平仄、平平仄。仄仄平平平仄仄。仄平平仄，仄平仄仄，仄仄平平仄。仄平平仄平平仄。平仄平平仄平仄。仄仄平平平仄仄。平平平仄，仄平平仄，平仄平平仄。,0,34,33,67,"[7, 3, 3, 7, 4, 4, 5, 7, 7, 7, 4, 4, 5]"
青玉案 ,李弥逊,平平仄仄平平仄。仄仄仄、平平仄。平仄平平平仄仄。平平仄仄，仄仄平平，平仄平平仄。仄平平仄平平仄。仄仄仄、平平仄平仄。仄仄平平平仄仄。仄平平仄，平仄平平，仄仄平平仄。,0,34,34,68,"[7, 3, 3, 7, 4, 4, 5, 7, 3, 5, 7, 4, 4, 5]"
青玉案 ,毛滂,平平平仄平平仄。仄仄仄、平平仄。平仄平平平仄仄。仄平平仄，仄平平仄，仄仄平平仄。仄平平仄平平仄。仄仄仄、平平仄。仄仄仄平平仄仄。仄平平仄，平平仄仄，平仄平平仄。,0,32,34,66,"[7, 3, 3, 7, 4, 4, 5, 7, 3, 3, 7, 4, 4, 5]"
青玉案 ,史达祖,仄平仄仄平平仄。仄仄仄、平平仄。仄仄仄平平仄仄。平平平仄，仄平平仄。平仄平平仄。平平仄仄平平仄。仄平仄、平平仄。平仄平平平仄仄。平平平仄，仄平平仄。平仄仄平仄。,0,33,33,66,"[7, 3, 3, 7, 4, 4, 5, 7, 3, 3, 7, 4, 4, 5]"
青玉案 ,张炎,仄平平仄平平仄。仄仄仄、平平仄。仄仄平平平仄仄。平平仄仄。平平仄仄。平仄平平仄。仄平仄仄平平仄。仄平仄、平平仄。仄仄仄平平仄仄。平平平仄。平平仄仄。仄仄平平仄。,0,31,35,66,"[7, 3, 3, 7, 4, 4, 5, 7, 3, 3, 7, 4, 4, 5]"
青玉案 ,吴潜,平平平仄平平仄。平仄平平仄平仄。仄仄仄平平仄仄。仄平平仄，仄平平仄，平仄平平仄。仄平仄仄平平仄。仄仄平平仄平仄。平仄仄平平仄仄。仄平平仄，仄平平仄，平仄平平仄。,0,34,34,68,"[7, 7, 7, 4, 4, 5, 7, 7, 7, 4, 4, 5]"
青玉案 ,胡铨,平平平仄平平仄。仄仄仄仄平平仄。平仄平平平仄仄。仄平平仄，仄平平仄，仄仄平平仄。仄平平仄平平仄。仄仄仄、平平仄平仄。仄仄平平平仄仄。仄平平仄，仄平平仄，平仄平平仄。,0,34,35,69,"[7, 7, 7, 4, 4, 5, 7, 3, 5, 7, 4, 4, 5]"
青玉案 ,李清照,平平仄仄平平仄。仄仄平平平仄。平平平平平仄仄。平平仄仄，仄平平仄，仄仄平平仄。平平仄仄平平仄。平仄平平仄平仄。平仄平平平仄仄。平平平仄，仄平平仄，仄仄平平仄。,0,37,30,67,"[7, 6, 7, 4, 4, 5, 7, 7, 7, 4, 4, 5]"
青玉案 ,曹组,仄平仄仄平平仄。仄仄仄平平仄。仄仄平平平仄仄。仄平平仄，仄平平仄，仄仄平平仄。平平仄仄平平仄。仄平仄、平平仄平仄。平仄平平平仄仄。仄平平仄，仄平平仄，仄仄平平仄。,0,32,36,68,"[7, 6, 7, 4, 4, 5, 7, 3, 5, 7, 4, 4, 5]"
青玉案 ,毛滂,平平仄仄平平仄。仄仄仄、平平仄。仄仄平平平平仄。平平平仄仄平仄。仄平仄、平平仄。平平仄仄平平仄。仄仄仄、平平仄仄仄。仄仄平平仄平仄。仄仄平平仄仄仄。仄仄仄、平平仄。,0,30,38,68,"[7, 3, 3, 7, 7, 3, 3, 7, 3, 5, 7, 7, 3, 3]"
青玉案 ,赵长卿,仄平平仄平平仄。仄仄平平仄。平仄仄平平仄仄。平平仄仄，仄平平仄。仄仄平平仄。仄平平仄平平仄。仄仄平平仄平仄。平仄平平平仄仄。平平仄仄，仄平仄仄。仄仄平平仄。,0,31,35,66,"[7, 5, 7, 4, 4, 5, 7, 7, 7, 4, 4, 5]"
青玉案 ,赵长卿,平平仄仄平平仄。仄仄平平仄平仄。平仄平平平仄仄。仄平平仄仄平平，仄仄仄、平平仄。仄平平仄平平仄。仄仄平平平仄仄。仄仄平平平仄仄。仄平平仄，仄平仄仄，仄仄平平仄。,0,32,36,68,"[7, 7, 7, 7, 3, 3, 7, 7, 7, 4, 4, 5]"
感皇恩 ,毛滂,仄仄仄平平，平平仄仄。平仄平平仄平仄。仄平仄仄，仄仄平平平仄。仄平平仄仄，平平仄。平仄平平，平平仄仄。仄仄平平仄平仄。仄平平仄，平仄仄平平仄。仄平平仄仄，平平仄。,0,33,34,67,"[5, 4, 7, 4, 6, 5, 3, 4, 4, 7, 4, 6, 5, 3]"
感皇恩 ,晁冲之,平仄仄平平，平平平仄。仄仄平平仄。平仄。仄平平仄，平仄仄平平仄。平平平仄仄，平平仄。仄仄仄平，平平仄仄。平仄平平仄。平仄。仄平平仄，仄仄仄平平仄。仄平平仄仄，平平仄。,0,34,33,67,"[5, 4, 5, 2, 4, 6, 5, 3, 4, 4, 5, 2, 4, 6, 5, 3]"
感皇恩 ,贺铸,平仄仄平平，平平平仄。平仄平平仄。平仄。仄平平仄，仄仄平平平仄。仄平平仄仄。平平仄。平仄仄平，平平平仄。平仄平平仄。平仄。仄平平仄，仄仄仄平平仄。仄平平仄仄。平平仄。,0,36,31,67,"[5, 4, 5, 2, 4, 6, 5, 3, 4, 4, 5, 2, 4, 6, 5, 3]"
感皇恩 ,周邦彦,仄仄仄平平，平平平仄。仄仄平平仄平仄。仄平平仄，仄仄仄平平仄。仄平平仄仄，平平仄。仄平仄仄，平平平仄。平仄平平仄平仄。仄平平仄，仄仄平平平仄。仄仄平、平仄仄，平平仄。,0,33,35,68,"[5, 4, 7, 4, 6, 5, 3, 4, 4, 7, 4, 6, 3, 3, 3]"
感皇恩 ,周紫芝,平仄仄平平，仄平平仄。仄仄平平仄平仄。平平平仄，仄平平平仄仄。仄平平仄仄，平平仄。仄仄仄平，仄仄平平仄。仄仄平平仄仄仄。仄平仄仄，平仄平平仄仄。平平平仄仄，仄仄仄。,0,30,38,68,"[5, 4, 7, 4, 6, 5, 3, 4, 5, 7, 4, 6, 5, 3]"
感皇恩 ,赵长卿,仄仄仄平平，平平平仄。仄仄平平仄平仄。平平仄仄，仄平平平平仄。仄平平仄平平仄。仄仄平平，平平平仄。仄仄平平仄平仄。仄平平仄，仄仄平平平仄。仄平平仄平平仄。,0,35,30,65,"[5, 4, 7, 4, 6, 7, 4, 4, 7, 4, 6, 7]"
感皇恩 ,汪莘,平仄平平，仄平平仄。平仄平平仄平仄。平平仄仄，仄仄仄平平仄。仄平平仄仄，平平仄。仄仄平平，仄平平仄。仄仄平平仄平仄。仄平平仄，平仄平平仄仄。仄平平仄仄，平平仄。,0,33,33,66,"[4, 4, 7, 4, 6, 5, 3, 4, 4, 7, 4, 6, 5, 3]"
钿带长中调 ,万俟咏,仄仄平。仄平平。仄平平、仄仄平。仄仄平平，仄仄仄平。平平仄仄，仄仄平仄平。仄仄仄平平平。仄仄平平仄仄，平仄平平。仄平仄、仄仄仄平。平平仄仄，仄平仄仄平。仄仄仄仄平平。,0,29,38,67,"[3, 3, 3, 3, 4, 4, 4, 5, 6, 6, 4, 3, 4, 4, 5, 6]"
梦行云 ,吴文英,仄平仄平仄。平平仄。平仄仄。平平仄仄，仄平平平仄。仄平平仄平平仄，平平平仄仄。仄平仄仄，平平平仄，平平仄，平仄仄。平平平仄，仄平仄平仄。仄平平仄平平仄，仄平平仄仄。,0,35,32,67,"[5, 3, 3, 4, 5, 7, 5, 4, 4, 3, 3, 4, 5, 7, 5]"
三奠子 ,王恽,仄平平仄仄，平仄平平。平仄仄，仄平平。平平平仄仄，平仄仄平平。仄平仄，平仄仄，仄平平。平平仄仄，平仄平平。平仄仄，仄平平。平平平仄仄，平仄仄平平。平仄仄，平平仄，仄平平。,0,37,30,67,"[5, 4, 3, 3, 5, 5, 3, 3, 3, 4, 4, 3, 3, 5, 5, 3, 3, 3]"
凤凰阁 ,柳永,平平平仄，仄仄平平仄仄。仄平平仄平平仄。平仄平平仄仄，平平平仄。仄仄仄、平平仄仄。平平平仄，仄仄平平仄仄。仄平平仄平平仄。平仄仄仄平仄，平仄平仄。仄平仄、平平仄仄。,0,33,35,68,"[4, 6, 7, 6, 4, 3, 4, 4, 6, 7, 6, 4, 3, 4]"
凤凰阁 ,叶清臣,仄平平仄仄，平平仄仄。仄平仄仄仄平仄。仄仄平平仄仄，仄仄平仄。仄仄仄、平平仄仄。平平平仄，仄仄平平仄仄。仄平平仄仄平仄。平仄仄、仄平平，仄仄平仄。仄仄仄、平平仄仄。,0,25,42,67,"[5, 4, 7, 6, 4, 3, 4, 4, 6, 7, 3, 3, 4, 3, 4]"
凤凰阁 ,赵师侠,仄平平平仄，平平仄仄。仄平平仄仄平仄。仄仄平平仄仄，仄仄平仄。仄平仄、平平仄仄。平平平仄，仄仄平平仄仄。仄平平仄仄平仄。仄仄平平，仄仄仄平平仄。仄仄仄、平平仄仄。,0,28,39,67,"[5, 4, 7, 6, 4, 3, 4, 4, 6, 7, 4, 6, 3, 4]"
看花回 ,柳永,仄仄平平仄仄平。平仄平平。仄平平仄平平仄，仄仄平、仄仄平平。仄平平仄仄，平仄平平。仄仄平平仄仄平。仄仄平平。仄平平仄平平仄，仄平平、仄仄仄平。仄平平仄仄，平仄平平。,0,35,33,68,"[7, 4, 7, 3, 4, 5, 4, 7, 4, 7, 3, 4, 5, 4]"
看花回 ,柳永,仄仄平平仄仄平。平仄平平。仄平平仄平平仄，仄仄平、仄仄平平。平平平仄仄，仄仄平平。平仄平平仄仄平。仄仄平平。仄平平仄平平仄，平平仄仄平平。仄平平仄仄，平仄平平。,0,37,30,67,"[7, 4, 7, 3, 4, 5, 4, 7, 4, 7, 6, 5, 4]"
看花回 ,黄庭坚,仄仄平平，平仄仄仄平仄。仄仄仄平仄仄，仄仄平平仄，平仄平仄。平仄仄平，仄仄平平平仄仄。平仄仄、仄仄平平，仄仄平仄仄平仄。平仄仄、平平仄仄。仄仄仄、仄平平仄。平仄平平仄仄，仄平仄仄平，平仄平仄。仄仄平平，仄平平平平平仄。仄平平、仄平仄，仄平平平仄。,0,44,57,101,"[4, 6, 6, 5, 4, 4, 7, 3, 4, 7, 3, 4, 3, 4, 6, 5, 4, 4, 7, 3, 3, 5]"
看花回 ,周邦彦,仄平平仄平仄，仄仄平仄。仄仄仄平仄仄，仄仄仄平平，平仄平仄。平平仄仄，平仄平平平仄仄。平仄仄、仄仄平平，仄平平仄仄平仄。平仄仄、平平仄仄。仄仄仄、仄平平仄。平仄平平仄仄，仄仄仄平平，仄仄平仄。平平仄仄，平仄平平平仄仄。仄平平、仄平仄，仄仄平平仄。,0,43,58,101,"[6, 4, 6, 5, 4, 4, 7, 3, 4, 7, 3, 4, 3, 4, 6, 5, 4, 4, 7, 3, 3, 5]"
看花回 ,蔡伸,仄仄平平平仄，仄平平仄。仄仄仄平仄仄，仄仄仄平平，仄平平仄。平平仄平仄仄，平平平仄仄。平仄仄、仄仄平平，仄平平仄仄平仄。仄仄仄、平平仄仄。仄平仄、仄平平仄。平仄平平仄仄，仄仄仄平平，平平平仄。仄仄平平仄仄，平平平仄仄。仄平平、仄平仄，仄仄平平仄。,0,45,56,101,"[6, 4, 6, 5, 4, 6, 5, 3, 4, 7, 3, 4, 3, 4, 6, 5, 4, 6, 5, 3, 3, 5]"
看花回 ,赵彦端,仄仄。仄平平仄仄，平平平仄。仄仄仄平仄仄。仄仄仄平平，平平平仄。平平仄仄平仄，平平仄仄仄。平仄仄、仄仄平平，仄平平仄仄平仄。平仄仄、平平仄仄。仄平仄、仄平平仄。平仄平平仄仄，仄平仄平仄，平平平仄。平平仄平平仄，平平仄平仄。仄平平、仄平平仄，仄仄平平仄。,0,49,54,103,"[2, 5, 4, 6, 5, 4, 6, 5, 3, 4, 7, 3, 4, 3, 4, 6, 5, 4, 6, 5, 3, 4, 5]"
看花回 ,赵彦端,仄仄。仄平平仄仄，平平平仄。仄平仄平仄仄。仄平仄平平，平平平仄。平平仄仄，平仄仄平平仄仄。平仄仄、平仄平平，仄平仄仄仄平仄。平仄仄平平仄仄。仄仄仄、仄平平仄。平仄平平仄仄，仄仄仄平平，平平平仄。平平仄平，平仄平平仄仄仄。仄平平、仄平平仄，仄仄仄、平平仄。,0,49,55,104,"[2, 5, 4, 6, 5, 4, 4, 7, 3, 4, 7, 7, 3, 4, 6, 5, 4, 4, 7, 3, 4, 3, 3]"
看花回 ,赵彦端,平仄仄，平平平仄，平平平仄。仄仄平平仄仄。仄平仄平平，平平平仄。平平平仄，仄仄平平平仄仄。平仄仄、仄仄平平，仄平平平仄平仄。仄平仄、平平仄仄。仄仄仄、平平平仄。平仄平平仄仄，仄仄仄平平，平平平仄。平平仄仄，平仄平平平仄仄。仄平平，仄平平仄，仄仄仄平平仄。,0,54,50,104,"[3, 4, 4, 6, 5, 4, 4, 7, 3, 4, 7, 3, 4, 3, 4, 6, 5, 4, 4, 7, 3, 4, 6]"
殢人娇 ,晏殊,仄仄平平，仄仄平平仄仄。仄平仄、仄平平仄。平平仄仄，仄仄平平仄。平仄仄、平平仄平仄仄。仄仄平平，仄平平仄。平平仄、仄平平仄。平平仄仄，仄仄平平仄。平仄仄、仄平平平平仄。,0,32,36,68,"[4, 6, 3, 4, 4, 5, 3, 6, 4, 4, 3, 4, 4, 5, 3, 6]"
殢人娇 ,杨无咎,仄仄平平，仄仄平平仄仄。仄平平、仄平平仄。平平平仄，仄仄平平仄。仄仄仄平平，仄平平仄。仄仄平平，仄平平仄。平仄仄、仄平平仄。仄平平仄，仄平平平仄。仄仄仄平平，仄平平仄。,0,33,35,68,"[4, 6, 3, 4, 4, 5, 5, 4, 4, 4, 3, 4, 4, 5, 5, 4]"
殢人娇 ,王庭珪,仄仄平平，平仄仄平平仄。平平仄、仄平仄仄。平平平仄，仄平平平仄。平仄仄平平、仄平平仄。平仄仄平平仄仄。仄平仄、平平仄仄。平平仄仄，仄仄平平仄。平仄仄平平、仄平仄仄。,0,33,34,67,"[4, 6, 3, 4, 4, 5, 5, 4, 7, 3, 4, 4, 5, 5, 4]"
殢人娇 ,张智宗,平仄平平，平平仄仄。平平仄、平平平仄。平平平仄，仄平平仄仄。仄仄仄、平平仄平平仄。平仄平平，平平仄仄。仄平平、平平仄仄。平平平仄，仄仄平平仄。仄仄仄、平平仄平平仄。,0,37,29,66,"[4, 4, 3, 4, 4, 5, 3, 6, 4, 4, 3, 4, 4, 5, 3, 6]"
殢人娇 ,毛滂,仄仄平平，平平平仄。平仄仄、仄平平仄。仄平仄仄，平平仄仄。仄仄仄、仄平仄平平仄。平仄平平，平平仄仄。平平仄、仄平平仄。仄平平仄，平平仄仄。仄仄仄、平平仄平仄仄。,0,30,34,64,"[4, 4, 3, 4, 4, 4, 3, 6, 4, 4, 3, 4, 4, 4, 3, 6]"
两同心 ,柳永,仄仄平平，仄平平仄。平平仄、平仄平平，平仄仄、仄平平仄。仄平平，仄仄平平，仄仄平仄。仄仄仄平平仄。仄平平仄。平平仄、仄仄平平，仄平仄、仄平平仄。仄仄平，仄仄平平，仄平平仄。,0,33,35,68,"[4, 4, 3, 4, 3, 4, 3, 4, 4, 6, 4, 3, 4, 3, 4, 3, 4, 4]"
两同心 ,杨无咎,平仄平平，仄平平仄。仄仄仄、平仄平平，平平仄、平平平仄。平平仄。平仄平平，仄平平仄。仄仄平平仄仄。仄平平仄。平平仄、平仄平平，平平仄、仄平平仄。平平仄。仄仄平平，仄平平仄。,0,39,29,68,"[4, 4, 3, 4, 3, 4, 3, 4, 4, 6, 4, 3, 4, 3, 4, 3, 4, 4]"
两同心 ,柳永,平平仄仄。仄平仄仄。仄平仄、平仄平平，仄平仄、仄平平仄。平平仄。平仄平平，平平平仄。平仄仄平平仄。仄平平仄。平仄仄、平仄平平，仄平仄、仄平平仄。平平仄。仄仄平平，仄平平仄。,0,36,32,68,"[4, 4, 3, 4, 3, 4, 3, 4, 4, 6, 4, 3, 4, 3, 4, 3, 4, 4]"
两同心 ,晏几道,仄平平仄，仄仄平平。仄仄仄、仄平平仄，仄平仄、仄仄平平。平平仄，仄仄平平，平仄平平。仄仄仄仄平平。仄仄平平。仄仄仄、平平平仄，仄平仄、仄仄平平。平平仄，仄仄平平，平仄平平。,0,33,35,68,"[4, 4, 3, 4, 3, 4, 3, 4, 4, 6, 4, 3, 4, 3, 4, 3, 4, 4]"
两同心 ,黄庭坚,仄仄平平。平仄平平。仄仄仄、平平平仄，平平仄、平仄平平。平平仄，仄仄平平，平仄平平。仄平平仄平平。平仄平平。仄仄仄、平平平仄，仄仄仄、平仄平平。平平仄，平仄平平，仄仄平平。,0,40,28,68,"[4, 4, 3, 4, 3, 4, 3, 4, 4, 6, 4, 3, 4, 3, 4, 3, 4, 4]"
两同心 ,杜安世,平平仄仄，平平仄平平。仄平仄、仄仄平平。仄平仄、仄仄平平。仄仄平仄，平平平仄，仄仄平平。仄仄平仄平平。平平平平仄。仄平仄、仄平平平。平仄仄、仄仄平仄。仄平仄仄，仄仄平平，仄仄平平。,0,36,36,72,"[4, 5, 3, 4, 3, 4, 4, 4, 4, 6, 5, 3, 4, 3, 4, 4, 4, 4]"
拾翠羽 ,张孝祥,平仄平平，平仄仄平平仄。仄平平、仄平平仄。平平仄仄，仄平平仄。平仄仄，平仄仄平平仄。仄仄平平，平仄仄平平仄。仄平平、仄平平仄。平平平仄，仄平平仄。平仄平，平仄仄平平仄。,0,37,31,68,"[4, 6, 3, 4, 4, 4, 3, 6, 4, 6, 3, 4, 4, 4, 3, 6]"
连理枝 ,李白,仄仄平平仄。平仄平平仄。仄仄平平，平平仄仄，平平平仄。仄仄平平仄、仄平平，仄平平仄仄。仄仄平平仄。仄仄平平仄。仄仄平平，平平仄仄，仄平平仄。仄仄平平仄、仄平平，仄平平仄仄。,0,34,36,70,"[5, 5, 4, 4, 4, 5, 3, 5, 5, 5, 4, 4, 4, 5, 3, 5]"
连理枝 ,邵叔齐,仄仄平平仄。仄仄平平仄。仄仄平平平平仄，仄仄仄平平仄。仄平平平仄、仄平平，仄平平平仄。仄仄平平仄。仄仄平平仄。仄仄仄平平平仄，仄仄平平平仄。仄平平平仄、仄平平，仄平平平仄。,0,36,36,72,"[5, 5, 7, 6, 5, 3, 5, 5, 5, 7, 6, 5, 3, 5]"
月上海棠 ,无名氏,平平仄仄平平仄。仄平平、平平仄平仄。仄平仄仄，仄平平、仄平平仄。平平仄，仄仄平平仄仄。平平仄仄平平仄。仄仄平、平平仄仄仄。仄平平仄，仄平平、仄平平仄。仄平平，平仄平平仄仄。,0,36,34,70,"[7, 3, 5, 4, 3, 4, 3, 6, 7, 3, 5, 4, 3, 4, 3, 6]"
月上海棠 ,段克己,仄平仄仄平平仄。仄仄仄平平、仄平仄。仄仄仄平平，仄平平、仄平平仄。平仄仄，仄仄平平仄仄。仄平仄仄平平仄。仄平仄平平、仄平仄。平仄仄平平，仄平平、仄平平仄。平平仄，仄仄平平仄仄。,0,33,39,72,"[7, 5, 3, 5, 3, 4, 3, 6, 7, 5, 3, 5, 3, 4, 3, 6]"
月上海棠 ,段成己,仄平平仄平平仄。仄仄平平仄平仄。仄仄仄平平，平仄仄平平仄。平平仄，仄仄平平仄仄。平平仄仄平平仄。仄仄仄平平、仄平仄。平仄仄平平，仄仄仄、平平平仄。平平仄，仄仄平平仄仄。,0,33,37,70,"[7, 7, 5, 6, 3, 6, 7, 5, 3, 5, 3, 4, 3, 6]"
月上海棠 ,姜夔,平平仄仄，仄仄平平仄，仄仄平仄。仄平平平仄，仄平平仄。仄平仄仄平平，平仄仄、仄平平仄。平平仄，仄仄仄仄，仄平平仄。平仄。平平仄，仄平仄，平仄平仄平仄。仄平平仄仄，仄平平仄。仄仄仄仄平平，仄平平，仄平平仄。平平仄，平仄平平仄仄。,0,42,49,91,"[4, 5, 4, 5, 4, 6, 3, 4, 3, 4, 4, 2, 3, 3, 6, 5, 4, 6, 3, 4, 3, 6]"
月上海棠 ,陈允平,平平仄仄，仄平平仄，仄平平平仄。仄平平平仄，仄平平仄。仄平仄仄平平，平平平、仄平平仄。平平仄，平仄平平，仄平平仄。平仄。平平仄仄，仄仄平平，仄平平仄。仄平平平仄，仄平平仄。仄平仄仄平平，平平仄，仄平平仄。平平仄，平平平平仄仄。,0,52,39,91,"[4, 4, 5, 5, 4, 6, 3, 4, 3, 4, 4, 2, 4, 4, 4, 5, 4, 6, 3, 4, 3, 6]"
惜黄花 ,史达祖,平平平仄。仄平平仄。仄平平，仄平平、仄平平仄。平仄仄平平，仄仄平平仄。仄仄仄、仄平平仄。平平平仄。仄平仄仄。仄平平，仄平平、仄平平仄。仄仄仄平平，平仄平平仄。仄仄仄、仄平平仄。,0,35,35,70,"[4, 4, 3, 3, 4, 5, 5, 3, 4, 4, 4, 3, 3, 4, 5, 5, 3, 4]"
惜黄花 ,许冲元,仄平仄仄。平平平仄。仄仄平平，平平仄，仄仄仄。平仄平平仄，平仄平平仄。仄平仄、仄平平仄。平仄平平，平平平仄。仄仄平平，平平仄，仄平仄。仄仄平平仄，仄仄平平仄。仄平仄、仄平平仄。,0,35,35,70,"[4, 4, 4, 3, 3, 5, 5, 3, 4, 4, 4, 4, 3, 3, 5, 5, 3, 4]"
且坐令 ,韩玉,平仄仄。仄仄平平仄。仄平仄仄平平仄。仄仄平平仄。仄仄平平，平平仄仄，平平仄仄。平仄仄、仄平平仄。平平仄、仄平仄。平平平仄平平仄。仄仄仄、平平仄。仄平平仄平平仄。仄平平平仄。,0,34,36,70,"[3, 5, 7, 5, 4, 4, 4, 3, 4, 3, 3, 7, 3, 3, 7, 5]"
佳人醉 ,柳永,仄仄平平仄仄。平仄平平平仄。仄仄平平仄。平平平仄，仄仄平仄。仄仄平平仄仄，仄平平平仄。平平仄。仄平平仄。平仄仄平，仄仄平平平仄，平仄平平仄。仄平仄。平平平仄。仄仄平平仄仄。,0,35,36,71,"[6, 6, 5, 4, 4, 6, 5, 3, 4, 4, 6, 5, 3, 4, 6]"
西施 ,柳永,仄平平仄仄平平。仄仄仄平平。仄平平仄，仄仄仄平平。仄仄平平，仄仄平平仄，仄仄仄平平。仄平仄仄平平仄，平平仄、仄平平。仄平仄仄，平仄仄平平。仄仄平平，仄仄平平仄，仄平仄平平。,0,34,37,71,"[7, 5, 4, 5, 4, 5, 5, 7, 3, 3, 4, 5, 4, 5, 5]"
西施 ,柳永,仄平平仄仄平平。仄仄仄平平。仄平仄仄仄，仄仄仄平平。仄仄平平仄仄，平仄仄，仄平仄平平。仄平平仄平平仄，仄平仄、仄平平。仄平仄仄仄，平仄仄平平。仄仄平平平仄，平平仄，仄平仄平平。,0,34,39,73,"[7, 5, 5, 5, 6, 3, 5, 7, 3, 3, 5, 5, 6, 3, 5]"
小镇西犯 ,柳永,仄平平仄仄，平平仄仄。平平仄、仄平平仄。平仄平平仄仄。仄平平仄。平仄仄，平平平仄仄。仄平仄。仄平平仄仄，平平仄仄。仄平平、仄平平仄。仄仄平平平仄。仄仄平仄。平平仄，仄仄平平仄。,0,34,37,71,"[5, 4, 3, 4, 6, 4, 3, 5, 3, 5, 4, 3, 4, 6, 4, 3, 5]"
小镇西犯 ,柳永,仄平仄仄平，平平仄仄。平平仄、仄平平仄。仄平仄。仄仄平、仄仄平平，仄仄平平，仄平平仄，仄平平仄。仄平仄。仄平平仄仄，平平仄仄。平平仄、仄平平仄。仄平仄。仄平平仄仄，仄平仄仄，平平仄仄，平仄仄平平仄。,0,36,43,79,"[5, 4, 3, 4, 3, 3, 4, 4, 4, 4, 3, 5, 4, 3, 4, 3, 5, 4, 4, 6]"
小镇西犯 ,蔡伸,平平平仄，仄平平平仄。平平仄、仄平平仄。平平仄。仄平平仄仄，仄仄平平，平平仄仄。平平仄平平仄。仄仄仄。平平平仄仄，平平仄仄。仄平仄、仄平平仄。仄平仄。仄平平仄仄，平仄平平，平平仄仄。平平仄平平仄。,0,42,37,79,"[4, 5, 3, 4, 3, 5, 4, 4, 6, 3, 5, 4, 3, 4, 3, 5, 4, 4, 6]"
千秋岁 ,秦观,仄平平仄。平仄平平仄。平仄仄，平平仄。平平平仄仄，平仄平平仄。平仄仄，仄平仄仄平平仄。仄仄平平仄。平仄平平仄。平仄仄，平平仄。仄平平仄仄，仄仄平平仄。平仄仄，仄平仄仄平平仄。,0,34,37,71,"[4, 5, 3, 3, 5, 5, 3, 7, 5, 5, 3, 3, 5, 5, 3, 7]"
千秋岁 ,周紫芝,仄平平仄。平仄平平仄。平仄仄，平平仄。平平平仄仄，仄仄平平仄。平仄仄。平平仄仄平平仄。仄仄平平仄。平仄平平仄。平仄仄，平平仄。平平平仄仄，平仄平平仄。平仄仄。平平仄仄平平仄。,0,37,34,71,"[4, 5, 3, 3, 5, 5, 3, 7, 5, 5, 3, 3, 5, 5, 3, 7]"
千秋岁 ,石孝友,平平仄仄。平仄平平仄。平仄仄。平平仄。平平平仄仄，平仄平平仄。平仄仄。平平平仄平平仄。平仄平平仄。平仄平平仄。平仄仄。平平仄。平平平仄仄，仄仄平平仄。平仄仄。平平仄仄平平仄。,0,39,32,71,"[4, 5, 3, 3, 5, 5, 3, 7, 5, 5, 3, 3, 5, 5, 3, 7]"
千秋岁 ,叶梦得,仄平平仄，平仄平平仄。平仄仄，平平仄。平平平仄仄，仄仄平平仄。平仄仄。平平仄仄平平仄。仄仄平平仄。仄仄平平仄。仄仄仄，平平仄。仄平平仄仄，仄仄平平仄。平仄仄。仄平平仄平平仄。,0,33,38,71,"[4, 5, 3, 3, 5, 5, 3, 7, 5, 5, 3, 3, 5, 5, 3, 7]"
千秋岁 ,晁补之,仄平平仄，平仄平平仄。平仄仄，平平仄。平平平仄仄，仄仄平平仄。平仄仄，平平仄仄平平仄。仄仄平平仄，平仄平平仄。平仄仄，平平仄。平平平仄仄，仄仄平平仄。平仄仄，平平仄仄平平仄。,0,36,35,71,"[4, 5, 3, 3, 5, 5, 3, 7, 5, 5, 3, 3, 5, 5, 3, 7]"
千秋岁 ,欧阳修,仄平平仄。仄仄平平仄。仄平仄仄平平仄。仄平平仄仄，平仄平平仄。仄平仄，平平仄仄平平仄。仄仄平平仄。仄仄平平仄。平仄仄，平平仄。平仄平平仄，平仄平平仄。仄仄仄，平平仄仄平平仄。,0,34,38,72,"[4, 5, 7, 5, 5, 3, 7, 5, 5, 3, 3, 5, 5, 3, 7]"
千秋岁 ,叶梦得,仄平平仄。平仄平平仄。仄平仄仄平平仄。仄平平仄仄，仄仄平平仄。平仄仄。平平仄仄平平仄。平仄平平仄。仄仄平平仄。平仄仄，平平仄。平平平仄仄，仄仄平平仄。平仄仄。平平仄仄平平仄。,0,35,37,72,"[4, 5, 7, 5, 5, 3, 7, 5, 5, 3, 3, 5, 5, 3, 7]"
千秋岁 ,无名氏,仄平平仄。平仄平平仄。仄平仄仄平平仄。仄平平仄仄，平仄平平仄。仄仄仄，平平仄仄平平仄。仄仄平平仄，仄仄平平仄。仄仄仄，平仄仄。仄平平仄仄，平仄平平仄。平仄仄，平平仄仄平平仄。,0,32,40,72,"[4, 5, 7, 5, 5, 3, 7, 5, 5, 3, 3, 5, 5, 3, 7]"
惜奴娇 ,晁补之,平仄平平，仄仄平平仄。仄平平、平平仄仄。仄仄平平，仄平仄、平平仄。仄仄。仄仄平、平平仄仄。平仄平平，仄仄仄、平平仄。仄平仄、仄平平仄。仄仄平平，平平仄、平平仄。仄仄。仄仄仄、平平仄仄。,0,33,38,71,"[4, 5, 3, 4, 4, 3, 3, 2, 3, 4, 4, 3, 3, 3, 4, 4, 3, 3, 2, 3, 4]"
惜奴娇 ,史达祖,平仄平平，仄仄仄、平平仄。平平仄、平平仄仄。仄仄平平，仄仄仄、平平仄。平仄。仄平平、平平仄仄。平仄平平，仄仄仄、平平仄。平平仄、平平仄仄。仄仄平平，仄仄仄、平平仄。仄仄。平仄仄、平平仄仄。,0,34,38,72,"[4, 3, 3, 3, 4, 4, 3, 3, 2, 3, 4, 4, 3, 3, 3, 4, 4, 3, 3, 2, 3, 4]"
惜奴娇 ,无名氏,仄平仄仄，仄仄平平仄。仄平仄、仄仄仄仄。仄仄平平，仄仄平平仄仄。仄仄仄，平平仄、仄平仄。仄仄平平，仄仄平平仄仄。仄平平、平仄平仄。仄仄平仄，仄仄平平平仄。仄平仄，平仄仄、仄平仄。,0,26,45,71,"[4, 5, 3, 4, 4, 6, 3, 3, 3, 4, 6, 3, 4, 4, 6, 3, 3, 3]"
惜奴娇 ,无名氏,仄平平仄。仄仄平平仄仄。仄仄平平平仄。仄平仄、仄平仄。仄仄平平，平仄平平仄仄。仄仄。仄仄平仄仄平仄。仄平平仄。平平仄仄。仄仄平平平仄。仄平平、平平仄。仄平平仄，平仄仄平平仄。平仄。平平平仄仄平仄。,0,37,43,80,"[4, 6, 6, 3, 3, 4, 6, 2, 7, 4, 4, 6, 3, 3, 4, 6, 2, 7]"
惜奴娇 ,无名氏,平仄平平平仄。平仄平平仄平仄。平仄平平，仄仄仄仄，仄仄平平平仄。仄仄平平，平仄平平仄平仄。仄平平、平仄平平，仄仄仄平仄。平仄。仄仄平平仄。仄平平、仄仄平平仄。平仄平平，仄仄仄仄，仄仄平平平仄。仄仄平平，平仄平平仄平仄。仄平仄、仄仄平平，仄仄平平仄。,0,50,52,102,"[6, 7, 4, 4, 6, 4, 7, 3, 4, 5, 2, 5, 3, 5, 4, 4, 6, 4, 7, 3, 4, 5]"
卓牌子近 ,袁去华,仄仄平平，仄平仄仄平仄。平仄仄、平平平仄。平仄仄仄平平，平仄平仄。平仄仄仄平仄，平仄仄。平平仄。仄仄平平平仄。平仄仄平平，仄平仄仄。仄仄平平，平平仄仄仄仄。仄平仄、仄平平仄。,0,32,39,71,"[4, 6, 3, 4, 6, 4, 6, 3, 3, 6, 5, 4, 4, 6, 3, 4]"
三登乐 ,范成大,仄仄平平，平仄仄、平平平仄。仄平平、仄平仄仄。仄平平、平仄仄，仄平平仄。平仄仄平，仄平仄仄。仄平平平仄仄，仄平平仄。仄平平、仄平仄仄。仄平平、仄仄仄，仄平平仄。平仄仄平，仄平仄仄。,0,32,39,71,"[4, 3, 4, 3, 4, 3, 3, 4, 4, 4, 6, 4, 3, 4, 3, 3, 4, 4, 4]"
三登乐 ,罗子衎,仄仄平平，仄仄仄平仄平，仄平平仄仄仄仄。平仄仄平平，仄仄平平仄仄。仄平平仄，平平仄仄。仄平平仄仄。仄仄平平，仄平仄仄平平仄。仄平平、仄平仄，仄平平仄仄。平平仄仄，仄平平仄仄。,0,31,41,72,"[4, 6, 7, 5, 6, 4, 4, 5, 4, 7, 3, 3, 5, 4, 5]"
檐前铁 ,无名氏,仄平平，仄仄平平，平平仄仄。仄平平、仄仄仄平平，平仄仄平平仄。平平仄，平平仄，仄仄仄、平平仄。平平仄、仄平平，仄仄平平平仄。平平仄、仄平平仄平平仄。仄仄平平，仄仄仄平平，平仄仄。,0,37,34,71,"[3, 4, 4, 3, 5, 6, 3, 3, 3, 3, 3, 3, 6, 3, 7, 4, 5, 3]"
甘露歌 ,王安石,仄仄仄平平仄仄。平平平仄仄。平仄平平仄仄平。平仄仄平平。仄仄平平平仄仄。平平仄仄仄。仄仄平平平仄平。平仄仄平平。平平仄仄平仄仄。仄仄平平仄。平仄仄平平仄平。平仄仄平平。,0,36,36,72,"[7, 5, 7, 5, 7, 5, 7, 5, 7, 5, 7, 5]"
忆帝京 ,柳永,仄平仄仄平平仄。仄仄仄平平仄。仄仄仄平平，仄仄平平仄。仄仄仄平平，仄仄平平仄。仄仄仄、仄平平仄。仄平仄、仄平平仄。仄仄平平，平平平仄，仄仄仄仄平平仄。仄仄仄平平，仄仄平平仄。,0,29,43,72,"[7, 6, 5, 5, 5, 5, 3, 4, 3, 4, 4, 4, 7, 5, 5]"
忆帝京 ,黄庭坚,平仄平平平平仄。平仄仄、平平仄。平仄仄平平，仄仄仄、平平仄。仄仄仄平平，仄仄仄、平平仄。平仄仄、平平平仄。仄平仄、仄平平仄。仄仄平平平平仄。仄平平，平仄仄平平仄。仄仄平平仄。仄仄仄、平仄仄。,0,36,40,76,"[7, 3, 3, 5, 3, 3, 5, 3, 3, 3, 4, 3, 4, 7, 3, 6, 5, 3, 3]"
于飞乐 ,晏几道,仄仄平平，仄平平仄平平。平平仄仄平平。仄平平，平仄仄，仄仄平平。平平仄仄，仄仄平、仄仄平平。仄仄平平，平平平仄，平平仄仄平平。仄平平，平仄仄，平仄平平。平平仄仄，平平仄、仄仄平平。,0,41,31,72,"[4, 6, 6, 3, 3, 4, 4, 3, 4, 4, 4, 6, 3, 3, 4, 4, 3, 4]"
于飞乐 ,张先,仄平平，平仄仄，仄仄平平。平平仄、仄仄平平。仄平平，平仄仄，平仄平平。平平平仄，仄平平、平仄平平。仄平平，仄仄平平。平平仄、仄仄平平。仄平平平仄，仄仄仄平平。平平平仄，仄平平、仄仄平平。,0,43,30,73,"[3, 3, 4, 3, 4, 3, 3, 4, 4, 3, 4, 3, 4, 3, 4, 5, 5, 4, 3, 4]"
于飞乐 ,毛滂,仄平平，平仄仄，平仄平平。仄平平、平仄平平。仄平平，平仄仄，平仄平平。仄平仄仄，平平仄、平仄平平。仄平平，平仄仄，仄仄平平。仄平平、仄仄平平。仄平平，平仄仄，平仄平平。仄平仄仄，仄平仄、平仄平平。,0,43,33,76,"[3, 3, 4, 3, 4, 3, 3, 4, 4, 3, 4, 3, 3, 4, 3, 4, 3, 3, 4, 4, 3, 4]"
撼庭竹 ,黄庭坚,平仄平平平仄平。平平仄平平。仄平平仄仄平平。仄平平仄仄平平。仄仄仄平仄，平仄仄平平。仄仄仄平仄仄平。平仄仄平平。平平仄仄平平仄。仄仄平平仄平平。平仄仄平仄，平仄仄平平。,0,39,33,72,"[7, 5, 7, 7, 5, 5, 7, 5, 7, 7, 5, 5]"
撼庭竹 ,王诜,仄仄平平仄平仄。平仄仄平仄。平平仄仄平平仄。仄平平仄仄平仄。平仄仄平平，平仄仄平仄。仄仄平平平仄仄，平平仄平仄。仄平仄仄平平仄。平平仄仄仄平仄。平仄仄平平，平仄平平仄。,0,35,37,72,"[7, 5, 7, 7, 5, 5, 7, 5, 7, 7, 5, 5]"
粉蝶儿 ,毛滂,仄仄平平，仄平平仄平仄。仄平平、仄平平仄。仄平平，平仄仄，平平平仄。仄平平，平仄仄平平仄。仄平仄平，平平仄平平仄。仄平平、仄平仄仄。仄平平，平仄仄，平平仄仄。仄仄平，仄平仄平平仄。,0,38,34,72,"[4, 6, 3, 4, 3, 3, 4, 3, 6, 4, 6, 3, 4, 3, 3, 4, 3, 6]"
粉蝶儿 ,曹冠,仄仄平平，平仄仄平平仄。仄平平、仄平平仄。仄平平仄仄，平仄平平仄。仄平平，平仄仄平平仄。平仄平平，仄平仄平平仄。仄平平、仄平平仄。仄平平平仄，仄仄平平仄。仄平平，仄仄仄平平仄。,0,38,34,72,"[4, 6, 3, 4, 5, 5, 3, 6, 4, 6, 3, 4, 5, 5, 3, 6]"
绕池游 ,无名氏,仄平平仄，仄仄平平平仄。平仄仄，平平仄平仄。平平仄仄，平仄平平平仄。仄平平仄。仄平仄仄。平平仄仄。仄仄平平平仄。平平仄，平平仄平仄。平平平仄。仄仄平平平仄。仄仄平仄，仄平仄仄。,0,36,36,72,"[4, 6, 3, 5, 4, 6, 4, 4, 4, 6, 3, 5, 4, 6, 4, 4]"
师师令 ,张先,平平仄仄。仄平平平仄。仄平平仄仄平平，仄仄仄、平平平仄。仄仄平平平仄仄。仄仄平平仄。平平平仄平平仄。仄平平平仄。仄平平仄仄平平，平仄仄、仄平平仄。仄仄平平平仄仄。仄仄平平仄。,0,37,36,73,"[4, 5, 7, 3, 4, 7, 5, 7, 5, 7, 3, 4, 7, 5]"
隔浦莲近拍 ,周邦彦,平平平仄仄仄。仄仄平平仄。仄仄平平仄，平平仄，平平仄。平仄平仄仄。平平仄。仄仄平平仄。仄平仄。平平仄仄，平平平仄平仄。平平仄仄，仄仄仄平平仄。平仄平平仄仄仄。平仄。平平平仄平仄。,0,36,37,73,"[6, 5, 5, 3, 3, 5, 3, 5, 3, 4, 6, 4, 6, 7, 2, 6]"
隔浦莲近拍 ,赵彦端,平平平仄仄仄。仄平平平仄。仄仄平平仄，平平平仄平仄。平仄平仄仄。平平仄。仄仄平平仄。仄平仄。平平仄仄，平平平仄平仄。平平平仄，仄仄平平平仄。仄仄平平仄仄仄。仄仄。平平平仄平仄。,0,37,36,73,"[6, 5, 5, 6, 5, 3, 5, 3, 4, 6, 4, 6, 7, 2, 6]"
隔浦莲近拍 ,吴文英,平平平仄仄仄。平仄平平仄。仄仄平平仄，平平仄，平平仄。平仄平仄仄。平平仄，仄仄平平仄。仄平仄。平平仄仄，平平仄仄平仄。仄平平仄，仄仄平平平仄。平仄平平仄仄仄。平仄。平平平仄仄仄。,0,36,37,73,"[6, 5, 5, 3, 3, 5, 3, 5, 3, 4, 6, 4, 6, 7, 2, 6]"
隔浦莲近拍 ,陆游,平平平仄仄仄。仄仄平平仄。仄仄平平仄，平平平仄平仄。平仄平平仄。平平仄，仄仄平平仄。仄平仄。平平仄仄，平平仄仄平仄。平平仄仄，仄仄仄平平仄。仄仄平平仄仄仄。平仄。平平平仄平仄。,0,35,38,73,"[6, 5, 5, 6, 5, 3, 5, 3, 4, 6, 4, 6, 7, 2, 6]"
隔浦莲近拍 ,彭元逊,仄平平仄平仄。仄仄平平仄。仄仄仄平仄。仄平平仄仄仄。仄仄平仄仄。平平仄，平仄仄平仄。平平仄。平平仄平，仄平仄仄平仄。平平仄仄，仄仄仄平平仄。仄仄平平仄仄仄。平仄，仄平仄仄平仄。,0,29,44,73,"[6, 5, 5, 6, 5, 3, 5, 3, 4, 6, 4, 6, 7, 2, 6]"
郭郎儿近拍 ,柳永,仄仄。平平仄仄平平，平仄平平平仄仄。平仄。仄仄平仄。平平平仄平平，仄仄平平平仄仄。平仄。仄仄平平，仄仄仄仄平仄。仄仄平平，平平仄仄，仄平平仄仄。仄平平、仄仄平平，平仄平平平仄仄。,0,36,37,73,"[2, 6, 7, 2, 4, 6, 7, 2, 4, 6, 4, 4, 5, 3, 4, 7]"
临江仙引 ,柳永,仄仄，仄仄，平仄仄，仄平平。平平仄仄平平。仄仄平平仄，仄平仄平平。平平仄仄，仄仄仄平，平仄仄平平。平平仄平平仄仄，平平仄仄平平。仄仄平平仄，仄平仄平平。平平仄仄仄仄，仄仄仄仄平平。,0,35,39,74,"[2, 2, 3, 3, 6, 5, 5, 4, 4, 5, 7, 6, 5, 5, 6, 6]"
临江仙引 ,柳永,仄仄。仄仄。平平仄，仄平平。平平仄仄平平。仄仄平平仄，仄平仄平平。仄平平仄，仄仄仄仄，平仄仄平平。仄仄平平平仄仄，平平仄仄平平。仄仄平平仄，仄平仄平平。平平仄仄仄仄，仄平仄仄平平。,0,35,39,74,"[2, 2, 3, 3, 6, 5, 5, 4, 4, 5, 7, 6, 5, 5, 6, 6]"
碧牡丹 ,晏几道,仄仄平平仄。平仄平平仄。仄仄平平，仄仄平平平仄。仄仄平平，平仄平平仄。仄平平仄平仄。仄平仄。仄仄平仄仄。平平仄平平仄。仄仄平平，仄仄仄平平仄。仄仄平平，平仄平平仄。平平平仄平仄。,0,37,37,74,"[5, 5, 4, 6, 4, 5, 6, 3, 5, 6, 4, 6, 4, 5, 6]"
碧牡丹 ,程垓,仄仄平平仄。仄仄仄，平平仄。仄仄平平，仄仄仄平平仄。仄仄平平，仄仄平平仄。仄平平，仄平仄。仄平仄。仄仄平平仄。平平仄平平仄。仄仄平平，仄平仄仄平仄。仄仄平平，仄仄平平仄。仄平平，仄平仄。,0,33,42,75,"[5, 3, 3, 4, 6, 4, 5, 3, 3, 3, 5, 6, 4, 6, 4, 5, 3, 3]"
百媚娘 ,张先,平仄仄平平仄。仄仄仄平平仄。仄仄仄平平仄仄，仄仄仄平平仄。仄仄平平平仄仄。平仄平平仄。仄仄仄平平仄。仄仄仄平平仄。仄仄仄平平仄仄，平仄仄平平仄。仄仄仄平平仄仄。平仄平平仄。,0,29,45,74,"[6, 6, 7, 6, 7, 5, 6, 6, 7, 6, 7, 5]"
风入松 ,晏几道,仄平平仄仄平平。平仄平平。仄平仄仄平平仄，仄平平、仄仄平平。平仄仄平平仄，仄平平仄平平。仄平平仄仄平平。仄仄平平。仄平平仄平平仄，仄平平、仄仄平平。仄仄仄平平仄，仄平仄仄平平。,0,40,34,74,"[7, 4, 7, 3, 4, 6, 6, 7, 4, 7, 3, 4, 6, 6]"
风入松 ,赵彦端,平平平仄仄平平。仄仄平平。仄平仄仄平平仄，平平仄仄平平。仄仄仄平平仄，平平仄仄平平。平平平仄仄平平。仄仄平平。平平平仄平平仄，平平仄仄平平。仄仄仄平平仄，平平平仄平平。,0,43,29,72,"[7, 4, 7, 6, 6, 6, 7, 4, 7, 6, 6, 6]"
风入松 ,康与之,仄平平仄仄平平。仄仄平平。仄平仄仄平平仄，仄平平仄平平。平仄平平平仄，平平平仄平平。仄平平仄仄平平。仄仄平平。仄平仄仄平平仄，仄平平、平仄平平。平仄仄平平仄，平平仄仄平平。,0,43,30,73,"[7, 4, 7, 6, 6, 6, 7, 4, 7, 3, 4, 6, 6]"
风入松 ,吴文英,仄平平仄仄平平。平仄仄平平。仄平仄仄平平仄，仄仄平、平仄平平。平仄仄平平仄，仄平平仄平平。平平平仄仄平平。平仄仄平平。平平平仄平平仄，仄平平、平仄平平。平仄平平平仄，仄平平仄平平。,0,47,29,76,"[7, 5, 7, 3, 4, 6, 6, 7, 5, 7, 3, 4, 6, 6]"
传言玉女 ,晁冲之,仄仄平平，仄仄仄平平仄。仄平平仄，仄平平仄仄。平仄仄仄，仄仄平平平仄。平平平仄，仄平平仄。仄仄平平，仄平平、仄仄仄。仄平平仄，仄平平仄仄。平平仄平，仄仄仄平平仄。平平平仄，仄平平仄。,0,35,39,74,"[4, 6, 4, 5, 4, 6, 4, 4, 4, 3, 3, 4, 5, 4, 6, 4, 4]"
传言玉女 ,曾觌,仄仄平平，平仄仄平平仄。仄仄平平，仄平平平仄。平平仄仄，仄仄平平平仄。平平仄仄，仄平平仄。仄仄平平，仄仄仄平平仄。平平仄仄，仄平平平仄。平平仄仄，仄仄仄平平仄。平平仄仄，仄平平仄。,0,36,38,74,"[4, 6, 4, 5, 4, 6, 4, 4, 4, 6, 4, 5, 4, 6, 4, 4]"
传言玉女 ,《乐府雅词》袁裪,平仄平平，仄仄仄平平仄。仄平仄仄，仄平平仄仄。平平仄仄，仄仄平平平仄。平平平仄，仄平平仄。仄仄平平，仄平仄仄仄。仄平平仄，仄平平仄仄。仄仄仄平，仄仄平平平仄。平平平仄，仄平平仄。,0,34,39,73,"[4, 6, 4, 5, 4, 6, 4, 4, 4, 5, 4, 5, 4, 6, 4, 4]"
枕屏儿 ,无名氏,平仄平平，平仄仄平仄仄。仄平平，平仄仄，平平仄仄。平仄仄，平平仄，仄平平仄。平平平、仄平仄仄。平仄平平，平仄仄平平仄。仄平平，平仄仄，平平仄仄。仄平平，平仄仄，仄平平仄。仄平仄、仄平仄仄。,0,37,37,74,"[4, 6, 3, 3, 4, 3, 3, 4, 3, 4, 4, 6, 3, 3, 4, 3, 3, 4, 3, 4]"
剔银灯 ,柳永,平仄平平仄仄。仄仄仄、仄平平仄。仄仄平平，平平平仄，仄仄仄平平仄。平平平仄。仄仄仄、仄平平仄。仄仄平平平仄。仄仄平平平仄。仄平仄平，平平仄仄，仄仄平平平仄。平平平仄。仄平仄、仄平平仄。,0,36,39,75,"[6, 3, 4, 4, 4, 6, 4, 3, 4, 6, 6, 4, 4, 6, 4, 3, 4]"
剔银灯 ,毛滂,平仄平平仄仄。平仄仄平平仄。平仄平平，仄平仄仄，平仄平平平仄。仄平平仄。仄平仄、平平仄仄。仄仄平平仄仄。仄仄仄平平仄。平仄平平，仄平平仄，仄仄平平平仄。平平仄仄。仄仄仄、平平仄仄。,0,35,39,74,"[6, 6, 4, 4, 6, 4, 3, 4, 6, 6, 4, 4, 6, 4, 3, 4]"
剔银灯 ,杜安世,仄仄平平仄仄。仄仄仄、平平平仄。仄仄平平，平平仄仄，仄仄平平平仄。平平仄仄。仄仄仄、平平仄仄。平仄仄平平仄。仄平仄、平平平仄。仄仄平平，平平平仄，仄仄平平平仄。仄平平仄。仄平仄、仄平平仄。,0,36,40,76,"[6, 3, 4, 4, 4, 6, 4, 3, 4, 6, 3, 4, 4, 4, 6, 4, 3, 4]"
剔银灯 ,范仲淹,仄仄平平仄仄。仄平仄、平平平仄。仄仄平平，平平平仄，仄仄平平平仄。仄仄仄平平，平平仄、平平仄仄。平仄平平仄仄。仄平仄、仄平平仄。仄仄平平，平仄仄平，仄仄平平平仄。仄仄仄平平，仄仄仄、平平平仄。,0,38,40,78,"[6, 3, 4, 4, 4, 6, 5, 3, 4, 6, 3, 4, 4, 4, 6, 5, 3, 4]"
剔银灯 ,衷长吉,仄平仄仄平平仄。平仄仄平平仄。仄仄仄平，仄平仄仄，平仄仄、平平仄仄。平平仄仄。仄平仄、仄平仄仄。平平仄仄平平仄。平仄仄平仄仄。仄仄仄平，平平仄仄，仄仄仄、仄平平仄。仄平平仄。仄仄仄、平平仄仄。,0,30,48,78,"[7, 6, 4, 4, 3, 4, 4, 3, 4, 7, 6, 4, 4, 3, 4, 4, 3, 4]"
隔帘听 ,柳永,仄仄仄平平仄，仄仄平平仄。平平仄仄平平仄。仄仄仄平平，仄平仄仄。仄仄仄。仄平平、仄平平仄。平平仄。平平平仄。仄仄平平仄。平平仄仄平平仄。仄仄平平仄，仄平平仄。仄平仄。平平仄、仄平平仄。,0,35,40,75,"[6, 5, 7, 5, 4, 3, 3, 4, 3, 4, 5, 7, 5, 4, 3, 3, 4]"
越溪春 ,欧阳修,平仄仄平平仄仄，平仄仄平平。仄平仄仄平平仄，仄仄平、平仄平平。平仄平平，平平仄仄，平仄平平。平平仄仄平平。平仄仄平平。仄平平仄仄仄仄仄，平平仄仄平平。平仄仄平平仄仄，平仄仄平平。,0,40,35,75,"[7, 5, 7, 3, 4, 4, 4, 4, 6, 5, 8, 6, 7, 5]"
长生乐 ,晏殊,仄仄平平仄仄平。平仄仄平平。仄平平仄，仄仄仄平平。仄仄平平平仄，平仄平平。平平仄仄，平仄平平仄平平。平平仄仄，仄仄平平。平平仄仄平平。平仄仄、仄仄仄平平。仄平平仄平仄，平仄仄平平。,0,40,35,75,"[7, 5, 4, 5, 6, 4, 4, 7, 4, 4, 6, 3, 5, 6, 5]"
长生乐 ,晏殊,仄仄平平平仄仄，仄仄仄平平。仄平平仄，仄平平平平。仄仄平平平仄，平仄平平。平平平仄，仄仄平平仄平平。平平仄仄，仄仄平平。仄仄平平仄仄平。平仄平仄仄平平。仄平平仄平仄，仄平仄平平。,0,41,34,75,"[7, 5, 4, 5, 6, 4, 4, 7, 4, 4, 7, 7, 6, 5]"
诉衷情近 ,柳永,仄平仄仄，仄仄平平仄仄。平平仄仄平平，平仄仄平仄仄。平仄仄平平仄，仄仄平平，仄仄平平仄。平平仄。仄仄平平仄仄。仄平平仄，仄仄平平仄。平平仄。仄平仄仄，平平仄仄，仄平平仄。仄仄平平仄。,0,33,42,75,"[4, 6, 6, 6, 6, 4, 5, 3, 6, 4, 5, 3, 4, 4, 4, 5]"
诉衷情近 ,柳永,仄平仄仄，仄仄平平仄仄，平平平仄平平，平仄仄平仄仄。平仄仄平平仄，平仄平平，仄仄平平仄。平平仄。仄仄平平仄仄。仄平平仄，仄仄平平仄。平平仄。仄平仄仄，平平仄仄，仄平平仄。仄仄平平仄。,0,35,40,75,"[4, 6, 6, 6, 6, 4, 5, 3, 6, 4, 5, 3, 4, 4, 4, 5]"
诉衷情近 ,晁补之,仄平仄仄，仄仄平平仄仄。平平仄仄平平，平仄仄平仄仄。平仄仄平，平平平仄，平平仄仄平平仄。仄平仄。仄仄平平仄仄。仄平平仄，仄仄平平仄。平平仄。仄平仄仄，平平仄仄，仄平仄仄。仄仄平平仄。,0,33,42,75,"[4, 6, 6, 6, 4, 4, 7, 3, 6, 4, 5, 3, 4, 4, 4, 5]"
下水船 ,黄庭坚,仄仄平平仄。平仄平平平仄。平仄平平，仄仄仄平平仄。仄平仄。仄仄平平仄仄，仄仄平平平仄。平平仄。仄仄平平仄。平仄平平平仄。仄仄平平，平平仄仄平仄。平平仄。平仄平平仄仄，平仄平平平仄。,0,39,36,75,"[5, 6, 4, 6, 3, 6, 6, 3, 5, 6, 4, 6, 3, 6, 6]"
下水船 ,贺铸,平仄平平仄。平仄平平平仄。平仄平平，平平仄平平仄。平仄仄。平仄平平仄仄。平仄平平平仄。平平仄。仄仄平平仄。平仄平平仄仄。平仄平平，平平仄平平仄。仄平仄。仄仄平平平仄，平仄平平平仄。,0,44,31,75,"[5, 6, 4, 6, 3, 6, 6, 3, 5, 6, 4, 6, 3, 6, 6]"
下水船 ,晁补之,仄仄平平仄。平仄平平仄仄。仄仄平平，平平仄平仄仄。仄仄仄，仄仄平平平仄，平仄平平平仄。仄平仄，平仄平平仄，仄仄平平平仄。平仄平平平平，仄平仄仄。仄仄仄，仄仄平平平仄。平仄平平平仄。,0,37,38,75,"[5, 6, 4, 6, 3, 6, 6, 3, 5, 6, 6, 4, 3, 6, 6]"
下水船 ,晁补之,仄仄平平仄。平仄平平仄仄。仄仄平平，平平仄仄平仄。仄平仄。平仄平平仄仄。平平仄仄平仄。仄平仄，仄仄平平仄。平仄平平平仄仄。仄仄平平，平平仄仄平仄。仄平仄。平仄平平仄仄。平仄平平仄仄。,0,36,40,76,"[5, 6, 4, 6, 3, 6, 6, 3, 5, 7, 4, 6, 3, 6, 6]"
解蹀躞 ,周邦彦,仄仄平平平仄，平仄平平仄。仄平平仄、平平仄平仄。平仄仄仄平平，仄平仄仄平平，仄平平仄。仄平仄。平仄平平平仄。平平仄平仄。仄平平仄、平平仄平仄。仄仄平仄平平，仄平平仄平平，仄平平仄。,0,41,34,75,"[6, 5, 4, 5, 6, 6, 4, 3, 6, 5, 4, 5, 6, 6, 4]"
解蹀躞 ,杨无咎,仄仄平平平仄。平仄平平仄。仄平平仄、平平仄平仄。仄仄仄仄平平，仄平平仄平平，仄平平仄。仄平仄。平仄平平平仄。平平仄平仄。仄平平仄、平平仄平仄。仄仄平仄平平，仄平平仄平平，仄平平仄。,0,41,34,75,"[6, 5, 4, 5, 6, 6, 4, 3, 6, 5, 4, 5, 6, 6, 4]"
解蹀躞 ,吴文英,仄平仄平仄仄，仄仄平平仄。仄平平仄平平、仄平仄。平仄仄仄平平，仄平仄仄平平，仄平平仄。仄平仄。平仄平平平仄，平平仄平仄。仄平平仄平平、仄平仄。仄仄平仄平平，仄平平仄平平，仄平平仄。,0,39,36,75,"[6, 5, 6, 3, 6, 6, 4, 3, 6, 5, 6, 3, 6, 6, 4]"
解蹀躞 ,方千里,仄仄平平平仄，仄仄平平仄。仄平平仄、平平仄平仄。仄仄仄仄平平，仄平仄仄，平仄仄平平仄。仄平仄。仄仄平平平仄。平平仄平仄。仄平平仄、平平仄平仄。仄仄平仄平平，仄平平仄平平，仄平平仄。,0,37,38,75,"[6, 5, 4, 5, 6, 4, 6, 3, 6, 5, 4, 5, 6, 6, 4]"
解蹀躞 ,曹勛,仄仄平平平仄，仄仄平平仄。仄仄平平、平平仄平仄。平仄平仄平平，平平仄仄，平仄仄平平仄。仄平仄。平仄平平平仄。仄仄仄平仄。仄平平仄、平平仄平仄。平仄平仄平平，仄平平仄，平仄仄平平仄。,0,39,36,75,"[6, 5, 4, 5, 6, 4, 6, 3, 6, 5, 4, 5, 6, 4, 6]"
解蹀躞 ,杨无咎,平仄平平平仄，仄仄平平仄。仄平平仄、平平仄平仄。仄仄平仄平平，仄平仄仄，平仄仄、平平仄。仄平仄。仄仄平平平仄。平平仄平仄。仄平平仄平平、仄平仄。仄平平仄平平，仄平平仄，平仄仄、平平仄。,0,39,36,75,"[6, 5, 4, 5, 6, 4, 3, 3, 3, 6, 5, 6, 3, 6, 4, 3, 3]"
扑蝴蝶 ,曹组,平平仄仄，平平平仄仄。平平仄仄，仄平平仄仄。仄平仄仄平平，仄仄平平仄仄，平平仄平仄仄。仄平仄。仄平平仄，仄平平仄仄。平平仄仄，平平仄仄仄。仄仄仄仄平平，仄仄平平仄仄，平平仄平平仄。,0,34,41,75,"[4, 5, 4, 5, 6, 6, 6, 3, 4, 5, 4, 5, 6, 6, 6]"
扑蝴蝶 ,赵师侠,平平平仄，平平平仄仄。平平仄仄，平平平仄仄。仄平平仄平平，仄仄平平仄仄。平平仄平平仄。仄平仄。平平仄仄，平平平仄仄。平平仄仄，平平平仄仄。仄平仄仄平平，仄仄平平仄仄。平平仄仄平仄。,0,40,35,75,"[4, 5, 4, 5, 6, 6, 6, 3, 4, 5, 4, 5, 6, 6, 6]"
扑蝴蝶 ,邵叔齐,平平仄仄，平仄仄平仄。平平平仄，平平仄仄仄。仄平仄仄平平，仄仄平平仄仄。平平仄平仄仄。仄平仄。平平平仄，仄仄平平仄仄仄。平平仄仄，仄平平仄仄。仄平仄仄平平，仄仄平平仄仄。平平仄平仄仄。,0,35,42,77,"[4, 5, 4, 5, 6, 6, 6, 3, 4, 7, 4, 5, 6, 6, 6]"
扑蝴蝶 ,丘崈,平平仄仄。平仄平平仄。平平仄仄。平平平仄仄。平平平仄平平，仄仄平平仄仄。平平仄平平仄。仄平仄。平平平仄，仄仄平平仄平仄。平平仄仄，平平平仄仄。仄平平仄平平，仄仄仄平平仄。平平仄平平仄。,0,43,34,77,"[4, 5, 4, 5, 6, 6, 6, 3, 4, 7, 4, 5, 6, 6, 6]"
千年调 ,辛弃疾,平仄仄平平，平仄平平仄。仄仄平平仄仄，仄仄平仄。仄平仄仄，仄仄平平仄。平仄仄，仄平平，平仄仄。仄平仄仄，仄仄平平仄。仄仄平仄仄仄，仄仄平仄。仄平平仄，仄仄仄平仄。仄平平，仄平平，平仄仄。,0,29,46,75,"[5, 5, 6, 4, 4, 5, 3, 3, 3, 4, 5, 6, 4, 4, 5, 3, 3, 3]"
千年调 ,曹组,平平仄平平，平仄平平仄。仄仄平平仄仄，仄仄仄仄。平平仄仄，仄仄平平仄。仄平仄，仄平平，仄仄仄。平平仄仄，平仄仄平仄。仄仄仄平，仄仄仄仄仄仄。平平仄仄，仄仄平平仄。仄仄仄，仄平平，仄仄平平仄。,0,29,48,77,"[5, 5, 6, 4, 4, 5, 3, 3, 3, 4, 5, 4, 6, 4, 5, 3, 3, 5]"
蕊珠閒 ,赵彦端,仄平平，平平仄，仄仄平平平仄。仄平平仄平平，仄平仄仄。仄平平仄，仄平平仄。仄平仄平平仄。仄平仄。仄平平仄仄仄。平仄平平平仄。仄平平仄，仄仄仄平平仄。仄平平仄，仄平平仄。仄平仄平平仄。,0,37,38,75,"[3, 3, 6, 6, 4, 4, 4, 6, 3, 6, 6, 4, 6, 4, 4, 6]"
瑞云浓 ,杨无咎,平平仄仄，平平平仄平仄。平仄平平仄平仄。平平仄仄，仄仄仄、平平平仄。仄仄仄平平，仄平平仄仄。平仄平平，平仄仄、平平仄仄。仄仄平平仄平仄。仄平平仄，仄仄平、仄平平仄。仄仄平平，仄平仄仄。,0,36,39,75,"[4, 6, 7, 4, 3, 4, 5, 5, 4, 3, 4, 7, 4, 3, 4, 4, 4]"
番枪子 ,韩玉,仄仄平仄平平仄。仄仄仄平平、平平仄。仄仄平仄平平，仄平平仄仄平仄。仄仄仄平平、平平仄。仄仄仄仄平平，平仄仄仄。仄仄仄平平、平平仄。仄平平仄平平，仄平平仄仄仄仄。仄仄仄平平、平仄仄。,0,33,42,75,"[7, 5, 3, 6, 7, 5, 3, 6, 4, 5, 3, 6, 7, 5, 3]"
荔枝香 ,柳永,仄仄平平仄仄，平仄仄。仄仄平仄平平，平仄平平仄。平仄平平平仄，仄仄平平仄。平仄、仄仄平平仄平仄。仄平仄，仄仄仄、平平仄。仄仄仄平，平仄仄平平仄。仄仄平平，仄仄平平仄平仄。平平平仄平仄。,0,35,41,76,"[6, 3, 6, 5, 6, 5, 2, 7, 3, 3, 3, 4, 6, 4, 7, 6]"
荔枝香 ,周邦彦,仄仄平平平仄，平仄仄。仄仄仄仄平平，平仄平平仄。平平仄仄平平，仄仄平平仄。仄仄仄平平仄平仄。平仄仄，仄仄仄、平平仄。仄仄平平，平仄仄平平仄。平仄平平，仄仄平平仄平仄。仄仄平平仄仄。,0,34,41,75,"[6, 3, 6, 5, 6, 5, 8, 3, 3, 3, 4, 6, 4, 7, 6]"
荔枝香 ,方千里,仄仄平平平仄。平仄仄。仄仄仄仄平平，平仄平平仄。平平仄仄平平，平仄平平仄。平仄、仄仄平平仄平仄。平仄仄，仄仄仄、平平仄。仄仄平平，平仄仄平平仄。平仄平平，仄仄平平仄平仄。仄仄平平仄仄。,0,36,40,76,"[6, 3, 6, 5, 6, 5, 2, 7, 3, 3, 3, 4, 6, 4, 7, 6]"
荔枝香 ,杨泽民,仄仄仄平平仄。平仄仄。仄仄仄仄平平，仄仄平平仄。仄平仄仄平平，仄仄平平仄。平仄。仄仄平平仄平仄。平仄仄。仄仄仄、平平仄。仄仄平平，平仄仄平平仄。仄仄平平，仄仄平平仄平仄。仄仄平平仄仄。,0,31,45,76,"[6, 3, 6, 5, 6, 5, 2, 7, 3, 3, 3, 4, 6, 4, 7, 6]"
荔枝香 ,陈允平,仄仄平平平仄，平仄仄。仄仄仄仄平平，平仄平平仄。平平仄仄平平，仄仄平平仄。平平仄仄，平平仄平仄。平仄，仄仄仄、仄平平仄。仄仄平平，仄仄仄平平仄。平仄平平，仄仄平平仄平仄。仄仄平平仄仄。,0,35,41,76,"[6, 3, 6, 5, 6, 5, 4, 5, 2, 3, 4, 4, 6, 4, 7, 6]"
荔枝香 ,吴文英,仄仄平平，平仄平平仄。仄平平仄平平，平仄平平仄。平平仄仄平平，仄仄平平仄。平仄、仄仄平平仄平仄。平仄仄。仄平仄、平平仄。仄仄平平，平仄仄平平仄。平仄平平，仄仄平平仄平仄。仄仄仄平平仄。,0,39,37,76,"[4, 5, 6, 5, 6, 5, 2, 7, 3, 3, 3, 4, 6, 4, 7, 6]"
荔枝香 ,吴文英,平仄平平，仄仄仄平仄。仄仄平仄平平，平仄平平仄。平平仄仄平平，仄仄平平仄。平仄、仄仄平平仄平仄。平仄仄，仄仄仄、平平仄。仄仄平平，仄仄仄平平仄。仄仄平平，仄仄平平仄平仄。仄仄平平平仄。,0,35,41,76,"[4, 5, 6, 5, 6, 5, 2, 7, 3, 3, 3, 4, 6, 4, 7, 6]"
荔枝香 ,周邦彦,仄平平平仄仄，仄平仄。仄仄平仄，平仄平平，平平仄仄平平，仄仄平平平仄。平仄、仄仄平平仄仄。仄平仄平，仄仄平仄仄。仄仄平平，仄仄仄、平平仄。仄平仄仄，仄仄平平仄平仄。仄平平仄平仄。,0,32,41,73,"[6, 3, 4, 4, 6, 6, 2, 6, 4, 5, 4, 3, 3, 4, 7, 6]"
荔枝香 ,杨泽民,仄平平平仄仄，仄平仄。仄仄平仄，平仄平平，平平仄仄平平，平平仄仄平仄。平仄。仄仄平平仄仄。仄平仄平仄，仄平仄仄。仄仄平平，仄仄仄、平平仄平平仄仄，仄仄平平仄平仄。仄仄平平，仄仄仄、平平仄。仄平平仄平仄。,0,37,46,83,"[6, 3, 4, 4, 6, 6, 2, 6, 5, 4, 4, 3, 7, 7, 4, 3, 3, 6]"
荔枝香 ,陈允平,仄平平平仄仄，仄平仄。仄仄平仄，平仄平平，仄平仄仄平平，仄仄平平平仄。平仄仄仄，平平仄仄。仄平仄平，仄仄平仄仄。仄仄平平仄，仄仄平平仄。仄平仄仄，仄仄平平仄平仄。仄平平仄平仄。,0,31,42,73,"[6, 3, 4, 4, 6, 6, 4, 4, 4, 5, 5, 5, 4, 7, 6]"
婆罗门引 ,曹组,仄平仄仄，仄平仄仄仄平平。平平仄仄平平。仄仄平平平仄，平仄仄平平。仄平平仄仄，仄仄平平。平平仄平。仄仄仄、仄平平。仄仄平平仄仄，平仄平平。平平平仄，仄平仄、平仄仄平平。平仄仄、仄仄平平。,0,38,38,76,"[4, 7, 6, 6, 5, 5, 4, 4, 3, 3, 6, 4, 4, 3, 5, 3, 4]"
婆罗门引 ,李俊民,平平仄仄，平平平仄仄平平。平平仄仄平平。仄仄平平仄仄，平仄仄平平。仄仄平平仄，仄仄平平。仄平仄仄，仄仄仄、仄平平。仄仄平平平仄，仄仄平平。平平仄仄，仄平仄、平平仄仄平。平仄仄、平仄平平。,0,38,38,76,"[4, 7, 6, 6, 5, 5, 4, 4, 3, 3, 6, 4, 4, 3, 5, 3, 4]"
婆罗门引 ,吴文英,平平仄仄，仄平平仄仄平平。平平仄仄平平。仄仄平平平仄，平仄仄平平。仄仄平仄仄，仄仄平平。平平仄平，仄仄仄、仄平平。仄仄平平仄仄，平仄平平。平平仄平。仄平仄、平平仄仄平。平仄仄、仄仄平平。,0,39,37,76,"[4, 7, 6, 6, 5, 5, 4, 4, 3, 3, 6, 4, 4, 3, 5, 3, 4]"
婆罗门引 ,无名氏,平平仄仄，仄平平仄仄平平。平仄仄、仄仄平平。仄仄平平平仄，平仄仄平平。仄平平平仄，平仄平平。仄平仄平。仄仄仄、仄平平。仄仄平平仄仄，平仄平平。平平仄平，仄仄平平平仄平。仄平仄、平仄平平。,0,41,35,76,"[4, 7, 3, 4, 6, 5, 5, 4, 4, 3, 3, 6, 4, 4, 7, 3, 4]"
御街行 ,柳永,平平平仄平平仄。仄仄平平仄。平平仄仄仄平平，仄仄仄平平仄。仄平平仄，平平平仄，平仄平平仄。仄平平仄平平仄。仄仄平平仄。仄平平仄仄平平，仄仄仄平平仄。平平平仄，平平仄仄，仄仄平平仄。,0,40,36,76,"[7, 5, 7, 6, 4, 4, 5, 7, 5, 7, 6, 4, 4, 5]"
御街行 ,柳永,平平仄仄平平仄。仄仄平平仄。平平平仄仄平平，仄仄仄平平仄。平仄仄平仄仄，平仄仄仄平平仄。平平仄仄平平仄。仄仄平平仄。平平仄仄仄平平，仄仄仄平平仄。平仄仄平，平平平仄，仄仄平平仄。,0,37,39,76,"[7, 5, 7, 6, 6, 7, 7, 5, 7, 6, 4, 4, 5]"
御街行 ,张先,平平平仄平平仄。平仄仄、平平仄。平平平仄仄平平，仄仄平平平仄。仄平平仄，仄平平仄，仄仄平平仄。平平仄仄平平仄。平仄平平仄。仄平平仄仄平平，平仄仄平平仄。平平平仄，仄平平仄，平仄平平仄。,0,44,33,77,"[7, 3, 3, 7, 6, 4, 4, 5, 7, 5, 7, 6, 4, 4, 5]"
御街行 ,范仲淹,平平仄仄平平仄。仄仄仄、平平仄。平平平仄仄平平，平仄平平平仄。平平平仄，仄平平仄，平仄平平仄。平平仄仄平平仄。仄仄仄、平平仄。平平平仄仄平平，平仄平平平仄。平平仄仄，平平平仄，平仄平平仄。,0,46,32,78,"[7, 3, 3, 7, 6, 4, 4, 5, 7, 3, 3, 7, 6, 4, 4, 5]"
御街行 ,高观国,平平仄仄平平仄。仄仄仄、平平仄。平平仄仄仄平平，平仄仄、平平平仄。平平仄仄，仄平平仄，仄平仄、平平仄。仄平平仄平平仄。仄仄仄、平平仄。平平平仄仄平平，仄仄仄、平平平仄。平平仄仄，仄平平仄，仄仄平平仄。,0,41,40,81,"[7, 3, 3, 7, 3, 4, 4, 4, 3, 3, 7, 3, 3, 7, 3, 4, 4, 4, 5]"
御街行 ,无名氏,平平仄仄平平仄。仄平仄、平平仄。仄平平仄仄平平，平仄仄平平仄。平平仄仄，仄平仄仄，仄仄平平仄。仄平平仄平平仄。仄平仄、平平仄。平平平仄仄平平，平仄平平平仄。仄平仄仄，平平平仄，仄仄仄、平平平仄。,0,42,38,80,"[7, 3, 3, 7, 6, 4, 4, 5, 7, 3, 3, 7, 6, 4, 4, 3, 4]"
韵令 ,程大昌,仄平仄仄，平仄平平。平平仄仄平。平平平仄，仄仄平平。平平仄仄，平仄平平。平平仄仄，仄仄仄平平。仄平仄仄，仄仄平平。平平仄仄平。仄平平仄，仄仄平平。平平仄仄，仄仄平平。仄平平仄，平仄仄平平。,0,40,36,76,"[4, 4, 5, 4, 4, 4, 4, 4, 5, 4, 4, 5, 4, 4, 4, 4, 4, 5]"
春声碎 ,谭宣子,平仄仄平平，仄仄平平平仄。平平仄仄，平平平仄，仄仄平平仄。平平仄，仄平仄仄平，平仄仄、平平仄。平平仄平仄。仄仄平平仄仄。平平仄仄，仄仄仄平平、仄平平仄。平仄仄。平仄仄仄平平，仄仄仄、平平仄。,0,37,40,77,"[5, 6, 4, 4, 5, 3, 5, 3, 3, 5, 6, 4, 5, 4, 3, 6, 3, 3]"
凤楼春 ,欧阳炯,仄仄仄平平。平仄平平。仄平平。仄平平仄仄平平。平仄仄，仄平平。平仄仄平平仄仄，仄仄仄平平。仄平平。平仄平平。仄平平仄，仄平平仄，仄平平仄平平。平仄仄平，平仄平仄仄平平。仄平平仄，平仄平平。,0,43,34,77,"[5, 4, 3, 7, 3, 3, 7, 5, 3, 4, 4, 4, 6, 4, 7, 4, 4]"
祝英台近 ,程垓,仄平平，平仄仄，平仄仄平仄。仄仄平平，平仄仄平仄。仄平平仄平平，仄平平仄，仄平仄、仄平平仄。仄平仄。平仄平仄平平，平平平仄仄。平仄平平，平仄仄平仄。仄平平仄平平，平平平仄，仄平仄、仄平平仄。,0,41,36,77,"[3, 3, 5, 4, 5, 6, 4, 3, 4, 3, 6, 5, 4, 5, 6, 4, 3, 4]"
祝英台近 ,史达祖,仄平平，平仄仄，平仄仄平仄。平仄平平，平仄仄平仄。仄平仄仄平平，平平平仄。仄仄仄、仄平平仄。仄平仄。平仄平仄平平，平平仄平仄。仄仄平平，平仄仄平仄。仄平仄仄平平，仄平仄仄，仄平仄、平平平仄。,0,38,39,77,"[3, 3, 5, 4, 5, 6, 4, 3, 4, 3, 6, 5, 4, 5, 6, 4, 3, 4]"
祝英台近 ,韩淲,仄平平，仄平仄，仄仄仄平仄。仄仄平平，平仄仄平仄。平平仄仄平平，平平仄仄，仄仄仄、仄平平仄。仄平仄。仄仄仄仄平平，平仄仄平仄。仄仄平平，平仄仄平仄。仄平平仄平平，平平平仄。仄仄仄、平平平仄。,0,35,42,77,"[3, 3, 5, 4, 5, 6, 4, 3, 4, 3, 6, 5, 4, 5, 6, 4, 3, 4]"
祝英台近 ,张炎,仄平平，平仄仄，仄仄平平仄。仄仄平平，平仄仄平仄。仄平平仄平平，仄平平仄。平仄仄、仄平平仄。仄平仄。平平仄仄平平，平仄仄平仄。仄仄平平，平仄仄平仄。仄平仄仄平平，仄平平仄。平仄仄、仄平平仄。,0,37,40,77,"[3, 3, 5, 4, 5, 6, 4, 3, 4, 3, 6, 5, 4, 5, 6, 4, 3, 4]"
祝英台近 ,刘过,仄平平，平仄仄。仄仄仄平仄。平仄平平，仄仄仄仄仄。仄平仄仄平平，平平平仄，平仄仄、仄平平仄。仄仄仄。仄仄平仄平平，平平仄平仄。平仄平平，平仄仄平仄。仄平仄仄平平，仄平平仄，仄平仄、仄平平仄。,0,35,42,77,"[3, 3, 5, 4, 5, 6, 4, 3, 4, 3, 6, 5, 4, 5, 6, 4, 3, 4]"
祝英台近 ,辛弃疾,仄平平，平仄仄。平仄仄平仄。仄仄平平，仄仄仄平仄。仄平仄仄平平，平平平仄，仄平仄、平平平仄。仄平仄。仄仄平仄平平，平平仄平仄。平仄平平，仄仄仄平仄。仄平平仄平平，平平平仄。仄仄仄、仄平平仄。,0,38,39,77,"[3, 3, 5, 4, 5, 6, 4, 3, 4, 3, 6, 5, 4, 5, 6, 4, 3, 4]"
祝英台近 ,岳珂,仄平平，平仄仄。仄仄平平仄。仄仄平平，平仄仄平仄。平平平仄平平，仄平平仄。仄平仄、平平平仄。仄平仄。仄仄仄仄平平，仄仄平平仄。仄仄平平，平仄仄平仄。仄平平仄平平，平平仄仄。仄仄仄、平平平仄。,0,38,39,77,"[3, 3, 5, 4, 5, 6, 4, 3, 4, 3, 6, 5, 4, 5, 6, 4, 3, 4]"
祝英台近 ,陈允平,仄平平，平仄仄，平仄仄平平。平仄平平，平仄仄平平。仄平仄仄平平，平平仄仄，平平仄、平仄平平。仄平平。平仄平仄平平，仄平平仄平。平仄平平，平仄仄平平。仄平平仄平平，平平平仄，平平仄、平仄平平。,0,49,28,77,"[3, 3, 5, 4, 5, 6, 4, 3, 4, 3, 6, 5, 4, 5, 6, 4, 3, 4]"
四园竹 ,周邦彦,平平仄仄，仄仄仄平平。仄平仄仄，平仄仄平，平仄平平。平仄平，平仄仄、平平仄仄。仄平平仄平平。仄平平。平平仄仄平平，平平仄仄平平。仄仄平平仄仄，平仄平平，仄仄平平。平仄仄。仄仄仄、平平仄仄平。,0,40,37,77,"[4, 5, 4, 4, 4, 3, 3, 4, 6, 3, 6, 6, 6, 4, 4, 3, 3, 5]"
四园竹 ,杨泽民,平平仄仄，仄仄仄平平。仄平仄仄，平仄仄平，平仄平平。平仄平平仄仄，平平仄仄。仄平平仄平平。仄平平。平平仄仄平平，平平仄仄平平。仄仄平平仄仄，平仄平平，仄仄平平。平仄仄。仄仄仄、平平仄仄平。,0,40,37,77,"[4, 5, 4, 4, 4, 6, 4, 6, 3, 6, 6, 6, 4, 4, 3, 3, 5]"
四园竹 ,陈允平,平平仄仄，仄仄仄平平。仄平平仄，平仄仄平，平仄平平。仄仄平平仄仄，平平仄仄。仄平平仄平平。仄平平。平平平仄平平，平平仄仄平平。仄仄平平仄仄，平仄平平，仄仄平平平仄仄。仄仄仄、平平仄仄平。,0,41,36,77,"[4, 5, 4, 4, 4, 6, 4, 6, 3, 6, 6, 6, 4, 7, 3, 5]"
侧犯 ,周邦彦,仄平仄仄，仄平仄仄平平仄。平仄。仄仄仄平平、仄平仄。平平仄仄仄，仄仄平平仄。平仄。平仄仄，平平仄平仄。平平仄仄，仄仄平平仄。平仄仄。仄平平，平仄仄平仄。仄仄平平，仄平平仄。平仄仄仄，仄平平仄。,0,33,44,77,"[4, 7, 2, 5, 3, 5, 5, 2, 3, 5, 4, 5, 3, 3, 5, 4, 4, 4, 4]"
侧犯 ,姜夔,仄平仄仄。仄平仄仄平平仄。平仄。仄仄仄平平、仄平仄。平平仄仄仄，仄仄平平仄。平仄。仄仄仄平平、仄平仄。平平仄仄，平仄平平仄。平仄仄。仄平平，平仄仄平仄。仄仄平平，仄平平仄。仄仄平平，仄平平仄。,0,34,43,77,"[4, 7, 2, 5, 3, 5, 5, 2, 5, 3, 4, 5, 3, 3, 5, 4, 4, 4, 4]"
侧犯 ,方千里,仄平仄仄，仄平仄仄平平仄。平仄。仄仄仄平平、仄平仄。平平仄仄仄，仄仄平平仄。平仄。平仄仄，平平仄平仄。平平仄仄，仄仄平平仄。平仄仄。仄平平，平仄仄平仄。仄仄平平，仄平仄仄。平仄。仄仄仄平平仄。,0,32,45,77,"[4, 7, 2, 5, 3, 5, 5, 2, 3, 5, 4, 5, 3, 3, 5, 4, 4, 2, 6]"
侧犯 ,陈允平,仄平仄仄，仄平仄仄平平仄。平仄。仄仄仄平平、仄平仄。平平仄仄平，仄仄平平仄。平仄平仄仄，平平仄平仄。平平仄仄，仄仄平平仄。平仄仄。平平平仄仄平仄。仄仄平平，仄平平仄。平仄平平，仄平平仄。,0,36,40,76,"[4, 7, 2, 5, 3, 5, 5, 5, 5, 4, 5, 3, 7, 4, 4, 4, 4]"
离亭宴 ,张先,仄平平仄仄。平仄仄、平平仄仄。平仄平平平仄仄。仄仄仄、仄平平仄。仄仄仄平平仄，平仄仄平平仄。平仄平平仄仄。仄仄仄、平平仄仄。平仄平平平仄仄。平仄仄、平平仄仄。仄仄仄平平仄，仄仄平平平仄。,0,33,44,77,"[5, 3, 4, 7, 3, 4, 6, 6, 6, 3, 4, 7, 3, 4, 6, 6]"
离亭宴 ,张昪,仄仄平平平仄。平仄仄平平仄。仄仄仄平平仄仄，仄仄仄平平仄。仄仄仄平平，仄仄仄平平仄。平仄仄平平仄。平仄仄平平仄。平仄仄平平仄仄，仄仄平平平仄。仄仄仄平平，平仄平平平仄。,0,32,40,72,"[6, 6, 7, 6, 5, 6, 6, 6, 7, 6, 5, 6]"
阳关引 ,寇准,仄仄平平仄。仄仄平平仄。平平仄仄，平平仄，平平仄。仄平平平仄，仄仄平平仄。仄仄平、平仄仄仄仄平仄。仄仄仄平仄，平仄仄。仄平平仄，平平仄，仄平仄。仄仄平平仄，仄仄平平仄。仄仄平、平仄仄仄仄平仄。,0,32,46,78,"[5, 5, 4, 3, 3, 5, 5, 3, 7, 5, 3, 4, 3, 3, 5, 5, 3, 7]"
一丛花 ,苏轼,平平平仄仄平平。平仄仄平平。平平仄仄平平仄，仄平仄、仄仄平平。平仄仄平，平平仄仄，平仄仄平平。平平平仄仄平平。平仄仄平平。平平仄仄平平仄，仄平仄、平仄平平。平仄仄平，平平仄仄，平仄仄平平。,0,45,33,78,"[7, 5, 7, 3, 4, 4, 4, 5, 7, 5, 7, 3, 4, 4, 4, 5]"
甘州令 ,柳永,仄平平，仄仄仄，平平仄仄。平仄仄、仄平平仄。仄平平，仄平仄，仄平平仄。仄平平，仄平仄，仄仄仄、仄平平仄。仄平仄仄，仄平平仄。仄平仄、仄平平仄。仄平平，仄仄仄，仄平平仄。仄平平，仄平仄，仄平仄、仄平平仄。,0,33,45,78,"[3, 3, 4, 3, 4, 3, 3, 4, 3, 3, 3, 4, 4, 4, 3, 4, 3, 3, 4, 3, 3, 3, 4]"
山亭柳 ,晏殊,平仄平平。仄仄仄平平。平仄仄，仄平平。仄仄仄平平仄，仄平平仄平平。仄仄平平平仄，仄仄平平。仄平平仄平平仄，平平仄仄仄平平。平平仄，仄平平。仄仄平平仄仄，仄平仄仄平平。仄仄平平仄仄，平仄平平。,0,41,38,79,"[4, 5, 3, 3, 6, 6, 6, 4, 7, 7, 3, 3, 6, 6, 6, 4]"
山亭柳 ,杜安世,仄平平仄，仄平平仄。仄平平、平仄仄。平仄平平，仄平平、仄平仄仄。平平仄平仄仄，仄仄平平仄。仄平仄平平仄仄。平平平仄仄平仄。仄平平，仄仄仄。仄仄平平，仄平平、仄平平仄。平平仄仄仄仄，仄仄仄、平平仄。,0,37,42,79,"[4, 4, 3, 3, 4, 3, 4, 6, 5, 7, 7, 3, 3, 4, 3, 4, 6, 3, 3]"
梦还京 ,柳永,仄平平平仄仄，平仄仄平仄。仄仄平平，仄平仄仄，平仄平平，仄仄平平平仄。仄平仄。平仄平平，仄仄仄仄仄平仄。仄仄平、平仄平仄。仄仄仄。仄仄平仄平仄。仄平仄。仄仄仄仄平平仄，仄仄平平，仄平仄平仄仄。,0,31,48,79,"[6, 5, 4, 4, 4, 6, 3, 4, 7, 3, 4, 3, 6, 3, 7, 4, 6]"
忆黄梅 ,王观,平仄仄平仄仄。仄仄仄平平仄。平仄仄平平，仄仄仄。仄仄平平、仄平平仄仄，平平仄。平仄平平仄仄。仄平仄。仄平平，平仄仄。仄平仄仄平平仄。仄平仄仄。仄平仄、平仄平平，仄平平平仄。平仄仄、平仄平平仄仄。,0,35,44,79,"[6, 6, 5, 3, 4, 5, 3, 6, 3, 3, 3, 7, 4, 3, 4, 5, 3, 6]"
红林檎近 ,周邦彦,平仄平平仄，仄平平仄平。仄仄仄平仄，仄平仄平平。仄平平平仄仄，仄仄仄仄平平。仄仄仄仄平平。平仄仄平平。仄仄平仄仄，平仄仄平平。平平仄仄，平平平仄平平。仄平平平仄，平平仄仄，仄平仄仄平仄平。,0,39,40,79,"[5, 5, 5, 5, 6, 6, 6, 5, 5, 5, 4, 6, 5, 4, 7]"
快活年近拍 ,万俟咏,平平仄仄平，仄仄平平仄。平平仄仄仄，仄平仄仄仄。仄仄平平，仄平仄仄，平仄平平，仄仄仄平平仄。仄平仄。平仄仄仄平，仄仄平平仄。平平仄仄仄，平平平仄仄。平仄平平，仄平平仄，平仄平平，平仄仄平平仄。,0,37,42,79,"[5, 5, 5, 5, 4, 4, 4, 6, 3, 5, 5, 5, 5, 4, 4, 4, 6]"
金人捧露盘 ,高观国,仄平平。平平仄，仄平平。仄平仄、平仄平平。平平仄仄，仄平平仄仄平平。平平仄仄，仄平仄、仄仄平平。平平仄，仄平仄，仄平仄，仄平平。平平仄、仄仄平平。平平仄仄，仄平平仄仄平平。平平仄仄，仄平仄、仄仄平平。,0,42,37,79,"[3, 3, 3, 3, 4, 4, 7, 4, 3, 4, 3, 3, 3, 3, 3, 4, 4, 7, 4, 3, 4]"
金人捧露盘 ,程垓,仄平平，平平仄，仄平平。仄仄仄、仄仄平平。平平仄仄，仄平平仄仄平平。仄平平仄仄平平，仄仄平平。仄平平，平仄仄，平仄仄，仄平平。仄平仄、仄仄平平。仄平仄仄，仄平平仄仄平平。仄平平仄仄平平，仄仄平平。,0,40,39,79,"[3, 3, 3, 3, 4, 4, 7, 7, 4, 3, 3, 3, 3, 3, 4, 4, 7, 7, 4]"
金人捧露盘 ,辛弃疾,仄平平，平仄仄，仄平平。仄平仄、仄仄平平。平平仄仄，仄平仄仄仄平平。仄平仄，仄平平、仄仄平平。平平仄，平平仄，平仄仄，仄平平。仄平仄、平仄平平。仄平平仄，平平平仄仄平平。仄平仄仄，仄平平、仄仄平平。,0,41,37,78,"[3, 3, 3, 3, 4, 4, 7, 3, 3, 4, 3, 3, 3, 3, 3, 4, 4, 7, 4, 3, 4]"
金人捧露盘 ,辛弃疾,仄平平。平仄仄，仄平平。仄平仄、平仄平平。平平仄仄，仄平平仄仄平平。仄平平仄，平平仄仄平平。平平仄，平平仄，平平仄，仄平平。仄平仄仄仄平平。平平仄仄，平平平仄仄平平。仄平平仄，仄平平、平仄平平。,0,46,32,78,"[3, 3, 3, 3, 4, 4, 7, 4, 6, 3, 3, 3, 3, 7, 4, 7, 4, 3, 4]"
金人捧露盘 ,贺铸,仄平平。平平仄，仄平平。仄仄仄、仄仄平平。平平仄仄，仄平平、平仄仄平平。仄平平仄，仄平平、仄仄平平。平平仄，平平仄，平仄仄，仄平平。仄仄仄、平仄平平。平平仄仄，仄仄平、平仄仄平平。仄平平仄，仄仄平、平仄平平。,0,43,38,81,"[3, 3, 3, 3, 4, 4, 3, 5, 4, 3, 4, 3, 3, 3, 3, 3, 4, 4, 3, 5, 4, 3, 4]"
过涧歇 ,柳永,平仄。仄仄仄、平仄仄平平平，仄仄平平平仄。仄平仄。仄仄平平仄仄，仄仄平平仄。仄仄仄，仄仄平平仄平仄。仄仄平仄，仄仄平平仄仄仄。仄平平仄，平平仄平仄。平仄平平，仄仄平平，仄平仄仄，仄仄仄仄平平仄。,0,32,48,80,"[2, 3, 6, 6, 3, 6, 5, 3, 7, 4, 7, 4, 5, 4, 4, 4, 7]"
过涧歇 ,晁补之,平仄。仄仄平、仄仄平仄平平，仄仄平平平仄。仄平仄。仄仄平平仄仄，仄仄平平仄。仄仄仄、仄仄平平仄平仄。平仄平平仄仄，平平仄平仄。仄平平仄，平平仄平仄。平仄平平，仄仄平平，仄仄平仄，仄仄平仄平平仄。,0,36,44,80,"[2, 3, 6, 6, 3, 6, 5, 3, 7, 6, 5, 4, 5, 4, 4, 4, 7]"
过涧歇 ,柳永,仄仄。仄平仄、仄仄平仄平仄。仄仄平平平仄。平仄仄。仄仄平平，仄仄平平，平平平仄，仄平仄仄。平平仄平仄。仄仄平仄，仄仄平平平仄仄。仄平仄仄，平平仄平仄。仄仄平平，仄仄平仄。平平平仄，仄平仄仄平平仄。,0,35,45,80,"[2, 3, 6, 6, 3, 4, 4, 4, 4, 5, 4, 7, 4, 5, 4, 4, 4, 7]"
瑶阶草 ,程垓,平平仄平仄，仄仄平平仄。平仄平平，仄仄平仄仄。仄平仄仄，仄平平仄，仄平平仄。仄平仄平仄仄。仄平仄。仄平平仄，仄平仄仄平平仄。仄仄平平，仄平仄仄平仄仄。仄平仄仄，仄平仄仄。仄平仄仄。平平仄仄平仄。,0,32,48,80,"[5, 5, 4, 5, 4, 4, 4, 6, 3, 4, 7, 4, 7, 4, 4, 4, 6]"
安公子 ,柳永,平平平仄仄。仄平平仄平仄，仄仄平平仄仄，平仄平平仄。平平平平仄。平仄仄平仄仄，仄仄平平平仄，平仄平平仄。仄仄仄仄平平，仄平仄仄。平平仄仄，仄仄仄仄平平仄。仄仄平平仄，平仄平平，平仄平平仄仄。,0,38,42,80,"[5, 6, 6, 5, 5, 6, 6, 5, 6, 4, 4, 7, 5, 4, 6]"
安公子 ,柳永,仄仄平平仄。仄平仄仄平平仄。仄仄平平平仄仄，仄平平平仄。平仄仄、平平仄仄平平仄。平仄平、仄仄平平仄。仄仄平平仄，平仄平平平仄。平仄平平仄。仄平平仄平平仄。仄仄平平平仄仄，仄平平平仄。仄仄仄、平平仄仄平平仄。平仄平、仄仄平平仄。仄仄仄平平，仄平仄平平仄。,0,52,54,106,"[5, 7, 7, 5, 3, 7, 3, 5, 5, 6, 5, 7, 7, 5, 3, 7, 3, 5, 5, 6]"
安公子 ,袁去华,仄仄平平仄。仄平平仄平平仄。平仄平平平仄仄，仄仄平平仄。仄仄仄平平，仄仄平平仄。平仄平、仄仄平平仄。仄仄仄平平，平仄平平平仄。仄仄平平仄。仄平平仄平平仄。仄仄平平平仄仄，仄平平平仄。仄仄仄平平，平仄平平仄。平仄仄、仄仄平平仄。仄仄平平平，平仄平平平仄。,0,53,53,106,"[5, 7, 7, 5, 5, 5, 3, 5, 5, 6, 5, 7, 7, 5, 5, 5, 3, 5, 5, 6]"
安公子 ,晁补之,仄仄平平仄。仄平平仄平平仄。平仄平平平仄仄，平平平仄。仄平仄、平平仄仄平平仄。平仄平、平仄平平仄。仄仄平仄仄，仄仄平平平仄。仄平平平仄。仄平平仄平平仄。仄仄平平平仄仄，仄平平仄。仄平仄、平平平仄平平仄。仄平仄、平仄平平仄。仄平平平仄，仄仄平平平仄。,0,55,49,104,"[5, 7, 7, 4, 3, 7, 3, 5, 5, 6, 5, 7, 7, 4, 3, 7, 3, 5, 5, 6]"
安公子 ,杜安世,仄仄平平仄。仄平平仄平平仄。平仄仄平平仄仄，仄平平仄。平仄仄、仄平仄仄。平平仄。平仄仄、仄仄平平仄。仄平平仄，仄仄平平，平平平仄。仄仄平平仄。仄平平仄平平仄。平仄仄平平仄仄，仄平平仄。平仄仄、仄平仄仄。平平仄。平仄仄、平仄平平仄。仄平平仄，仄仄平平，仄平平仄。,0,50,56,106,"[5, 7, 7, 4, 3, 4, 3, 3, 5, 4, 4, 4, 5, 7, 7, 4, 3, 4, 3, 3, 5, 4, 4, 4]"
安公子 ,陆游,平仄平平仄。仄平平仄平平仄。仄仄平平，平仄仄、平平仄仄。仄仄平平，平仄平平仄。平仄仄、平仄平平仄。仄仄平平仄，平仄平平仄仄。仄仄平平仄。仄平平仄平平仄。仄仄平平，平仄仄、平平平仄。平仄平平，仄仄平平仄。平仄平、仄仄平平仄。仄仄平平仄，仄仄平平仄仄。,0,51,51,102,"[5, 7, 4, 3, 4, 4, 5, 3, 5, 5, 6, 5, 7, 4, 3, 4, 4, 5, 3, 5, 5, 6]"
应景乐 ,萧回,平平仄仄。仄仄平平、仄仄平仄仄。平平仄，平平仄平仄。仄平平仄仄。平仄仄仄，仄仄平平平仄，平平仄平仄。平仄仄平仄。仄仄仄、仄仄平平，仄仄仄仄仄，平仄平仄。平仄平平，平仄平仄。平仄仄平平，平仄仄平仄。,0,35,45,80,"[4, 4, 5, 3, 5, 5, 4, 6, 5, 5, 3, 4, 5, 4, 4, 4, 5, 5]"
柳初新 ,柳永,平平仄仄平平仄。仄仄仄、平平仄。仄平平仄，平平仄仄，仄仄仄平平仄。平仄平平平仄。仄平平、平平平仄。仄仄平平仄仄。平平平、平平平仄。仄平平仄，平平仄仄，仄仄仄平平仄。仄仄仄、平平平仄。仄平平、仄平平仄。,0,42,39,81,"[7, 3, 3, 4, 4, 6, 6, 3, 4, 6, 3, 4, 4, 4, 6, 3, 4, 3, 4]"
柳初新 ,无名氏,平平平仄平平仄。平仄仄、平平仄。平平平仄，平平仄仄，仄仄仄平平仄。平仄仄、平平仄仄。仄平平、平平平仄。仄仄平平仄仄。仄平平、仄平平仄。仄平平仄，平平仄仄，仄仄仄平平仄。仄仄平、平平仄仄。仄平平、仄平平仄。,0,42,40,82,"[7, 3, 3, 4, 4, 6, 3, 4, 3, 4, 6, 3, 4, 4, 4, 6, 3, 4, 3, 4]"
鬭百花 ,柳永,仄仄平平平仄。平仄平平平仄。平平仄仄平平，平仄平平平仄。平仄平平，平仄仄仄平平，仄仄仄平平仄。平仄平平仄。仄仄平平，仄仄平平平仄。平仄仄仄，平平仄平平仄。平仄平平，平平仄仄平平，平仄仄平平仄。,0,46,35,81,"[6, 6, 6, 6, 4, 6, 6, 5, 4, 6, 4, 6, 4, 6, 6]"
鬭百花 ,柳永,仄仄平平平仄，仄仄平平平仄，平平平仄仄仄，仄平平仄平仄。仄平仄仄，平平仄仄平平，平仄平平仄仄。平仄平平仄。平仄平仄，仄平平仄平仄。平仄仄平，平平仄仄平仄。仄仄平平，平平仄仄平平，仄仄平平平仄。,0,42,39,81,"[6, 6, 6, 6, 4, 6, 6, 5, 4, 6, 4, 6, 4, 6, 6]"
鬭百花 ,晁补之,平仄平平平仄。仄仄平平平仄。平仄仄平平仄。仄仄平平平仄。仄仄平平，平平仄仄平平，仄仄仄平平仄。平仄平平仄。平仄平平，仄仄平平仄仄。平仄仄平，平平仄仄平仄。仄仄平平，平平仄仄平平，平仄仄平平仄。,0,43,38,81,"[6, 6, 6, 6, 4, 6, 6, 5, 4, 6, 4, 6, 4, 6, 6]"
皂罗特髻 ,苏轼,仄平仄仄，仄仄仄平平，仄平平仄。仄平仄仄，仄仄平平仄。平平仄、仄平仄仄，仄平平、仄仄平平仄。仄平仄仄，仄仄平平仄。平仄仄平仄仄，仄平平平仄。仄平仄、仄平仄仄，仄平仄、仄仄平平仄。仄平仄仄，仄仄平平仄。,0,31,50,81,"[4, 5, 4, 4, 5, 3, 4, 3, 5, 4, 5, 6, 5, 3, 4, 3, 5, 4, 5]"
最高楼 ,辛弃疾,平平仄，平仄仄平平。仄仄仄平平。仄平平仄平平仄，仄平平仄仄平平。仄平平，平仄仄，仄平平。仄仄仄、仄平平仄仄。仄仄仄、仄平平仄仄。平仄仄、仄平平。平平仄仄平平仄，仄平仄仄仄平平。仄平平，平仄仄，仄平平。,0,39,42,81,"[3, 5, 5, 7, 7, 3, 3, 3, 3, 5, 3, 5, 3, 3, 7, 7, 3, 3, 3]"
最高楼 ,方岳,平平仄，平仄仄平平。平仄仄平平。仄仄平仄仄平平仄，仄平平仄仄仄平平。仄平平，平仄仄，仄平平。平仄仄、平平平仄仄。仄仄仄、平平平仄仄。平仄仄、仄平平。仄仄平仄仄平平仄，仄平平仄仄仄平平。仄平平，平仄仄，仄平平。,0,42,43,85,"[3, 5, 5, 8, 8, 3, 3, 3, 3, 5, 3, 5, 3, 3, 8, 8, 3, 3, 3]"
最高楼 ,元好问,平平仄，平仄仄平平。平仄仄平平。平平平仄平平仄，平平平仄仄平平。仄平平，平仄仄，仄平平。仄平仄平平、平仄仄。仄仄仄平、平仄仄。平仄仄、仄平平。平平仄仄平平仄，平平仄仄仄平平。仄平平，平仄仄，仄平平。,0,45,35,80,"[3, 5, 5, 7, 7, 3, 3, 3, 5, 3, 4, 3, 3, 3, 7, 7, 3, 3, 3]"
最高楼 ,司马昂父,平平仄，仄平仄仄平平。平仄仄平平。仄平平平仄仄平仄，平平平仄仄平平。仄平平，平仄平，仄平平。仄平仄、仄平平仄仄。仄平仄、仄平平仄仄。平仄仄、仄平平。平平仄仄平平仄，平平平仄仄平平。仄仄平，平仄仄，仄平平。,0,45,38,83,"[3, 6, 5, 8, 7, 3, 3, 3, 3, 5, 3, 5, 3, 3, 7, 7, 3, 3, 3]"
最高楼 ,毛滂,平仄仄，平仄仄平平。平仄仄，仄平平。仄平仄仄平平仄，仄平平仄仄平平。仄平平，平仄仄，仄平平。平仄仄、平平平仄仄。仄仄仄、仄平平仄仄。平仄仄，仄平平。平平仄仄平平仄，仄平平仄仄平平。仄平平，平仄仄，仄平平。,0,41,41,82,"[3, 5, 3, 3, 7, 7, 3, 3, 3, 3, 5, 3, 5, 3, 3, 7, 7, 3, 3, 3]"
最高楼 ,陈亮,平仄仄，平仄仄平平。平仄仄、仄平平。仄平平仄平平仄，平平平仄仄平平。仄平平，平仄仄，仄平平。平仄仄、平平平仄仄。仄仄仄、平平平仄仄。平仄仄、仄平平。平平仄仄平平仄，平平仄仄仄平平。仄平平，平仄仄，仄平平。,0,44,38,82,"[3, 5, 3, 3, 7, 7, 3, 3, 3, 3, 5, 3, 5, 3, 3, 7, 7, 3, 3, 3]"
最高楼 ,毛滂,平仄仄，平仄仄平平。平仄仄，仄平平。平平仄仄平平仄，仄平平仄仄平平。仄平平，平仄仄，仄平平。仄平仄仄平、平仄仄，仄仄平平仄、平仄仄，平平仄仄平平。仄平平仄平平仄，平平平仄仄平平。仄平平，平仄仄，仄平平。,0,44,38,82,"[3, 5, 3, 3, 7, 7, 3, 3, 3, 5, 3, 5, 3, 6, 7, 7, 3, 3, 3]"
最高楼 ,程垓,仄平平仄，仄仄仄平平。平仄仄、仄平平。平平平仄平平仄，仄平平仄仄平平。仄平平，仄平仄，仄平平。仄平仄、平平平仄仄。仄平仄、平平平仄仄。平仄仄、仄平平。平平仄仄平平仄，仄平仄仄仄平平。仄平平，平仄仄，仄平平。,0,44,39,83,"[4, 5, 3, 3, 7, 7, 3, 3, 3, 3, 5, 3, 5, 3, 3, 7, 7, 3, 3, 3]"
最高楼 ,无名氏,平平仄仄，平仄仄平平。平仄仄、仄平平。仄平平仄平平仄，平平仄仄仄平平。仄平平，平仄仄，仄平平。平仄仄、平平平仄仄，仄平仄、平平仄仄平。平仄仄、仄平平。仄平仄仄平平仄，仄平仄仄仄平平。仄平平，平仄仄，仄平平。,0,43,40,83,"[4, 5, 3, 3, 7, 7, 3, 3, 3, 3, 5, 3, 5, 3, 3, 7, 7, 3, 3, 3]"
最高楼 ,柳富,平平仄仄，仄仄仄平平。平仄仄、仄平平。平仄仄平平仄仄，仄平平仄仄平平。仄平平，平仄仄，仄平平。仄仄仄平平。仄平平仄平平仄，平仄仄、仄平平。仄平平仄平平仄，平仄仄、仄平平。仄平平，平平仄，仄平平。,0,41,37,78,"[4, 5, 3, 3, 7, 7, 3, 3, 3, 5, 7, 3, 3, 7, 3, 3, 3, 3, 3]"
最高楼 ,无名氏,平平仄，平仄平平仄。仄仄平平平仄仄。平平仄仄平平仄，仄平平仄平平仄。平平仄，平平仄，平平仄。仄仄仄平平仄仄。仄仄仄平平仄仄。仄平平仄平平仄。平平仄仄平平仄，仄平平仄平平仄。仄平平，平平仄，平平仄。,0,44,38,82,"[3, 5, 7, 7, 7, 3, 3, 3, 7, 7, 7, 7, 7, 3, 3, 3]"
倒垂柳 ,杨无咎,仄平平仄仄，仄平平、平仄仄。仄仄平仄仄，平仄仄平仄。平平仄平仄，平仄平平仄。平平平仄仄，平平平仄仄仄。平平平仄。仄仄平平平仄仄。仄仄仄平平，仄仄仄平仄。平仄仄平，平仄平仄仄。平平平仄，仄仄平平仄。,0,38,43,81,"[5, 3, 3, 5, 5, 5, 5, 5, 6, 4, 7, 5, 5, 4, 5, 4, 5]"
倒垂柳 ,杨无咎,平平平仄仄。仄平平、仄仄仄。平平平平仄，平仄仄平仄。仄平平仄仄，仄仄平平仄。平平平仄仄，平平平仄平仄。平平仄仄。仄仄平平平仄仄。仄仄仄平平，仄仄仄平仄。平平仄仄，平仄平平仄。平平平仄，仄仄平平仄。,0,40,41,81,"[5, 3, 3, 5, 5, 5, 5, 5, 6, 4, 7, 5, 5, 4, 5, 4, 5]"
彩凤飞 ,陈亮,平仄仄，平平仄，仄仄平平仄。仄平平、平仄仄平平仄。仄平平，仄平仄、仄仄平平，平平仄、仄仄仄平平仄。仄平仄。仄仄平平平仄，平平平平仄。仄仄平、平仄平平仄仄。仄平平、仄仄仄，平仄平仄。平平仄仄仄、仄仄仄仄。,0,37,44,81,"[3, 3, 5, 3, 6, 3, 3, 4, 3, 6, 3, 6, 5, 3, 6, 3, 3, 4, 5, 4]"
有有令 ,赵长卿,平平仄仄。平仄仄平平，仄平平仄仄。平仄平平仄，平平仄、平平仄。仄仄平、仄仄平平，仄平仄仄，平平平仄。仄仄。平平仄仄。平仄仄、仄平平仄。仄仄平平仄仄，仄仄平平仄。仄平仄仄平仄。仄平仄仄。平仄仄、仄平仄仄。,0,35,46,81,"[4, 5, 5, 5, 3, 3, 3, 4, 4, 4, 2, 4, 3, 4, 6, 5, 6, 4, 3, 4]"
拂霓裳 ,晏殊,仄平平。仄平平仄仄平平。平仄仄，仄平平仄仄平平。平平平仄仄，平仄仄平平。仄平平。仄平平、平仄仄平平。平平仄仄，平仄仄、仄平平。平仄仄，仄平平仄仄平平。平平平仄仄，平仄仄平平。仄平平。仄平平、平仄仄平平。,0,47,35,82,"[3, 7, 3, 7, 5, 5, 3, 3, 5, 4, 3, 3, 3, 7, 5, 5, 3, 3, 5]"
拂霓裳 ,晏殊,仄平平。仄平平仄仄仄平平。平平仄，仄平平仄仄平平。仄仄平平仄，平平仄仄平。平仄仄，仄平平仄仄、仄平平。平平仄仄，仄仄仄、仄平平。仄平平。仄平平仄仄平平。平平平仄仄，平仄仄平平。仄平平。仄仄平仄仄、仄平平。,0,43,40,83,"[3, 8, 3, 7, 5, 5, 3, 5, 3, 4, 3, 3, 3, 7, 5, 5, 3, 5, 3]"
柳腰轻 ,柳永,平平仄仄平平仄。平平仄，平平仄。仄平平仄，仄平平仄，仄仄平平平仄。仄平仄、平仄平平，仄平平、仄平平仄。仄仄平平仄仄。仄平平、仄平平仄。仄平平仄，仄平平仄，仄仄平平平仄。仄平仄、平仄平平，仄平平、仄平平仄。,0,44,38,82,"[7, 3, 3, 4, 4, 6, 3, 4, 3, 4, 6, 3, 4, 4, 4, 6, 3, 4, 3, 4]"
爪茉莉 ,柳永,仄仄平平，仄平仄仄仄。平平仄、仄平平仄。平平仄仄，仄仄仄、平平仄仄。仄平仄、仄仄平平，仄平仄、平仄仄。平平仄仄，仄平平、仄平仄。平仄仄、仄平平仄。平平仄仄，仄平平、平平仄。仄仄平、仄仄仄平平仄。仄平仄，平仄仄。,0,35,47,82,"[4, 5, 3, 4, 4, 3, 4, 3, 4, 3, 3, 4, 3, 3, 3, 4, 4, 3, 3, 3, 6, 3, 3]"
蓦山溪 ,程垓,仄平平仄，仄仄平平仄。仄仄仄平平，仄平仄、平平仄仄。平平仄仄，平仄仄平平，仄仄仄，仄平平，仄仄平平仄。平平仄仄，仄仄平平仄。仄仄仄平平，仄平平、平平仄仄。平平仄仄，平仄仄平平，平平仄，仄平平，仄仄平平仄。,0,39,43,82,"[4, 5, 5, 3, 4, 4, 5, 3, 3, 5, 4, 5, 5, 3, 4, 4, 5, 3, 3, 5]"
蓦山溪 ,姜夔,仄平平仄。仄仄平平仄。仄平仄平平，仄平平、平平仄仄。仄平仄仄，平仄仄平平，平仄仄，仄平平，平仄平平仄。平平仄仄，仄仄平平仄。仄仄仄平平，仄平仄、平平仄仄。仄平平仄，平仄仄平平，平仄仄，仄平平，仄仄平平仄。,0,40,42,82,"[4, 5, 5, 3, 4, 4, 5, 3, 3, 5, 4, 5, 5, 3, 4, 4, 5, 3, 3, 5]"
蓦山溪 ,张震,平平平仄，仄仄平平仄。仄仄仄平平，平仄仄、平平仄仄。平平仄仄，仄仄仄平平，平仄仄，仄平平，仄仄平平仄。仄平平仄。平仄平平仄。仄仄仄平平，平仄仄、平平仄仄。平平仄仄，平仄仄平平，平仄仄，仄平平，平仄平平仄。,0,40,42,82,"[4, 5, 5, 3, 4, 4, 5, 3, 3, 5, 4, 5, 5, 3, 4, 4, 5, 3, 3, 5]"
蓦山溪 ,张震,平平平仄。平仄平平仄。仄仄仄平平，仄平平、仄平平仄。仄平平仄，平仄仄平平，平仄仄，仄平平，平仄平平仄。平平仄仄。平仄平平仄。平仄仄平平，平平仄、平平仄仄。仄平平仄，仄仄仄平平，平仄仄，仄平平，仄仄平平仄。,0,44,38,82,"[4, 5, 5, 3, 4, 4, 5, 3, 3, 5, 4, 5, 5, 3, 4, 4, 5, 3, 3, 5]"
蓦山溪 ,易祓,仄平平仄，平仄平平仄。平仄仄平平，仄平仄、平平仄仄。仄平平仄，仄仄仄平平，平平仄，平平仄。仄仄平平仄。平平仄仄，平仄平平仄。仄仄仄平平，仄平平、平平仄仄。仄平仄仄，平仄仄平平，平平仄，平平仄。平仄平平仄。,0,43,39,82,"[4, 5, 5, 3, 4, 4, 5, 3, 3, 5, 4, 5, 5, 3, 4, 4, 5, 3, 3, 5]"
蓦山溪 ,周邦彦,平平平仄，仄仄平平仄。仄仄仄平平，仄平平、平平仄仄。平平仄仄，平仄仄平平，平平仄。平平仄。仄仄平平仄。平平仄仄，仄仄平平仄。仄仄仄平平，仄平平、仄平仄仄。平平仄仄，平仄仄平平，平仄仄。平平仄。仄仄平平仄。,0,41,41,82,"[4, 5, 5, 3, 4, 4, 5, 3, 3, 5, 4, 5, 5, 3, 4, 4, 5, 3, 3, 5]"
蓦山溪 ,贺铸,仄平平仄。仄仄平平仄。仄仄仄平平，仄平平、平平仄仄。平平平仄，仄仄仄平平，仄平平，平平仄。仄仄平平仄。平平平仄，仄仄平平仄。平仄仄平平，仄平平、平平仄仄。仄平平仄，仄仄仄平平，仄平平，平平仄。仄仄平平仄。,0,43,39,82,"[4, 5, 5, 3, 4, 4, 5, 3, 3, 5, 4, 5, 5, 3, 4, 4, 5, 3, 3, 5]"
蓦山溪 ,万俟咏,平平仄仄。平仄平平仄。平仄仄平平，仄平仄、平平平仄。平平仄仄，平仄仄平平，平仄仄，平仄仄。仄仄平平仄。平平平仄。仄仄平平仄。仄仄仄平平，仄平仄、平平平仄。平平仄仄，平仄仄平平，平仄仄，平平仄。平仄平平仄。,0,43,39,82,"[4, 5, 5, 3, 4, 4, 5, 3, 3, 5, 4, 5, 5, 3, 4, 4, 5, 3, 3, 5]"
蓦山溪 ,黄庭坚,平平仄仄，仄仄平平仄。平仄仄平平，仄平平、平平仄仄。平平仄仄，仄仄仄平平，平仄仄。平平仄。仄仄平平仄。平平仄仄。仄仄平平仄。仄仄仄平平，仄平平、平平平仄。平平仄仄，仄仄仄平平，平平仄。平平仄。平仄平平仄。,0,42,40,82,"[4, 5, 5, 3, 4, 4, 5, 3, 3, 5, 4, 5, 5, 3, 4, 4, 5, 3, 3, 5]"
蓦山溪 ,晁端礼,平平仄仄。平仄平平仄。仄仄仄平平，仄平平、仄平仄仄。平平仄仄，仄仄仄平平，平平仄。平平仄。仄仄平平仄。平平仄仄，平仄平平仄。平仄仄平平，仄平平、平平仄仄。平平仄仄，仄仄仄平平，平仄仄。平仄仄。平仄平平仄。,0,41,41,82,"[4, 5, 5, 3, 4, 4, 5, 3, 3, 5, 4, 5, 5, 3, 4, 4, 5, 3, 3, 5]"
蓦山溪 ,石孝友,平平仄仄。平仄平平仄。平仄仄平平，仄平平、平平仄仄。仄平仄仄，平仄仄平平，平仄仄。仄平仄。仄仄平平仄。仄平平仄。平仄平平仄。平仄仄平平，仄仄仄、平平仄仄。仄平仄仄，平仄仄平平，平平仄。仄平仄。仄仄平平仄。,0,39,43,82,"[4, 5, 5, 3, 4, 4, 5, 3, 3, 5, 4, 5, 5, 3, 4, 4, 5, 3, 3, 5]"
蓦山溪 ,欧阳修,平平平仄，平仄平平仄。平仄仄平平，仄平平、仄平平仄。平平仄仄，平仄仄平平，仄平平，平仄仄，仄仄平平仄。仄平平仄，平仄平平仄。平仄仄平平，仄平平、平平仄仄。平平平仄，仄仄仄平平，平平仄。平平仄。仄仄平平仄。,0,46,36,82,"[4, 5, 5, 3, 4, 4, 5, 3, 3, 5, 4, 5, 5, 3, 4, 4, 5, 3, 3, 5]"
蓦山溪 ,陆游,平平平仄，仄仄平平仄。仄仄仄平平，仄仄仄、平平仄仄仄。仄平平仄，平仄仄平平，平仄仄，仄平平，平仄平平仄。平平仄仄，仄仄平平仄。仄仄仄平平，仄平平、平平仄仄。平平仄仄，仄仄仄平平，平仄仄，仄平平，仄仄平平仄。,0,39,44,83,"[4, 5, 5, 3, 5, 4, 5, 3, 3, 5, 4, 5, 5, 3, 4, 4, 5, 3, 3, 5]"
千秋岁引 ,王安石,仄仄平平，平平仄仄。仄仄平平仄平仄。平平仄平仄仄仄，平平仄仄平平仄。仄平平，仄平仄，仄平仄。平仄仄平平仄仄。平仄仄平平平仄。仄仄平平仄平仄。平平仄平平仄仄，平平仄仄平平仄。仄平平，仄仄仄，平平仄。,0,40,42,82,"[4, 4, 7, 7, 7, 3, 3, 3, 7, 7, 7, 7, 7, 3, 3, 3]"
千秋岁引 ,李冠,仄平仄，仄仄平平仄。仄仄平平、平平仄。仄平平、仄仄平平仄，仄平仄仄平平仄。平仄仄，平平仄，平仄仄。仄仄平平平仄仄。仄仄平平平仄仄。平平平仄平平仄。仄平平、仄仄平平仄，平平仄仄平平仄。平仄仄，仄平仄，平平仄。,0,41,43,84,"[3, 5, 4, 3, 3, 5, 7, 3, 3, 3, 7, 7, 7, 3, 5, 7, 3, 3, 3]"
千秋岁引 ,无名氏,仄平平仄，仄仄平平仄。仄仄平平仄平仄。平平仄仄平平仄。平平仄仄平平仄。仄平平，平仄仄，平平仄。仄平仄平平平仄仄。仄仄仄平平平仄仄。仄仄平平仄平仄。平平仄仄平平仄。平平仄仄平平仄。仄仄仄。平仄仄。平平仄。,0,41,44,85,"[4, 5, 7, 7, 7, 3, 3, 3, 8, 8, 7, 7, 7, 3, 3, 3]"
千秋岁引 ,无名氏,平仄仄平，平仄仄平仄。仄仄仄平平、平平仄。平平仄仄仄平平，仄仄仄、仄仄平平仄。仄平平，仄平平，平平仄。仄仄平平平仄仄。仄仄平平平仄仄。仄仄仄平平、平仄仄。仄平平仄仄平平，仄平平、仄仄平平仄。平仄仄，仄平平，平平仄。,0,42,45,87,"[4, 5, 5, 3, 7, 3, 5, 3, 3, 3, 7, 7, 5, 3, 7, 3, 5, 3, 3, 3]"
早梅芳 ,周邦彦,仄平平，平仄仄。仄仄平平仄。平平平仄，仄仄平平仄平仄。仄平平仄仄，仄仄平平仄。仄平平仄仄，仄仄仄平仄。仄平平，仄仄仄。平仄平平仄。平平平仄，仄仄平平仄平仄。仄平平仄仄，仄仄平平仄。仄平平，仄仄平仄仄。,0,36,46,82,"[3, 3, 5, 4, 7, 5, 5, 5, 5, 3, 3, 5, 4, 7, 5, 5, 3, 5]"
早梅芳 ,李之仪,仄平平，仄仄平平仄。仄仄平平仄。仄平平仄，仄仄平平仄平仄。仄平平仄仄，仄仄平平仄。仄平平，仄仄平平仄。仄平平，平仄仄。仄仄平平仄。平平平仄，仄仄平平仄平仄。仄平平仄仄，仄仄平平仄。仄平平，仄仄平平仄。,0,38,44,82,"[3, 5, 5, 4, 7, 5, 5, 3, 5, 3, 3, 5, 4, 7, 5, 5, 3, 5]"
早梅芳 ,无名氏,平平平，仄平仄。平仄平平仄。仄平平仄，平仄仄平仄平仄。仄平平仄仄，仄仄平平仄。仄平平仄仄，平仄仄平仄。仄平平，仄仄仄。仄仄平平仄。平平仄仄，仄仄平平仄平仄。仄平平仄仄，平仄平平仄。仄仄平仄仄，平仄仄。,0,36,46,82,"[3, 3, 5, 4, 7, 5, 5, 5, 5, 3, 3, 5, 4, 7, 5, 5, 5, 3]"
新荷叶 ,黄裳,仄仄平平，平平仄仄平平。仄仄平平，仄平仄仄平平。平平仄仄，仄仄平、平仄平平。平平平仄，仄平平仄平平。平仄平平，仄平仄仄平平。仄仄平平，仄平平仄平平。平平仄仄，平平仄、仄仄平平。仄平平仄，仄平平仄平平。,0,48,34,82,"[4, 6, 4, 6, 4, 3, 4, 4, 6, 4, 6, 4, 6, 4, 3, 4, 4, 6]"
新荷叶 ,赵彦端,仄仄平平，平平仄仄平平。平仄平平，仄平平仄平平。平平仄仄，仄仄平、平仄平平。平平平仄，仄平平仄平平。平仄平平。平平仄仄平平。平仄平平，仄平平仄平平。平平仄仄，平平仄、平仄平平。仄平平仄，仄平平仄平平。,0,53,29,82,"[4, 6, 4, 6, 4, 3, 4, 4, 6, 4, 6, 4, 6, 4, 3, 4, 4, 6]"
新荷叶 ,赵抃,仄仄平平，平平仄仄平平。仄仄平平，仄平仄仄平平。平平仄仄，平平仄、仄仄平平。平平仄仄仄平，平仄平平。平仄平平，平平平仄平平。仄仄平平，仄平仄仄平平。平平仄仄，平平仄、仄仄平平。平仄仄仄仄平，仄仄平平。,0,46,36,82,"[4, 6, 4, 6, 4, 3, 4, 6, 4, 4, 6, 4, 6, 4, 3, 4, 6, 4]"
新荷叶 ,赵长卿,仄仄平平，仄平仄仄平平。仄仄平平，仄平平仄平平。平平仄仄，平平仄、仄仄平平。平平平仄，仄平平仄平平。仄仄平平，平平仄仄平平。仄仄平平仄仄，平仄平平。仄平平仄，仄平仄、平仄平平。平平仄仄，仄平平仄平平。,0,47,35,82,"[4, 6, 4, 6, 4, 3, 4, 4, 6, 4, 6, 6, 4, 4, 3, 4, 4, 6]"
南州春色 ,汪梅溪,平平仄，仄平平。平平平仄，仄仄仄平平。仄仄平平平仄仄，仄仄仄平平。仄仄平平仄仄，平平平仄，平仄仄平平。仄仄平平仄仄，平平仄仄，平仄平平。平仄平平，平平平仄，平仄仄、平仄平平。仄仄平平平仄，平仄仄平平。,0,45,37,82,"[3, 3, 4, 5, 7, 5, 6, 4, 5, 6, 4, 4, 4, 4, 3, 4, 6, 5]"
长寿乐 ,柳永,平平仄仄。仄仄平、仄仄平平平仄。平仄平平，平平平仄，仄仄平平仄仄。仄平平，仄仄平平，仄平平仄。平仄仄、仄仄平平仄仄。平平仄、仄仄平平仄仄。平仄仄。仄仄仄、仄仄平平平仄。仄仄平仄平平，仄平平仄，平平平仄。仄平平仄仄，仄平平仄平平仄。仄仄平、仄仄平平仄仄。仄平仄、仄仄仄平仄仄。,0,50,62,112,"[4, 3, 6, 4, 4, 6, 3, 4, 4, 3, 6, 3, 6, 3, 3, 6, 6, 4, 4, 5, 7, 3, 6, 3, 6]"
长寿乐 ,柳永,平平仄仄。仄平仄、平仄平平平仄。仄仄平平，平平仄仄，平仄平平平仄。仄平平、平仄平仄，平仄平平仄。仄平平仄仄，平平仄仄，仄平平仄仄，平平仄仄。仄平仄。仄平平、仄仄平平平仄。仄仄平平，平平仄仄，仄仄平平平仄。仄平平、仄仄平仄，平仄平平仄。仄平平、仄仄平平仄仄，仄平平仄仄，平平仄仄。,0,57,56,113,"[4, 3, 6, 4, 4, 6, 3, 4, 5, 5, 4, 5, 4, 3, 3, 6, 4, 4, 6, 3, 4, 5, 3, 6, 5, 4]"
迷仙引 ,柳永,平仄平平，平仄平平，仄仄平仄。仄仄平平，平平平仄平仄。仄仄平、平仄仄，仄平平平仄。平仄仄仄平，平仄平仄，平平平仄。仄仄平平仄。仄仄平平仄。仄仄平平，平平平仄平平仄。仄仄仄、平平仄仄。仄平平仄仄，平平仄仄。,0,42,41,83,"[4, 4, 4, 4, 6, 3, 3, 5, 5, 4, 4, 5, 5, 4, 7, 3, 4, 5, 4]"
迷仙引 ,无名氏,平平仄。仄仄平平，仄平平仄。仄仄仄平平仄仄。平平仄。仄仄平平，仄平平平仄。平仄仄，平仄平平仄。平仄仄仄，仄仄平平仄，平平仄。仄平平仄。平平仄，平平仄，仄平平仄平平仄。仄仄仄平仄。仄平仄，平平仄。平仄平平，仄仄平平仄平仄。平仄仄、平仄仄。仄平平、仄仄平平仄。平平仄。仄平平、仄仄平平仄。仄平平、平仄平平仄。,0,61,61,122,"[3, 4, 4, 7, 3, 4, 5, 3, 5, 4, 5, 3, 4, 3, 3, 7, 5, 3, 3, 4, 7, 3, 3, 3, 5, 3, 3, 5, 3, 5]"
促拍满路花 ,柳永,平仄平平仄，仄仄仄平平。仄平平仄仄平平。仄平仄仄，平仄仄平平。仄平平平仄，仄仄平仄仄平，仄仄平平。仄平平仄平仄，平仄仄平平。平平平仄仄平平。仄平平仄，仄仄仄平平。平仄平平仄，平仄平平，仄平仄仄平平。,0,44,39,83,"[5, 5, 7, 4, 5, 5, 6, 4, 6, 5, 7, 4, 5, 5, 4, 6]"
促拍满路花 ,廖行之,仄仄平平仄，仄仄仄平平。平平平仄仄平平。仄平平仄，平仄仄平平。平平平仄仄，仄平平仄，仄平仄仄平平。平平仄仄，平仄仄平平。仄平平仄仄平平。平平仄仄，平仄仄平平。仄仄平平仄，仄仄平平，仄平仄仄平平。,0,43,38,81,"[5, 5, 7, 4, 5, 5, 4, 6, 4, 5, 7, 4, 5, 5, 4, 6]"
促拍满路花 ,吕渭老,平平平仄仄，仄仄仄平平。仄平平仄仄、仄平平。平平仄仄，平仄仄平平。仄仄平平仄，平仄平平。仄平平仄平平。仄平平仄，平仄仄平平。仄平平仄仄、仄平平。平平平仄，仄仄仄平平。平仄平平仄，平仄平平。仄平平仄平平。,0,47,36,83,"[5, 5, 5, 3, 4, 5, 5, 4, 6, 4, 5, 5, 3, 4, 5, 5, 4, 6]"
促拍满路花 ,无名氏,平平平仄仄，仄仄仄平平。平平平仄仄、仄平平。仄平平仄，仄仄仄平平。仄仄平平仄，平平平仄，仄平仄仄平平。仄仄平仄仄平平。仄仄仄平平。平平平仄仄、仄平平。仄平仄仄，仄仄仄平平。仄仄平平仄，仄平平仄，仄平平仄平平。,0,43,43,86,"[5, 5, 5, 3, 4, 5, 5, 4, 6, 7, 5, 5, 3, 4, 5, 5, 4, 6]"
促拍满路花 ,赵师侠,平平平仄仄，仄仄仄平平。仄平平仄仄、仄平平。仄平平仄，仄仄仄平平。仄仄平平仄，仄仄平平，仄平平仄平平。仄平平、仄仄平平。平仄仄平平。平平平仄仄、仄平平。平平仄仄，仄仄仄平平。平仄平平仄，仄仄平平。仄平仄仄平平。,0,45,41,86,"[5, 5, 5, 3, 4, 5, 5, 4, 6, 3, 4, 5, 5, 3, 4, 5, 5, 4, 6]"
促拍满路花 ,曹勛,平平平仄仄，平仄仄平平。平平平仄仄、仄平平。仄平平仄，仄仄仄平平。平仄平平仄，平仄平平仄仄，平仄平平。仄平仄仄仄平平。平仄仄平平。仄平平仄仄、仄平平。仄平仄仄，平仄仄平平。平仄仄、平平仄，仄仄平平，仄平仄仄平平。,0,46,41,87,"[5, 5, 5, 3, 4, 5, 5, 6, 4, 7, 5, 5, 3, 4, 5, 3, 3, 4, 6]"
促拍满路花 ,秦观,仄仄平平仄。仄仄平平仄。平仄平平仄、仄平仄。仄平仄仄，平仄平平仄。平仄平平仄。平仄平平，仄平平仄平仄。平平仄仄。仄仄平平仄。仄仄平平仄、平平仄。仄平平仄，仄仄平平仄。仄仄平平仄。仄仄平平，仄平平仄仄仄。,0,39,44,83,"[5, 5, 5, 3, 4, 5, 5, 4, 6, 4, 5, 5, 3, 4, 5, 5, 4, 6]"
促拍满路花 ,周邦彦,平平仄仄平，平仄平平仄。平平平仄仄、平平仄。平平仄仄，仄仄平平仄。仄平平仄仄。仄仄平平，仄平仄仄平仄。平平平仄，仄仄平平仄。平平平仄仄、平平仄。平平仄仄，平仄平平仄。平仄平平仄。仄平仄平，仄平平仄平仄。,0,44,39,83,"[5, 5, 5, 3, 4, 5, 5, 4, 6, 4, 5, 5, 3, 4, 5, 5, 4, 6]"
促拍满路花 ,袁去华,平仄平平仄。仄仄平平仄。平平平仄仄、仄平仄。仄仄仄仄平，仄仄平平仄。仄仄平平仄。仄仄平平，仄仄平平平仄。仄仄平、平平平仄仄。仄仄平平仄。仄平仄、仄平仄。仄仄仄平平，平仄平平仄。平平仄、平仄仄平，仄仄仄、仄平平仄。,0,38,48,86,"[5, 5, 5, 3, 5, 5, 5, 4, 6, 3, 5, 5, 3, 3, 5, 5, 3, 4, 3, 4]"
促拍满路花 ,辛弃疾,平仄平平仄。仄仄平平仄。平平平仄仄、仄平仄。仄平仄平平，平仄平平仄。仄仄平平仄。仄仄仄平平，平仄平平平仄。仄仄仄、平平平仄。仄仄平平仄。仄平平、仄仄平平仄。仄平仄平平，仄仄平平仄。仄仄平平仄。仄仄平平，仄仄仄、平平平仄。,0,44,46,90,"[5, 5, 5, 3, 5, 5, 5, 5, 6, 3, 4, 5, 3, 5, 5, 5, 5, 4, 3, 4]"
促拍满路花 ,牛真人,仄仄平平仄。仄仄平平平仄。平平平仄仄、平平仄。仄仄平平，平仄平平仄。仄仄平平仄，仄仄平平，仄平平仄平仄。仄仄平平仄。平仄仄平平仄。平平仄仄仄、仄平仄。仄仄平平，仄仄仄、平平仄。仄平平仄仄，平仄仄平平，仄仄平平平仄。,0,42,46,88,"[5, 6, 5, 3, 4, 5, 5, 4, 6, 5, 6, 5, 3, 4, 3, 3, 5, 5, 6]"
黄鹤引 ,《泊宅编》方失名,平平平仄。仄仄平平仄平仄。仄平平仄平平，平平平仄。平平仄仄。仄仄平平平仄。仄平平，仄仄平仄平平平仄。平仄仄平平，平仄平平仄。仄平平仄平平，平平平仄。平平仄仄。平仄仄平平仄。仄平平仄。仄仄仄、平平平仄。,0,47,36,83,"[4, 7, 6, 4, 4, 6, 3, 8, 5, 5, 6, 4, 4, 6, 4, 3, 4]"
洞仙歌 ,苏轼,平平仄仄，仄平平平仄。仄仄平平仄平仄。仄平平、仄仄平仄平平，平仄仄，平仄平平仄仄。仄平平仄仄，平仄平平，平仄平平仄平仄。仄仄仄平平、仄仄平平，平平仄、仄平平仄。仄仄仄、平平仄平平，仄仄仄、平平仄平平仄。,0,42,41,83,"[4, 5, 7, 3, 6, 3, 6, 5, 4, 7, 5, 4, 3, 4, 3, 5, 3, 6]"
洞仙歌 ,葛郯,平平仄仄。平仄平平仄。仄仄平平仄平仄。仄平平仄仄、仄仄平平，平平仄，仄仄平平仄仄。仄平平仄仄，平仄平平，仄仄平平仄平仄。仄仄仄平平、仄仄平平，平平仄、平平平仄。平仄平、平仄仄平平，仄平仄平平、仄平平仄。,0,43,40,83,"[4, 5, 7, 5, 4, 3, 6, 5, 4, 7, 5, 4, 3, 4, 3, 5, 5, 4]"
洞仙歌 ,张炎,仄平平仄，仄仄平平仄。平仄平平仄平仄。仄平平、仄仄仄仄平平，平仄仄，仄仄平平平仄。仄仄平平仄。仄仄平平，仄仄平平仄平仄。仄仄仄平平、仄仄平平，仄平仄、仄平平仄。仄平平、仄仄仄平平，仄仄仄平平、仄平平仄。,0,38,45,83,"[4, 5, 7, 3, 6, 3, 6, 5, 4, 7, 5, 4, 3, 4, 3, 5, 5, 4]"
洞仙歌 ,辛弃疾,平平仄仄，仄平平平仄。平仄平平仄平仄。仄平平平仄、仄仄平平，平平仄，平仄平平平仄。平平平仄仄，仄仄平平，仄仄平平仄平仄。仄仄仄平平、仄仄平平，仄仄仄、仄平仄仄。仄仄仄、仄平仄平平，平平仄、平平仄仄平仄。,0,41,42,83,"[4, 5, 7, 5, 4, 3, 6, 5, 4, 7, 5, 4, 3, 4, 3, 5, 3, 6]"
洞仙歌 ,汪元量,平平平仄。仄仄平平仄。平仄平平仄平仄。仄仄平仄仄、平仄平平，平平仄，平仄仄平平仄。平平平仄仄。仄仄平平，仄仄平平仄平仄。仄仄仄平平、平平平仄，平仄仄、平平平仄。仄平平、仄仄仄平平，仄仄仄平平、仄平平仄。,0,43,40,83,"[4, 5, 7, 5, 4, 3, 6, 5, 4, 7, 5, 4, 3, 4, 3, 5, 5, 4]"
洞仙歌 ,刘一止,仄平平仄，仄平平平仄。仄仄平平仄平仄。仄平平平仄、平仄平平，平仄仄，平仄平平仄仄。平平平仄仄，仄仄平平，仄仄平平仄平仄。平仄仄、平平仄仄平平，平平仄、仄平平仄。仄仄仄、平平仄平平，仄仄仄平平、仄平平仄。,0,43,40,83,"[4, 5, 7, 5, 4, 3, 6, 5, 4, 7, 3, 6, 3, 4, 3, 5, 5, 4]"
洞仙歌 ,赵长卿,平平仄仄，平仄平平仄。平仄平平仄平仄。仄平平、仄仄仄仄平平，仄平仄，平仄平平平仄。平平平仄仄。仄仄平平，平仄仄平仄平仄。仄平平、平仄平平，平平仄、仄仄仄平平仄。仄仄仄、仄平仄平平，仄仄平、仄仄平平平仄。,0,42,41,83,"[4, 5, 7, 3, 6, 3, 6, 5, 4, 7, 3, 4, 3, 6, 3, 5, 3, 6]"
洞仙歌 ,京镗,平平仄仄，仄平平仄仄。平仄平平仄平仄。仄平平平仄、平仄平平，平仄仄，仄仄平平平仄。平平平仄仄，仄仄平平，仄仄平平仄平仄。仄平仄仄、仄仄平平，平仄仄、平平仄仄。仄仄仄平平仄平平，仄仄仄平平、仄平平仄。,0,40,42,82,"[4, 5, 7, 5, 4, 3, 6, 5, 4, 7, 4, 4, 3, 4, 8, 5, 4]"
洞仙歌 ,姜夔,平平仄仄，仄仄平平仄。仄仄平平仄平仄。仄平平平仄、仄仄平平，平仄仄，仄仄平平仄仄。平平平仄仄，仄仄平平，平仄平平仄平仄。仄仄仄平平，仄仄平平，仄平仄、平平仄仄。仄仄平、平仄仄平平，仄仄仄平平、仄平平仄。,0,39,44,83,"[4, 5, 7, 5, 4, 3, 6, 5, 4, 7, 5, 4, 3, 4, 3, 5, 5, 4]"
洞仙歌 ,晏几道,平平仄仄，仄仄平平仄。仄仄平平仄平仄。仄平平、仄仄平仄平平，仄仄仄，平仄平平仄仄。平平平仄仄，仄仄平平，仄仄平平仄平仄。仄仄仄、仄平平，仄仄平平，平平仄、平平平仄。仄仄仄、平平仄平平，仄仄仄平平、仄平平仄。,0,40,44,84,"[4, 5, 7, 3, 6, 3, 6, 5, 4, 7, 3, 3, 4, 3, 4, 3, 5, 5, 4]"
洞仙歌 ,李元膺,平平仄仄，仄平平平仄。平仄平平仄平仄。仄仄平仄仄、平仄平平，平仄仄。平仄平平仄仄。平平平仄仄，仄仄平平，平仄平平仄平仄。仄平平、仄仄仄，仄仄平平，仄平平、仄平平仄。仄仄仄、平平仄平平，仄仄仄平平、仄平平仄。,0,42,42,84,"[4, 5, 7, 5, 4, 3, 6, 5, 4, 7, 3, 3, 4, 3, 4, 3, 5, 5, 4]"
洞仙歌 ,无名氏,平平仄仄，平仄平平仄。仄仄平平仄平仄。仄平平、平仄仄。仄仄平平，平仄仄，平仄平平仄仄。仄平平仄仄。仄仄平平，平仄平平仄平仄。仄仄仄平平、仄仄平平，平仄仄、平平平仄。仄仄仄、平平仄平平，仄仄仄平平、仄平平仄。,0,41,43,84,"[4, 5, 7, 3, 3, 4, 3, 6, 5, 4, 7, 5, 4, 3, 4, 3, 5, 5, 4]"
洞仙歌 ,黄裳,仄平平仄，平仄平平仄。平仄平平仄平仄。仄平平仄仄、平仄平平，平仄仄，平仄平平仄仄。仄平平仄仄，平仄平平，仄仄平平仄平仄。仄仄仄平平、仄仄平平，平平仄、仄平平仄。仄仄仄平平、仄仄平平，仄仄仄平平、仄平平仄。,0,42,42,84,"[4, 5, 7, 5, 4, 3, 6, 5, 4, 7, 5, 4, 3, 4, 5, 4, 5, 4]"
洞仙歌 ,周紫芝,平平平仄，仄平平平仄。仄仄平平仄平仄。仄平平、平仄平仄平平，平仄仄，平仄仄平平仄仄。仄平平仄仄，仄仄平平，仄仄平平仄平仄。仄仄仄平平、仄仄平平，平平仄、平平平仄。仄平仄、平平仄平仄，仄仄平、平平仄平平仄。,0,44,40,84,"[4, 5, 7, 3, 6, 3, 7, 5, 4, 7, 5, 4, 3, 4, 3, 5, 3, 6]"
洞仙歌 ,晁补之,平平仄仄，仄平平平仄。仄仄平平仄平仄。仄平平仄仄、平仄平平，平平仄，平仄平平仄仄。平平平仄仄，平仄平平，仄仄平平仄平仄。仄平仄仄、平平仄仄平平，仄仄仄、平平平仄。仄平仄平平、仄平平，仄仄仄平、平仄平平仄。,0,44,40,84,"[4, 5, 7, 5, 4, 3, 6, 5, 4, 7, 4, 6, 3, 4, 5, 3, 4, 5]"
洞仙歌 ,阮阅,仄平仄仄，仄仄平平仄。平仄平平仄平仄。仄平仄、仄仄仄仄平平，仄平仄，仄平平仄仄。仄平平仄仄，仄仄平平，平仄平平仄平仄。仄平平仄仄、仄仄平平，仄仄仄、平仄仄平仄仄。仄仄仄仄平、仄仄平，平仄仄平平、仄平仄仄。,0,33,51,84,"[4, 5, 7, 3, 6, 3, 5, 5, 4, 7, 5, 4, 3, 6, 5, 3, 5, 4]"
洞仙歌 ,京镗,平平仄仄，仄仄平平仄。仄仄平平仄平仄。仄平平仄仄、平仄平平，平仄仄，仄仄平平仄仄。平平平仄仄，仄仄平平，仄仄平平仄平仄。仄平平平仄、仄仄平平，平仄仄、平平仄平平仄。仄仄仄平平、仄平平，仄仄仄平平、仄平平仄。,0,41,44,85,"[4, 5, 7, 5, 4, 3, 6, 5, 4, 7, 5, 4, 3, 6, 5, 3, 5, 4]"
洞仙歌 ,刘子寰,平平仄仄，仄仄平平仄。平仄平平仄平仄。仄平平仄仄、仄仄平平，平平仄，平仄平平仄仄。平平平仄仄。仄仄平平，仄仄平平仄平仄。仄仄平平仄、仄仄平平，平仄仄、平仄平平仄仄。仄平平、仄仄仄平平，仄平仄平平、仄平平仄。,0,42,43,85,"[4, 5, 7, 5, 4, 3, 6, 5, 4, 7, 5, 4, 3, 6, 3, 5, 5, 4]"
洞仙歌 ,卢祖皋,仄平仄仄。仄仄平平仄。仄仄平平仄平仄。仄平平平仄、仄仄平平，平仄仄，仄仄平平仄仄。仄平平仄仄。仄仄平平，仄仄平平仄平仄。仄仄仄平平、平仄平平，平仄仄、平仄平平仄仄。仄仄平平仄、仄平平，仄仄仄、仄平仄平平仄。,0,37,48,85,"[4, 5, 7, 5, 4, 3, 6, 5, 4, 7, 5, 4, 3, 6, 5, 3, 3, 6]"
洞仙歌 ,李元膺,仄平仄仄，仄仄平平仄。平仄平平仄平仄。仄平平平仄、仄仄平平，平仄仄。仄仄平平仄仄。仄平平仄仄，仄仄平平，仄仄平平仄平仄。仄平平平仄、仄仄平平，平仄仄。仄仄平平仄仄。仄仄仄平平、仄平平，仄仄仄平平、仄平仄仄。,0,37,48,85,"[4, 5, 7, 5, 4, 3, 6, 5, 4, 7, 5, 4, 3, 6, 5, 3, 5, 4]"
洞仙歌 ,无名氏,平平平仄。仄平平平仄。仄仄平平仄平仄。仄仄平仄仄、平仄平平，平平仄。平仄平平仄仄。仄平平仄仄，仄仄平平，平仄平平仄平仄。仄仄平仄仄、仄仄平平，平仄仄。平仄平平仄仄。仄仄仄、平平仄平平，仄平仄平平、仄平平仄。,0,42,43,85,"[4, 5, 7, 5, 4, 3, 6, 5, 4, 7, 5, 4, 3, 6, 3, 5, 5, 4]"
洞仙歌 ,晁补之,平平平仄。仄平平平仄。仄仄平平仄平仄。仄仄平平仄、仄仄平平，平平仄。仄仄平平平仄。平平平仄仄。仄仄平平，平仄平平仄平仄。仄仄平平仄、平仄平平，平平仄。平仄平平平仄。仄平仄平平、仄平平，仄仄仄平平、仄平平仄。,0,47,38,85,"[4, 5, 7, 5, 4, 3, 6, 5, 4, 7, 5, 4, 3, 6, 5, 3, 5, 4]"
洞仙歌 ,李邴,仄平平仄，仄平平平仄。平仄平平仄平仄。仄平平、平仄仄，平仄平平，平平仄，平仄平平平仄。平平平仄仄，平仄平平，平仄平平仄平仄。仄仄平、平仄仄，平仄平平，平平仄、仄平平仄。仄仄仄、平平仄平平，仄仄仄平平、仄平平仄。,0,48,37,85,"[4, 5, 7, 3, 3, 4, 3, 6, 5, 4, 7, 3, 3, 4, 3, 4, 3, 5, 5, 4]"
洞仙歌 ,无名氏,平平仄仄，仄仄平平仄。仄仄平平仄仄仄。仄平平、仄仄平，仄平仄。平平仄。仄仄平平平仄。仄平平仄，平仄平平，仄仄平平仄仄仄。仄平平、仄仄仄，平仄平平，平平平、平仄平平仄仄。仄平仄、平平仄平平，仄平仄、平平仄平平仄。,0,43,42,85,"[4, 5, 7, 3, 3, 3, 3, 6, 4, 4, 7, 3, 3, 4, 3, 6, 3, 5, 3, 6]"
洞仙歌 ,黄庭坚,仄平平仄，仄平平平仄。仄仄平平仄平仄。仄平平、平仄仄仄仄平平，平平仄，平仄平平仄仄。仄仄平平仄，仄仄平平，平仄平平仄平仄。仄仄仄、仄平平，仄仄平平，平平仄、仄平平仄。仄平仄平平、仄平平，仄仄仄平平、仄平平仄。,0,43,42,85,"[4, 5, 7, 3, 7, 3, 6, 5, 4, 7, 3, 3, 4, 3, 4, 5, 3, 5, 4]"
洞仙歌 ,晁补之,平平仄仄，仄仄平平仄。仄仄平平仄仄仄。仄平平、平仄平仄平平，平平仄，平仄平平仄仄。仄平平仄仄，平仄平平，仄仄平平仄平仄。仄平平、仄平平仄，仄仄平平，平仄仄、平平平仄。仄平仄平平、仄平平，仄仄仄平平、仄平平仄。,0,44,41,85,"[4, 5, 7, 3, 6, 3, 6, 5, 4, 7, 3, 4, 4, 3, 4, 5, 3, 5, 4]"
洞仙歌 ,吴文英,平平平仄，平仄平平仄。仄仄平平仄平仄。仄平平平仄、平仄平平，平平仄，平仄平平仄仄。仄平平仄仄，平仄平平，平仄平平仄平仄。仄平仄、仄平平，仄仄平平，平平仄、平仄平平仄仄。仄仄仄、平平仄平平，仄仄仄仄平、仄平平仄。,0,46,40,86,"[4, 5, 7, 5, 4, 3, 6, 5, 4, 7, 3, 3, 4, 3, 6, 3, 5, 5, 4]"
洞仙歌 ,蔡伸,平平仄仄。仄仄平平仄。平仄平平仄平仄。仄平平、平仄仄，平仄平平，平平仄，平仄平平平仄。仄平平仄仄，平仄平平，仄仄平平仄平仄。仄平平平仄、仄仄平平，仄仄仄、仄仄平平仄仄。仄仄仄、平平仄仄平，仄仄仄平平、仄平平仄。,0,42,44,86,"[4, 5, 7, 3, 3, 4, 3, 6, 5, 4, 7, 5, 4, 3, 6, 3, 5, 5, 4]"
洞仙歌 ,林外,平平平仄，平仄平平仄。仄仄平平仄平仄。仄平平仄仄、仄仄平平，平仄仄，平仄平平仄仄。仄平平仄。仄仄平平仄。仄仄平平仄平仄。仄仄平、平仄仄，仄仄平平，平仄仄、平仄仄平平仄。仄平平平仄、仄平平，仄仄仄平平、平平仄仄。,0,41,45,86,"[4, 5, 7, 5, 4, 3, 6, 4, 5, 7, 3, 3, 4, 3, 6, 5, 3, 5, 4]"
洞仙歌 ,无名氏,仄平平仄，仄仄平平仄。仄仄平平仄平仄。仄平平，仄平平、平仄平平，平仄仄，仄仄平平仄仄。平平平仄仄，仄仄平平，平仄平平仄平仄。仄平平仄仄、平仄平平，平仄仄、平仄平平仄仄。仄平平、仄仄仄平平，仄仄仄平平、仄平平仄。,0,43,43,86,"[4, 5, 7, 3, 3, 4, 3, 6, 5, 4, 7, 5, 4, 3, 6, 3, 5, 5, 4]"
洞仙歌 ,赵长卿,仄平仄仄，仄仄平平仄。仄仄平平仄平仄。仄平平、仄平仄仄平平，平仄仄，仄仄平平仄仄。平平平仄仄，平仄平平，仄仄平平仄平仄。仄平平，平仄仄、仄仄平平，平仄仄、平仄平平仄仄。仄平仄平平、仄平平，仄平仄平平、仄平平仄。,0,42,44,86,"[4, 5, 7, 3, 6, 3, 6, 5, 4, 7, 3, 3, 4, 3, 6, 5, 3, 5, 4]"
洞仙歌 ,康与之,仄平平仄。仄仄平平仄。仄仄平平仄平仄。仄仄平、平仄仄，平仄平平，平仄仄，平仄仄平平仄。平平平仄仄，平仄平平，仄仄平平仄平仄。仄平平、平仄仄，平仄平平，平仄仄、平仄平平平仄。仄平仄、平平仄平平，仄仄仄平平、仄平平仄。,0,45,42,87,"[4, 5, 7, 3, 3, 4, 3, 6, 5, 4, 7, 3, 3, 4, 3, 6, 3, 5, 5, 4]"
洞仙歌 ,赵长卿,仄平平仄，仄仄平平仄。平仄平平仄平仄。仄平平、平仄仄，仄仄仄仄平，平仄仄，仄仄仄平平仄。平平仄仄。仄仄平平仄。仄仄平平仄平仄。仄仄平、平仄平，仄仄平平，仄仄仄、仄仄平平平仄。仄仄仄平平、仄平平，仄仄仄平平、仄平平仄。,0,38,50,88,"[4, 5, 7, 3, 3, 5, 3, 6, 4, 5, 7, 3, 3, 4, 3, 6, 5, 3, 5, 4]"
洞仙歌 ,潘牥,平平仄仄，仄平平平仄。平仄平平仄平仄。仄仄平平仄仄，仄仄平平，平平仄，仄仄平平平仄。平平平仄仄，仄仄平平，平仄平平仄平仄。仄平平、平平仄仄，仄仄平平，平平仄、仄平平平平仄。仄仄仄平平、仄平平，平仄仄、仄平仄平平仄。,0,47,41,88,"[4, 5, 7, 6, 4, 3, 6, 5, 4, 7, 3, 4, 4, 3, 6, 5, 3, 3, 6]"
洞仙歌 ,无名氏,仄平仄仄，平仄平平仄。平仄平平仄平仄。仄仄仄、平仄平平，平平仄、平平平仄。仄平仄、平仄仄平平，仄平仄平平、仄平平仄。仄平平仄，平仄平平，平仄平平仄平仄。仄仄仄、平仄平平，平平仄、平平平仄。仄仄仄、平平仄平平，仄平仄、平仄仄平平仄。,0,50,43,93,"[4, 5, 7, 3, 4, 3, 4, 3, 5, 5, 4, 4, 4, 7, 3, 4, 3, 4, 3, 5, 3, 6]"
洞仙歌 ,柳永,平仄，仄仄平仄仄，平仄仄平平仄。仄仄仄平仄，仄平仄仄。平平仄仄平平仄。仄仄仄、平平平仄，仄平平仄。仄仄仄，仄仄平平平仄。平仄。仄仄仄、仄平平仄，仄平仄仄，仄仄平仄平平，仄仄仄平仄仄。平平平仄平平仄。仄仄仄平平，仄平平平仄。仄仄仄平平，仄平平仄。仄仄仄仄。仄仄仄平平仄。平平仄。仄平仄、仄平平仄。,0,48,72,120,"[2, 5, 6, 5, 4, 7, 3, 4, 4, 3, 6, 2, 3, 4, 4, 6, 6, 7, 5, 5, 5, 4, 4, 6, 3, 3, 4]"
洞仙歌 ,柳永,平仄，平仄平平，仄仄平平平仄。仄仄仄平平，仄仄平平仄。仄平平仄，平平平仄，仄仄平平，仄仄仄、平平仄。平仄仄，仄仄仄平平仄。平仄。仄仄平平平仄，仄平平仄。平仄仄仄平平，平仄平仄仄平平仄。仄平仄仄平平，平平平仄仄平，平平仄、平平仄。平仄仄平平，平仄平仄。平平仄仄。仄仄仄、仄平平仄。平平仄，仄仄仄、仄平平仄。,0,60,63,123,"[2, 4, 6, 5, 5, 4, 4, 4, 3, 3, 3, 6, 2, 6, 4, 6, 8, 6, 6, 3, 3, 5, 4, 4, 3, 4, 3, 3, 4]"
洞仙歌 ,柳永,平仄平平仄。仄仄平仄仄，平平平仄。仄平平仄仄，仄平平仄。平平仄仄平平仄。仄仄仄、平平平仄仄。平平仄。仄仄仄平平，平仄平平仄。仄仄。仄平仄仄，仄仄平平，仄仄平平，仄仄仄仄平平，仄仄仄平平仄。平平仄仄平平仄。仄仄仄平平平仄仄。平仄仄。仄平平，仄仄平平仄平仄。仄仄仄。仄仄仄、平平仄。仄平平平仄，仄平平仄平平仄。,0,56,70,126,"[5, 5, 4, 5, 4, 7, 3, 5, 3, 5, 5, 2, 4, 4, 4, 6, 6, 7, 8, 3, 3, 7, 3, 3, 3, 5, 7]"
洞仙歌 ,晁补之,平平仄仄，仄平平仄，平平平仄。平仄仄平仄，仄平平平仄。平平平仄，平平平仄，平仄平平，平仄仄、平仄仄。平仄仄，仄仄仄仄平仄。平仄。仄平平平，平仄平平，仄仄平平，平仄平平平仄，仄仄仄平平仄。仄平仄仄，平平仄平，平仄平平，仄仄仄、平平仄。平仄仄平平，仄仄平仄。仄平仄仄。仄仄仄平、平平仄。平平仄。仄仄仄、平平平仄。,0,62,61,123,"[4, 4, 4, 5, 5, 4, 4, 4, 3, 3, 3, 6, 2, 4, 4, 4, 6, 6, 4, 4, 4, 3, 3, 5, 4, 4, 4, 3, 3, 3, 4]"
洞仙歌 ,晁补之,平仄仄仄。仄仄仄平平，平平仄仄。平仄仄平平，仄仄平平仄。平平仄仄，平平平仄，平仄平平，平仄仄、平仄仄。平仄仄，仄仄平平仄仄。平仄。仄仄平平，仄仄平平，平仄平平，仄仄平平，平平平仄，仄平平仄。平平仄仄，平平仄仄，平仄平平，平平仄、平仄仄。平仄仄平平，平平平仄。仄平仄仄。仄平仄仄。平平仄。平仄仄。仄仄平、仄平平仄。,0,62,62,124,"[4, 5, 4, 5, 5, 4, 4, 4, 3, 3, 3, 6, 2, 4, 4, 4, 4, 4, 4, 4, 4, 4, 3, 3, 5, 4, 4, 4, 3, 3, 3, 4]"
望云涯引 ,李甲,平平平仄，仄平仄，平平仄。仄仄平平，仄仄仄平平仄。平平仄仄，仄仄平平仄，仄仄仄。仄仄平平，仄平仄平仄。仄平平仄，仄平仄，平平仄。仄仄平平，平仄仄平平仄。平平仄仄，平仄平平仄，仄仄仄。仄仄平平，仄仄平平平仄。,0,38,45,83,"[4, 3, 3, 4, 6, 4, 5, 3, 4, 5, 4, 3, 3, 4, 6, 4, 5, 3, 4, 6]"
泛兰舟 ,无名氏,平仄平平平仄，仄平平平仄。仄平仄仄平平，平仄仄平仄。平仄平平，平平仄仄，平平平仄，平仄平平平仄。仄平仄。平仄仄平，平平平仄仄平仄。仄仄仄仄平平，平仄仄平仄。平仄平平，仄仄仄平，平平平仄，仄平仄平平仄。,0,45,38,83,"[6, 5, 6, 5, 4, 4, 4, 6, 3, 4, 7, 6, 5, 4, 4, 4, 6]"
踏歌 ,朱敦儒,仄仄。仄平平、仄仄平平仄。平平仄、仄仄平平仄。仄平平仄仄平平仄。仄仄。仄平平、仄仄平平仄。仄平仄、仄仄仄平仄。仄平平仄仄平平仄。平仄仄，仄仄仄。平平仄、仄仄平平仄。仄平仄平平，仄仄平平仄。仄平平仄仄平仄。,0,35,48,83,"[2, 3, 5, 3, 5, 8, 2, 3, 5, 3, 5, 8, 3, 3, 3, 5, 5, 5, 7]"
踏歌 ,无名氏,仄仄。仄平平仄仄平平仄。仄平平、仄仄平平仄。仄平平仄仄平平仄。仄仄。仄仄平平仄平平仄。平平仄、仄仄平平仄。仄仄平平仄平平仄。仄平仄仄仄平仄。平平仄、仄仄平平仄。平仄仄平平，仄仄平平仄。平仄平仄平平仄。,0,39,45,84,"[2, 8, 3, 5, 8, 2, 8, 3, 5, 8, 7, 3, 5, 5, 5, 7]"
秋夜月 ,尹鹗,平平平仄。仄平平，平仄仄，平平平仄。仄仄平平平仄，仄平平仄。平平仄，平平仄，仄平平仄。平仄、仄仄仄平平仄。平平平仄。仄平平，平仄仄，仄平平仄。仄仄平平平仄，仄平平仄。仄平平，平仄仄，平平仄仄。仄平、平仄仄平平仄。,0,45,39,84,"[4, 3, 3, 4, 6, 4, 3, 3, 4, 2, 6, 4, 3, 3, 4, 6, 4, 3, 3, 4, 2, 6]"
秋夜月 ,柳永,平平仄仄。仄仄仄、平平仄平平仄。仄仄平，仄平平仄平平仄。仄平平，平仄仄，仄仄平平平仄。仄仄仄平平仄。平平仄仄。仄仄仄仄平，仄仄平平仄。仄仄仄平平仄，仄仄平仄。仄平仄，平仄仄，仄平平仄。仄仄平平，仄平平仄。,0,35,48,83,"[4, 3, 6, 3, 7, 3, 3, 6, 6, 4, 5, 5, 6, 4, 3, 3, 4, 4, 4]"
祭天神 ,柳永,仄仄平平仄平平仄。仄平平、仄仄平平平仄仄。平平仄仄平平，仄仄平平仄。仄平平仄仄平平，平平仄。仄仄仄、平平仄。仄平仄、平仄平平仄。平平仄，平仄仄，仄仄平平仄。仄平平、平平平仄，平仄平平，仄仄平平，仄仄平平仄。,0,44,40,84,"[8, 3, 7, 6, 5, 7, 3, 3, 3, 3, 5, 3, 3, 5, 3, 4, 4, 4, 5]"
祭天神 ,柳永,仄仄平平仄平平仄。平平仄、平仄平平，平仄仄平平仄。平平仄仄，仄仄平平仄平仄。平平仄、平仄平平，仄仄仄平平仄。仄平平平仄，仄平仄仄平平仄。仄平平仄平平，平平仄平仄。仄平仄平平，平平平仄，仄平平仄、仄仄平平仄。,0,47,39,86,"[8, 3, 4, 6, 4, 7, 3, 4, 6, 5, 7, 6, 5, 5, 4, 4, 5]"
鹤冲天 ,柳永,平平仄仄，仄仄平平仄。仄仄仄平仄，平平仄。仄平平仄仄，平平仄、平平仄。平仄平平仄。仄平仄仄，仄仄仄平仄仄。平平仄仄平平仄。平仄平仄仄，平平仄。仄仄平平仄，平仄仄、平平仄。仄仄平仄仄。平平平仄，仄平仄仄平仄。,0,37,47,84,"[4, 5, 5, 3, 5, 3, 3, 5, 4, 6, 7, 5, 3, 5, 3, 3, 5, 4, 6]"
鹤冲天 ,杜安世,平平平仄。仄仄平平仄。平仄仄平平，平平仄。仄仄平平仄，平平仄，平平仄。仄仄平平仄。平仄平平，仄平仄仄平仄。仄平仄仄，仄仄平平仄。平仄仄平平，平平仄。仄仄平平仄，平平仄、平平仄。平仄平平仄。仄仄平平，仄平平平平仄。,0,46,40,86,"[4, 5, 5, 3, 5, 3, 3, 5, 4, 6, 4, 5, 5, 3, 5, 3, 3, 5, 4, 6]"
鹤冲天 ,柳永,平平仄仄。仄仄平平仄。平仄仄平平，平平仄。仄仄平平仄，平仄仄平平仄。平平平仄仄。平仄平平，仄仄仄平平仄。平平仄仄，平仄平平平仄。仄仄仄平平，平平仄。仄仄平平仄仄，平平仄、平平仄。平平平仄仄。仄仄平平，仄仄仄平平仄。,0,45,43,88,"[4, 5, 5, 3, 5, 6, 5, 4, 6, 4, 6, 5, 3, 6, 3, 3, 5, 4, 6]"
少年游慢 ,张先,平平平仄仄。仄仄平平仄仄。平仄平平，平平平仄，平平仄。平仄平平仄，仄仄平平仄。平仄平平，仄平仄仄平仄。仄仄平平仄。平仄平平平仄。仄仄平平，平平平仄，平平仄。平仄平平仄，仄仄平平仄。仄仄平平，平平仄平平仄。,0,47,37,84,"[5, 6, 4, 4, 3, 5, 5, 4, 6, 5, 6, 4, 4, 3, 5, 5, 4, 6]"
兀令 ,贺铸,平仄平平平仄仄。仄平平仄。平仄平平仄。仄平仄平平，仄仄平平仄。平仄仄仄平平，仄仄平平仄。仄仄平平仄。仄仄平平平仄仄。仄平平仄。平仄平平仄。仄仄仄平平，仄仄平平仄。仄仄平仄平平，平仄平平仄。仄仄平平仄。,0,41,43,84,"[7, 4, 5, 5, 5, 6, 5, 5, 7, 4, 5, 5, 5, 6, 5, 5]"
踏青游 ,苏轼,仄仄平平，仄仄仄平平仄。仄仄仄、仄平平仄。仄平平，仄仄仄，仄平平仄。平仄仄。平平仄平平仄。平仄仄平平仄。平仄平平，平仄仄平平仄。仄平仄、仄平平仄。仄平平，平仄仄，平平平仄。平仄仄。平平仄平仄仄。平平仄仄平仄。,0,40,44,84,"[4, 6, 3, 4, 3, 3, 4, 3, 6, 6, 4, 6, 3, 4, 3, 3, 4, 3, 6, 6]"
踏青游 ,陈济翁,仄仄平平，平仄仄平平仄。仄仄平、平平平仄。仄平平，平仄仄，平平仄仄。仄仄仄。仄平仄平平仄，平仄仄平平仄。平仄平平，仄仄仄平平仄。仄仄仄、平平平仄。仄平平，平平仄，平平平仄。仄平仄。仄仄平平平仄，仄平仄平平仄。,0,42,42,84,"[4, 6, 3, 4, 3, 3, 4, 3, 6, 6, 4, 6, 3, 4, 3, 3, 4, 3, 6, 6]"
踏青游 ,王诜,平仄平平，平平仄平平仄。仄仄仄、平平平仄。仄平平，平仄仄，仄平平仄。仄仄仄，平平仄平平仄，平仄仄平平仄。仄仄平平，平平仄平平仄。仄仄仄、平平仄仄。仄平平，平仄仄，平平平仄。仄仄仄，平平仄平平仄，仄仄仄平平仄。,0,42,42,84,"[4, 6, 3, 4, 3, 3, 4, 3, 6, 6, 4, 6, 3, 4, 3, 3, 4, 3, 6, 6]"
踏青游 ,无名氏,仄仄平平，仄仄仄平平仄。仄仄仄、仄仄平仄。仄平平、平平仄，平平仄。仄平仄。平仄仄平仄仄。仄仄仄平平仄。仄仄仄平，平平仄平平仄。仄仄仄、平平平仄。平平仄平平，仄仄平平仄。仄仄仄。仄平仄平平仄，仄仄仄平平仄。,0,35,48,83,"[4, 6, 3, 4, 3, 3, 3, 3, 6, 6, 4, 6, 3, 4, 5, 5, 3, 6, 6]"
梦玉人引 ,沈会宗,平仄平仄，平平仄，仄平仄。仄仄平平，仄仄仄平平仄。仄仄平平，仄仄平、仄仄平平仄。仄仄平平，仄仄平平仄。仄平平仄，仄仄平、平仄仄平仄。仄仄平平，仄平平仄平仄。平仄仄平，仄平平平仄。仄平仄平平，仄仄仄、仄平平仄。,0,38,46,84,"[4, 3, 3, 4, 6, 4, 3, 5, 4, 5, 4, 3, 5, 4, 6, 4, 5, 5, 3, 4]"
梦玉人引 ,李甲,仄平平仄，仄平平，仄平仄。仄仄平平，仄平平平平仄。仄仄平平，仄仄平平仄仄平仄。平仄平平，仄仄平平仄。仄平平仄，平平仄、仄仄仄平仄。仄平平平，仄平仄平平仄。平仄仄仄，平平平平仄。仄平仄平，平平仄仄，平平平仄。,0,44,40,84,"[4, 3, 3, 4, 6, 4, 8, 4, 5, 4, 3, 5, 4, 6, 4, 5, 4, 4, 4]"
梦玉人引 ,朱敦儒,仄平平仄，仄平平，仄平仄。仄仄平平，仄平仄平平仄。仄仄平平，仄仄平、仄仄平平仄。平仄平平，仄平平平仄。仄平平仄，仄平平、平仄仄平仄。仄仄平平，仄平平仄平仄。平仄平平，平仄平平仄。仄平平、仄平平，仄仄平平平仄。,0,45,39,84,"[4, 3, 3, 4, 6, 4, 3, 5, 4, 5, 4, 3, 5, 4, 6, 4, 5, 3, 3, 6]"
梦玉人引 ,范成大,仄平平仄，平平仄，仄平仄。平仄平平，平仄仄平平仄。平仄平平，仄仄平仄仄、平平平仄。仄仄平平，仄仄平平仄。仄平平仄，仄仄平、仄仄仄平仄。仄仄平平，仄平平仄平仄。平仄平平，平平平平仄。仄仄仄、仄平平，仄仄平平平仄。,0,43,42,85,"[4, 3, 3, 4, 6, 4, 5, 4, 4, 5, 4, 3, 5, 4, 6, 4, 5, 3, 3, 6]"
梦玉人引 ,吕渭老,仄平平仄，仄仄仄，仄平平。仄仄平平，仄平平仄平平。仄仄平平，仄仄平、平仄平平。仄仄仄平，仄平仄平平。仄平平仄，平仄仄、平仄仄平平。仄仄平平，仄平平仄平平。仄仄平平仄，平平平仄平。仄平仄，仄平平、仄仄平平。,0,43,39,82,"[4, 3, 3, 4, 6, 4, 3, 4, 4, 5, 4, 3, 5, 4, 6, 5, 5, 3, 3, 4]"
蕙兰芳引 ,周邦彦,平仄仄平，仄平仄、仄平平仄。仄仄仄平平，平仄仄平仄仄。仄平仄仄，仄仄仄、仄平平仄。仄仄平仄仄，仄仄平平平仄。仄仄平平，平平平仄，仄仄平仄。仄平仄平平，平仄仄平仄仄。平平平仄，仄平仄仄。平仄平、平仄仄平平仄。,0,36,48,84,"[4, 3, 4, 5, 6, 4, 3, 4, 5, 6, 4, 4, 4, 5, 6, 4, 4, 3, 6]"
倾杯近 ,袁去华,仄仄平平仄仄，平仄平平仄。仄仄平平仄仄，仄平平仄仄。平平仄仄，平仄平平平仄仄。仄平平、仄平平仄仄平仄。仄仄平，仄平仄，仄仄平平仄。仄仄平平，仄仄平平平平仄。平平仄仄，仄仄平平平平仄。仄平平、仄平平仄仄。,0,40,44,84,"[6, 5, 6, 5, 4, 7, 3, 7, 3, 3, 5, 4, 7, 4, 7, 3, 5]"
清波引 ,姜夔,仄平平仄。仄平仄、仄平仄仄。仄平平仄。仄平仄平仄。仄仄仄平仄，仄仄平平平仄。仄平平仄平平，仄平仄、仄平仄。平平仄仄。仄平仄、平仄仄仄。仄平平仄。仄平仄平仄。平平仄平仄，仄仄平平平仄。仄仄平仄平平，仄平平仄。,0,37,47,84,"[4, 3, 4, 4, 5, 5, 6, 6, 3, 3, 4, 3, 4, 4, 5, 5, 6, 6, 4]"
清波引 ,张炎,平平平仄。仄仄仄、仄平仄仄。仄平平仄。平仄仄平仄。仄仄平平仄。仄仄平平平仄。仄平仄仄平平，平平仄、仄平仄。平平仄仄。仄仄平平仄仄。仄平平仄。仄平仄平仄。平仄平平仄。仄仄仄平平仄。平平仄仄平平，仄平仄仄。,0,37,46,83,"[4, 3, 4, 4, 5, 5, 6, 6, 3, 3, 4, 6, 4, 5, 5, 6, 6, 4]"
簇水 ,赵长卿,平仄平平，仄平仄仄平平仄。仄平平仄，仄仄仄、平平平仄。仄仄平平平仄，仄仄平平仄。平仄仄、仄仄平仄。仄平仄。仄仄仄、仄平仄仄，仄仄仄、平平仄。平平仄仄，仄仄仄平平仄。仄仄仄平平仄，仄仄平平仄。平平仄、平仄平平仄。,0,35,50,85,"[4, 7, 4, 3, 4, 6, 5, 3, 4, 3, 3, 4, 3, 3, 4, 6, 6, 5, 3, 5]"
受恩深 ,柳永,仄仄平平仄。平平平仄仄。仄平平仄仄平仄。仄仄仄平平，仄仄仄仄平平仄。平仄平平仄。仄仄仄平平，平仄仄仄。仄仄平平平仄仄。仄仄平平，平仄平平平仄。仄仄仄平平，仄平仄仄平平仄。平仄平平仄。仄平仄平平，仄平平仄。,0,40,46,86,"[5, 5, 7, 5, 7, 5, 5, 4, 7, 4, 6, 5, 7, 5, 5, 4]"
婆罗门令 ,柳永,仄平仄、仄平平仄。平平仄、仄仄平平仄。仄仄平平，平平仄、平平仄。平仄仄，平仄平平仄。平平仄，平仄仄。仄平平、仄仄平平仄。平平仄仄平平仄，平仄仄、仄平仄平仄。仄平仄仄，仄仄平仄。仄仄平平，仄仄平仄平平仄。仄仄平平仄。,0,40,46,86,"[3, 4, 3, 5, 4, 3, 3, 3, 5, 3, 3, 3, 5, 7, 3, 5, 4, 4, 4, 7, 5]"
华胥引 ,周邦彦,平平平仄，平仄平平，仄平仄仄。仄仄平平，平平仄仄平仄仄。仄仄平仄平平，仄仄平平仄。平仄平平，仄平平仄平仄。平仄平平，仄平平、仄平平仄。仄平平仄，平平平平仄仄。仄仄平平平仄，仄仄平平仄。平仄平平，仄平平仄平仄。,0,47,39,86,"[4, 4, 4, 4, 7, 6, 5, 4, 6, 4, 3, 4, 4, 6, 6, 5, 4, 6]"
五福降中天 ,江致和,仄平平平仄，仄仄仄仄平平。平仄仄平平，仄仄平平。平仄平平仄仄，仄仄平平仄平。仄仄平平，仄平仄仄仄平平。平平仄仄，仄仄仄、平平仄平。仄仄仄平平仄，仄仄平平。平平仄仄，仄仄仄平平仄平。仄仄平平，仄平平仄仄平平。,0,41,45,86,"[5, 6, 5, 4, 6, 6, 4, 7, 4, 3, 4, 6, 4, 4, 7, 4, 7]"
离别难 ,薛昭蕴,仄仄仄仄平平。平平仄仄平平。仄平平仄仄。仄平平仄仄。仄平平仄仄，仄平平。平仄仄。平平仄。平平平仄仄平平。平仄仄。平平仄。平仄平。平平仄仄平平。仄仄平平仄。仄仄平平仄。仄平仄、仄平平。平仄仄。平平仄。平平平仄仄平平。,0,46,41,87,"[6, 6, 5, 5, 5, 3, 3, 3, 7, 3, 3, 3, 6, 5, 5, 3, 3, 3, 3, 7]"
离别难 ,柳永,平仄仄平仄仄，平平仄平平。仄平平、仄仄平平。仄平平、平仄仄平平。仄平仄、仄仄平平，平平平仄，平仄平平。仄平平、仄仄平平平仄，平仄仄平平。平仄仄，仄平平。仄平平、仄仄平平。仄平平仄仄平仄，仄平平平仄仄平平。仄仄仄、仄仄平平，平平平仄，平仄平平。仄仄仄、仄仄平平仄仄，平仄仄平平。,0,60,52,112,"[6, 5, 3, 4, 3, 5, 3, 4, 4, 4, 3, 6, 5, 3, 3, 3, 4, 7, 8, 3, 4, 4, 4, 3, 6, 5]"
江城梅花引 ,程垓,平平平仄仄平平。仄平平。仄平平。仄仄仄平，仄仄仄平平。仄仄仄平平仄仄，仄平仄，仄平平、仄仄平。仄平。仄平。仄平平。仄仄平。平仄平。仄仄仄仄，仄仄仄、平仄平平。平仄平平，平仄仄平平。仄仄仄平平仄仄，平仄仄，仄平平、仄仄平。,0,40,47,87,"[7, 3, 3, 4, 5, 7, 3, 3, 3, 2, 2, 3, 3, 3, 4, 3, 4, 4, 5, 7, 3, 3, 3]"
江城梅花引 ,赵汝茪,仄平平仄仄平平。仄平平。仄平平。仄仄平平，仄仄仄平平。平仄仄平平仄仄，平仄仄，仄平平、平仄平。仄平。仄平。仄仄平。仄仄平。仄仄平。仄平仄平。仄平平、平仄平平。仄仄平平，平仄仄平平。平仄仄平平仄仄，平仄仄，仄平平、仄仄平。,0,44,43,87,"[7, 3, 3, 4, 5, 7, 3, 3, 3, 2, 2, 3, 3, 3, 4, 3, 4, 4, 5, 7, 3, 3, 3]"
江城梅花引 ,吴文英,平平平仄仄平平。仄平平。仄平平。仄仄仄平，仄仄仄平平。仄仄平平平仄仄，仄平平。平平仄仄仄平。仄平仄仄仄平平。仄平平。平仄平。仄平仄仄，仄平仄、仄仄平平。平仄平平，平仄仄平平。仄仄平平平仄仄，仄平平。仄平仄仄仄平。,0,44,43,87,"[7, 3, 3, 4, 5, 7, 3, 6, 7, 3, 3, 4, 3, 4, 4, 5, 7, 3, 6]"
江城梅花引 ,周密,仄平平仄仄平平。仄平平。仄平平。仄仄平平，平仄仄平平。平仄平平平仄仄，平仄仄，仄平平、仄仄平。平平仄平平仄平。仄平平，平仄平。平平仄仄，平平仄、仄仄平平。仄仄平平，平仄仄平平。仄仄仄平平仄仄，平仄仄，仄平平、仄仄平。,0,47,40,87,"[7, 3, 3, 4, 5, 7, 3, 3, 3, 7, 3, 3, 4, 3, 4, 4, 5, 7, 3, 3, 3]"
江城梅花引 ,王观,平平平仄仄平平。仄平平。仄平平。平仄仄平，平仄仄平平。仄仄仄平平仄仄，仄平仄，平平仄、仄仄平。仄仄仄仄仄仄仄。仄仄平，平仄仄。仄平仄仄。仄平仄、仄仄平平。仄仄平平，仄仄仄平平。平仄平平平仄仄，仄平仄，仄平平、仄仄平。,0,38,49,87,"[7, 3, 3, 4, 5, 7, 3, 3, 3, 7, 3, 3, 4, 3, 4, 4, 5, 7, 3, 3, 3]"
江城梅花引 ,周密,平平平仄仄平平。仄平平。仄平平。仄仄平平，平仄仄平平。仄仄平平平仄仄，仄平仄，仄平平、平仄平。仄平仄平仄平仄。仄仄平，平仄仄。仄平仄仄，平平仄、平仄平平。仄仄平平，平仄仄平平。仄仄平平平仄仄，平平仄，仄平平、仄仄平。,0,46,41,87,"[7, 3, 3, 4, 5, 7, 3, 3, 3, 7, 3, 3, 4, 3, 4, 4, 5, 7, 3, 3, 3]"
江城梅花引 ,李献能,仄平平仄仄平平。仄平平。仄平平。仄仄平平，平仄仄平平。仄仄仄平平仄仄，仄平仄，平平仄仄平。仄仄平平平仄仄。仄平平，平仄平。平平仄仄仄平仄，仄仄平平。仄仄平平，平仄仄平平。平仄仄平平仄仄，仄平仄，平平仄仄平。,0,43,42,85,"[7, 3, 3, 4, 5, 7, 3, 5, 7, 3, 3, 7, 4, 4, 5, 7, 3, 5]"
寰海清 ,王庭珪,仄仄平平。仄平平仄，平仄平平。平仄仄平仄仄，平仄平平。平平仄平仄，平平仄，平仄仄、平仄平平。平平仄仄平平。仄仄仄、仄平仄仄平平。平仄平平，仄仄仄仄平平。平平仄仄仄平仄，仄平平仄仄平平。仄平平仄仄，仄平平、仄平平。,0,46,41,87,"[4, 4, 4, 6, 4, 5, 3, 3, 4, 6, 3, 6, 4, 6, 7, 7, 5, 3, 3]"
劝金船 ,苏轼,平平平仄平平仄。仄仄平平仄。平平仄仄平平仄。仄平仄平仄。仄仄平平，仄仄仄平平仄。平仄仄平平仄，仄仄平仄。平平仄仄平平仄。仄仄平平仄。平平仄仄平平仄。仄平仄平仄。仄仄平平，仄仄仄平平仄。仄仄仄平平仄，平仄平仄。,0,41,47,88,"[7, 5, 7, 5, 4, 6, 6, 4, 7, 5, 7, 5, 4, 6, 6, 4]"
劝金船 ,张先,平平仄仄平平仄。仄仄平平仄。平平仄仄平平仄。仄平仄平仄。仄仄仄平仄，仄仄仄、仄平平仄。平仄仄平，平仄仄平平仄。平平平仄平平仄。仄仄平平仄。平平仄仄平平仄，仄平仄平仄。仄仄仄平平，仄仄仄、平平平仄。仄仄仄平平仄，仄平平仄。,0,42,50,92,"[7, 5, 7, 5, 5, 3, 4, 4, 6, 7, 5, 7, 5, 5, 3, 4, 6, 4]"
醉思仙 ,吕渭老,仄平平。仄平平仄仄，平仄平平。仄平平平仄，仄仄平平。平仄仄，平平仄，仄仄仄平平。仄平平，仄仄仄，仄平平仄平平。仄仄平平仄，平平仄仄平平。仄平平平仄，仄仄平平。平平仄，平平仄，仄仄仄、仄平平。仄平平，仄仄仄，仄平仄仄平平。,0,45,43,88,"[3, 5, 4, 5, 4, 3, 3, 5, 3, 3, 6, 5, 6, 5, 4, 3, 3, 3, 3, 3, 3, 6]"
醉思仙 ,孙道绚,仄平平。仄平平仄仄，平仄平平。仄平平平仄，平仄平平。平仄仄，仄平平，仄平仄、仄平平。仄平平，仄仄仄，仄平平仄平平。平仄平平仄，仄平平仄平平。仄平平仄仄，平仄平平。仄仄仄，仄平平，仄仄仄、仄平平。仄平平，仄平仄，仄平平仄平平。,0,48,41,89,"[3, 5, 4, 5, 4, 3, 3, 3, 3, 3, 3, 6, 5, 6, 5, 4, 3, 3, 3, 3, 3, 3, 6]"
醉思仙 ,朱敦儒,仄平平。仄平平仄仄，仄仄平平。仄平平平仄，平仄平平。平平仄，平平仄，仄仄仄、平仄平平。仄仄平，仄仄平仄仄，仄仄平平。平仄平仄仄，平平仄仄平平。仄仄平平仄，仄仄平平。平仄仄，仄平平，仄平仄、平仄平平。仄平仄，仄仄平仄仄，平仄平平。,0,45,46,91,"[3, 5, 4, 5, 4, 3, 3, 3, 4, 3, 5, 4, 5, 6, 5, 4, 3, 3, 3, 4, 3, 5, 4]"
醉思仙 ,曹勛,仄平平。仄仄平仄仄，平仄平平。仄平平仄仄，仄仄平平。平平仄，平仄仄，仄仄仄、仄仄平平。平平仄，仄仄仄仄仄，平仄平平。平仄平平仄，平平仄仄平平。仄仄平仄仄，平仄平平。仄平仄，平平仄，仄仄仄、仄仄平平。仄平平，仄仄仄，仄平平仄平平。,0,42,49,91,"[3, 5, 4, 5, 4, 3, 3, 3, 4, 3, 5, 4, 5, 6, 5, 4, 3, 3, 3, 4, 3, 3, 6]"
玉人歌 ,杨炎昶,平平仄。仄仄仄平平，平平平仄。仄平平仄，仄仄仄平仄。平平仄仄平平仄，仄仄平平仄。仄平平、平仄平平，仄平仄仄。平仄仄平仄。仄平仄平平，仄平仄仄。仄仄平平，仄仄仄平仄。平平平仄平平仄，仄仄平平仄。仄平平、仄仄平平仄仄。,0,42,46,88,"[3, 5, 4, 4, 5, 7, 5, 3, 4, 4, 5, 5, 4, 4, 5, 7, 5, 3, 6]"
惜红衣 ,姜夔,仄仄平平，平平仄仄。仄平平仄。仄仄平平，平平仄平仄。平平仄仄，平仄仄、平平平仄。平仄。平仄仄平，仄平平平仄。平平仄仄。平仄平平，平平仄平仄。平平仄仄仄仄。仄平仄。仄仄仄平平仄，仄仄仄平平仄。仄仄平平仄，平仄仄平平仄。,0,43,45,88,"[4, 4, 4, 4, 5, 4, 3, 4, 2, 4, 5, 4, 4, 5, 6, 3, 6, 6, 5, 6]"
惜红衣 ,李莱老,仄仄平平，平平仄仄。仄平平仄。平仄平平，平平仄平平仄。平平仄仄，仄仄仄、平平平仄。平仄。平仄仄平，仄平平平仄。平平仄仄。平仄平平，平平仄平仄。平平平仄仄仄。仄平仄。仄仄仄平平仄，仄仄仄平平仄。仄平平平仄，平仄仄平平仄。,0,46,43,89,"[4, 4, 4, 4, 6, 4, 3, 4, 2, 4, 5, 4, 4, 5, 6, 3, 6, 6, 5, 6]"
惜红衣 ,吴文英,仄仄平平，平平仄仄，仄平仄仄。仄仄平平，平平仄平仄。平平仄仄平仄，仄平平、平仄平仄。平仄平平，平平平平仄。平平仄仄。仄仄平平，平平仄平仄。平平仄仄仄仄，仄平仄。平仄仄平平仄，平仄仄平平仄。仄仄平平仄，平仄平平平仄。,0,46,42,88,"[4, 4, 4, 4, 5, 6, 3, 4, 4, 5, 4, 4, 5, 6, 3, 6, 6, 5, 6]"
惜红衣 ,张炎,仄仄平平，平平仄仄，仄平平仄。仄仄平平，平平仄平仄。平平仄仄，平仄仄、平平平仄。平仄。仄仄仄平，仄平平平仄。平平仄仄，仄仄平平，平平仄平仄。平平仄仄，仄仄仄平仄。仄仄仄平平仄，仄仄平平平仄。仄仄平平仄，平仄仄平平仄。,0,42,46,88,"[4, 4, 4, 4, 5, 4, 3, 4, 2, 4, 5, 4, 4, 5, 4, 5, 6, 6, 5, 6]"
鱼游春水 ,无名氏,平平平平仄。仄仄平平平仄仄。平平平仄，平仄仄平平仄。仄仄平平仄仄平，仄仄平仄平平仄。平仄仄平，平平平仄。仄仄平平仄仄。仄仄仄平平平仄。平平平仄平平，平平仄仄。仄平平仄平平仄，仄仄平平平平仄。平平仄平，仄平平仄。,0,49,40,89,"[5, 7, 4, 6, 7, 7, 4, 4, 6, 7, 6, 4, 7, 7, 4, 4]"
鱼游春水 ,赵闻礼,平平平仄仄。平仄平平平仄仄。仄平平仄，仄仄仄平平仄。仄仄平平平仄仄。仄仄平平平仄仄。平仄仄平，仄平平仄。平仄平平仄仄。平仄平平平仄仄。平平仄仄平平，平平仄仄。仄仄平平平仄仄。仄仄平平平仄仄。平平仄仄，仄平平仄。,0,44,45,89,"[5, 7, 4, 6, 7, 7, 4, 4, 6, 7, 6, 4, 7, 7, 4, 4]"
卜算子慢 ,柳永,平平仄仄，平仄仄平，仄仄仄平平仄。仄仄平平，仄仄仄平平仄。仄平平、仄仄平平仄。仄仄仄、平平仄仄，平平仄仄平仄。仄仄平平仄。仄仄仄平平，仄平平仄。仄仄平平，仄仄仄平仄仄。仄平平、平仄平平仄。仄仄仄、平平仄仄，仄平平平仄。,0,38,51,89,"[4, 4, 6, 4, 6, 3, 5, 3, 4, 6, 5, 5, 4, 4, 6, 3, 5, 3, 4, 5]"
卜算子慢 ,张先,平平仄仄，平仄仄平，仄仄仄平平仄。仄仄平平，仄仄仄平平仄。平仄。仄平平仄仄平平仄。仄仄仄平平，仄仄平平仄仄平仄。仄仄平平仄。仄仄仄平平，仄平平仄。仄仄平平，仄仄仄平平仄。平仄。仄平平、仄仄平平仄。仄仄仄、平平仄仄，仄平平仄仄。,0,39,54,93,"[4, 4, 6, 4, 6, 2, 8, 5, 8, 5, 5, 4, 4, 6, 2, 3, 5, 3, 4, 5]"
雪狮儿 ,程垓,仄平平仄，平平仄仄，平平平仄。仄仄平平，平仄仄平平仄。平平仄仄。仄仄仄、平平平仄。平平仄、仄平平仄，仄平平仄。仄仄平平仄仄。仄平平、平仄仄平平仄。仄仄平平，仄仄平平平仄。平平仄仄。仄仄仄、平平平仄。平仄仄。仄仄仄平平仄。,0,43,46,89,"[4, 4, 4, 4, 6, 4, 3, 4, 3, 4, 4, 6, 3, 6, 4, 6, 4, 3, 4, 3, 6]"
雪狮儿 ,张雨,平平仄仄，仄平仄、平仄平平，平平平仄。仄仄平平，仄仄平平平仄。平平仄仄。仄仄仄、仄平平仄。仄仄仄、平平仄仄，平平平仄。仄平平平仄仄。仄平平、仄仄仄平平仄。平仄平平，仄仄仄平平仄。仄平仄仄。平仄仄、平平平仄。平平仄。仄仄平平平仄。,0,45,47,92,"[4, 3, 4, 4, 4, 6, 4, 3, 4, 3, 4, 4, 6, 3, 6, 4, 6, 4, 3, 4, 3, 6]"
石湖仙 ,姜夔,平平平仄。仄平仄平平，平仄平仄。平仄仄平平，仄平平、平平仄仄。平平平仄，仄仄仄、仄平平仄。平仄。仄仄平、仄仄平仄。平平仄平仄仄，仄平平、平平仄仄。仄仄平平，仄仄平平平仄。仄仄平平，仄平平仄。仄平平仄。平仄仄。平平仄仄平仄。,0,45,44,89,"[4, 5, 4, 5, 3, 4, 4, 3, 4, 2, 3, 4, 6, 3, 4, 4, 6, 4, 4, 4, 3, 6]"
八六子 ,杜牧,仄平平。仄平平仄，平仄平仄平平。仄仄仄仄仄平平，平仄平平仄仄，平平仄平仄平。平平仄平平仄，仄仄平平，平仄平平。仄仄平平。仄平平、平平仄平平仄，仄平平仄，仄平平仄，平仄、仄仄平平仄仄，平平仄仄平平。仄平平，平平仄平仄平。,0,51,39,90,"[3, 4, 6, 7, 6, 6, 6, 4, 4, 4, 3, 6, 4, 4, 2, 6, 6, 3, 6]"
八六子 ,晁补之,仄平平。仄平平仄，平平平仄平平。仄仄仄平仄平平，平仄平平仄仄，平平仄平仄平。平平仄仄平平。仄仄平平平仄，平平仄仄平平。仄仄仄平平，仄平平仄，仄平平仄，仄仄平平。平平仄、仄仄平平仄仄，平平仄仄平平。仄平平。平平仄平仄平。,0,52,39,91,"[3, 4, 6, 7, 6, 6, 6, 6, 6, 5, 4, 4, 4, 3, 6, 6, 3, 6]"
八六子 ,杨缵,仄平平。仄平平仄，仄平平仄平平。仄仄仄平平平仄，仄平平仄，平平仄仄平平。平平仄仄平平。平仄平平平仄，平平仄仄平平。仄仄仄平平，仄平平仄，仄平仄仄，仄平平仄平平。仄仄平平仄仄，仄平平仄平平。仄平平。仄平平、仄平仄平。,0,50,39,89,"[3, 4, 6, 7, 4, 6, 6, 6, 6, 5, 4, 4, 6, 6, 6, 3, 3, 4]"
八六子 ,秦观,仄平平。仄平平仄，平平仄仄平平。仄仄仄平平仄仄，仄平平仄平平，仄平仄平。平平平仄平平。仄仄仄平平仄，平平仄仄平平。仄平仄平平，仄平平仄，仄平平仄，仄平平仄，仄平仄仄平平仄仄，平平平仄平平。仄平平。平平仄平仄平。,0,50,38,88,"[3, 4, 6, 7, 6, 4, 6, 6, 6, 5, 4, 4, 4, 8, 6, 3, 6]"
八六子 ,李演,仄平平，仄平平仄，平平仄仄平平。仄仄仄仄平平仄，仄平平仄平平。平平仄平。平平平仄平平。平仄仄平仄仄，仄平仄仄平平。仄仄仄平平，仄平平仄，仄平平仄，仄平平仄，平平仄仄平平仄仄，平平仄仄平平。仄平平。平平仄平仄平。,0,49,39,88,"[3, 4, 6, 7, 6, 4, 6, 6, 6, 5, 4, 4, 4, 8, 6, 3, 6]"
八六子 ,王沂孙,仄平平。仄平平仄，平平仄仄平平。仄仄仄平平仄仄，仄平平仄平平。仄平仄平。平平。平仄平平。仄仄平平平仄，平平仄仄平平。仄仄仄平平，平平平仄，仄平平仄，平平平仄，平平仄仄平平仄仄，平平平仄平平。仄平平。平平仄平仄平。,0,53,35,88,"[3, 4, 6, 7, 6, 4, 2, 4, 6, 6, 5, 4, 4, 4, 8, 6, 3, 6]"
谢池春慢 ,张先,仄平平仄，平平仄、平平仄。仄仄仄平平，仄仄平平仄。平仄平平仄，平仄平平仄。仄平平，平仄仄。仄平平仄，平仄平平仄。平平仄仄，平仄仄、平平仄。仄仄平平仄，平仄平平仄。仄仄平平仄，仄仄平平仄。平平仄，平仄仄。平平平仄，平仄平平仄。,0,47,43,90,"[4, 3, 3, 5, 5, 5, 5, 3, 3, 4, 5, 4, 3, 3, 5, 5, 5, 5, 3, 3, 4, 5]"
采桑子慢 ,吴礼之,平平仄仄，仄仄仄仄平平。仄平仄、平平平仄，仄仄平平。仄仄平平。仄平平仄仄平平。仄平平仄，平平仄仄，仄仄平平。平仄仄平平仄，平平平仄平平。仄平仄、平平平仄，仄仄平平。平仄平平。仄平仄仄仄平平。仄平平仄，仄仄仄仄，仄仄平平。,0,46,44,90,"[4, 6, 3, 4, 4, 4, 7, 4, 4, 4, 6, 6, 3, 4, 4, 4, 7, 4, 4, 4]"
采桑子慢 ,蔡伸,平平仄仄，仄仄平平平仄。仄仄仄平平，仄仄仄仄平平。仄仄平平，仄平平仄平平仄。平平平仄，平平仄仄，平平平仄。平仄仄平，仄平平仄，仄平平仄。仄平仄、平平平仄，仄平平平。平仄平平。平平平仄仄平平。平平仄仄，仄平仄仄，平仄平平。,0,50,40,90,"[4, 6, 5, 6, 4, 7, 4, 4, 4, 4, 4, 4, 3, 4, 4, 4, 7, 4, 4, 4]"
采桑子慢 ,潘元质,平平仄仄，平仄平平平仄。仄平仄平平平仄，仄仄平平。平仄平平，仄平平仄仄平平。仄平平仄，平平仄仄，平仄平平。仄仄仄平，仄平平仄，平仄平平。仄平仄、平平平仄，仄仄平平。仄仄平平，仄平平仄仄平平。平平平仄，平平仄仄，仄仄平平。,0,51,39,90,"[4, 6, 7, 4, 4, 7, 4, 4, 4, 4, 4, 4, 3, 4, 4, 4, 7, 4, 4, 4]"
采桑子慢 ,辛弃疾,平平平仄，仄仄仄仄平仄。仄仄仄平平，平仄仄平平仄。平平仄仄，平仄仄、仄仄平平。仄平平仄平平，平仄仄仄仄仄。仄仄平平，平平仄仄，仄平平仄。平仄仄平平，仄仄仄平平仄。仄仄仄平，仄仄平、仄仄仄仄。仄平平仄，平平仄仄，仄仄仄仄。,0,36,54,90,"[4, 6, 5, 6, 4, 3, 4, 6, 6, 4, 4, 4, 5, 6, 4, 3, 4, 4, 4, 4]"
采桑子慢 ,无名氏,仄仄仄平，平仄平平平仄。仄平仄、平平平仄，仄仄平平。仄仄平平，仄平平仄仄平平。平仄平平，平平仄仄，仄仄平平。平平平仄，仄平平仄，平仄平平。仄平平平仄，仄仄平仄平平。平平仄仄，平平仄仄平平。仄平平仄，平平仄仄，仄仄平平。,0,50,39,89,"[4, 6, 3, 4, 4, 4, 7, 4, 4, 4, 4, 4, 4, 5, 6, 4, 6, 4, 4, 4]"
探芳信 ,史达祖,仄平仄。仄仄仄平平，平平平仄。仄仄平平仄，平仄仄平仄。仄平平仄平平仄，仄仄平平仄。仄平平、仄仄平平，仄平平仄。仄仄仄平仄。仄仄仄平平，平平平仄。仄仄平平，仄平仄、仄平仄。仄平仄仄平平仄，仄仄平平仄。仄平平，仄仄平平仄仄。,0,41,49,90,"[3, 5, 4, 5, 5, 7, 5, 3, 4, 4, 5, 5, 4, 4, 3, 3, 7, 5, 3, 6]"
探芳信 ,吴文英,仄平仄。仄仄仄平平，平平仄仄。仄仄平平仄，平平仄平仄。仄平平仄平平仄，仄仄平平仄。仄平平、仄仄平平，仄平平仄。平仄平平仄，仄仄仄平平，平仄平仄。仄仄平平，仄平仄、仄平仄。仄平平仄平平仄，仄仄平平仄。仄平平、仄仄平平仄仄。,0,43,47,90,"[3, 5, 4, 5, 5, 7, 5, 3, 4, 4, 5, 5, 4, 4, 3, 3, 7, 5, 3, 6]"
探芳信 ,吴文英,仄平仄。仄仄仄平平，平仄平仄。仄仄平仄仄，平平仄平仄。平平仄仄平平仄，仄仄平平仄。仄仄平平，仄平平、仄平平仄。平仄平平仄。仄仄仄仄平，平平仄仄。仄仄平平，仄平仄、仄平仄。仄平仄仄平平仄，仄仄平平仄。仄平平、仄仄平平仄仄。,0,40,50,90,"[3, 5, 4, 5, 5, 7, 5, 4, 3, 4, 5, 5, 4, 4, 3, 3, 7, 5, 3, 6]"
探芳信 ,吴文英,仄平仄。仄仄平平平，仄平平仄。仄仄仄平平，平平仄平仄。仄平平仄平平仄，平仄平平仄。仄平平、仄仄平平，仄平平仄。平仄仄平仄。仄仄仄平平，仄平平仄。仄仄平平，平仄仄平仄。平平仄仄平平仄，平仄平平仄。仄平平、仄仄平平仄仄。,0,45,44,89,"[3, 5, 4, 5, 5, 7, 5, 3, 4, 4, 5, 5, 4, 4, 5, 7, 5, 3, 6]"
遥天奉翠华引 ,侯寘,仄平平仄平。仄平平、仄仄平平。平平仄仄，平平平仄平平。仄平平仄仄，仄仄平、平仄仄平平。仄仄平平，平平仄仄平平。平平仄仄，仄仄平、平仄仄平。仄平仄平，平仄平仄平平。仄仄平平仄，仄平平、平仄仄平平。平仄平平。仄平平、仄仄平平。,0,51,39,90,"[5, 3, 4, 4, 6, 5, 3, 5, 4, 6, 4, 3, 4, 4, 6, 5, 3, 5, 4, 3, 4]"
夏云峰 ,柳永,仄平平。平平仄、平仄仄仄平平。平仄仄平仄仄，仄仄平平。仄平平仄，平仄仄、仄仄平平。仄仄仄、平平仄仄，平仄平平。仄平仄仄平平。仄平仄、仄平平仄平平。平仄仄平仄仄，仄仄平平。仄平平仄，平仄仄、仄仄平平。仄仄仄、平平仄仄，平仄平平。,0,43,48,91,"[3, 3, 6, 6, 4, 4, 3, 4, 3, 4, 4, 6, 3, 6, 6, 4, 4, 3, 4, 3, 4, 4]"
夏云峰 ,曹勛,仄平平，仄仄仄，平平仄仄平平。平仄仄仄，仄仄仄仄平平。仄平平仄，平仄仄、仄仄平平。平仄仄、平平仄仄，仄仄平平。平平平仄平平。仄平平仄仄，平仄平平。平平仄仄，仄仄仄仄平平。仄平平仄，平仄仄、平仄平平。平仄仄、平平仄仄，仄仄平平。,0,44,47,91,"[3, 3, 6, 4, 6, 4, 3, 4, 3, 4, 4, 6, 5, 4, 4, 6, 4, 3, 4, 3, 4, 4]"
夏云峰 ,张元干,仄平平，平仄仄，平仄仄仄平平。平仄仄平仄仄，仄仄平平。仄平平仄，平仄仄、仄仄平平。仄仄、仄平平仄仄，仄仄平平。平平平仄仄平。仄平仄仄平，平仄平平。平仄仄平仄仄，仄仄平平。平平平仄，平仄仄、仄仄平平。仄仄、仄平平仄仄，平仄平平。,0,43,48,91,"[3, 3, 6, 6, 4, 4, 3, 4, 2, 5, 4, 6, 5, 4, 6, 4, 4, 3, 4, 2, 5, 4]"
夏云峰 ,无名氏,平仄平，平平仄，仄平平仄平平。平仄仄平平仄，仄仄平平。仄平平仄，仄仄仄、仄仄平平。仄仄仄、平平仄仄，仄仄平平。平平仄仄平平。仄平仄、仄仄平仄平平。平仄仄平，仄仄仄仄平平。仄平平仄，平仄仄、平仄平平。仄仄仄、仄平仄仄，平仄平平。,0,43,48,91,"[3, 3, 6, 6, 4, 4, 3, 4, 3, 4, 4, 6, 3, 6, 4, 6, 4, 3, 4, 3, 4, 4]"
夏云峰 ,赵长卿,仄平平。平仄仄、平平仄仄平平。平仄仄平，仄平平仄平平。仄平平仄，平仄仄、仄仄平平。仄仄仄、平平仄仄，仄仄平平。仄平平仄平平。仄平平、仄平平仄平平。仄仄仄平，仄平仄仄平平。平平平仄，仄仄仄仄仄平平。仄仄仄平平，仄仄平仄平平。,0,46,45,91,"[3, 3, 6, 4, 6, 4, 3, 4, 3, 4, 4, 6, 3, 6, 4, 6, 4, 7, 5, 6]"
采莲令 ,柳永,仄平平，平仄平平仄。平平仄、仄平平仄。仄平仄仄仄平平，仄仄平平仄。平平仄、平平仄仄，平平仄仄，仄平平仄平仄。仄仄平平，仄仄仄仄平平仄。平平仄、仄平平仄。仄平平仄，仄仄仄、仄仄平平仄。仄平仄、平平仄仄，平平平仄，仄仄仄平平仄。,0,43,48,91,"[3, 5, 3, 4, 7, 5, 3, 4, 4, 6, 4, 7, 3, 4, 4, 3, 5, 3, 4, 4, 6]"
醉翁操 ,苏轼,平平。平平。平平。仄平平。平平。平平仄平平平平。仄平平仄平平。平仄平。仄仄仄平平。仄仄平仄平仄平。仄平仄仄，平仄平平。仄平仄仄，平仄平平仄平。平仄平平平平。仄仄平平平平。平平平仄平。平平平平平。仄仄仄平平。仄平平仄平仄平。,0,60,31,91,"[2, 2, 2, 3, 2, 7, 6, 3, 5, 7, 4, 4, 4, 6, 6, 6, 5, 5, 5, 7]"
红芍药 ,王观,平平仄仄，仄仄平仄。仄平仄平平平仄。仄仄平平仄。平平仄仄仄，仄仄仄、仄平平仄。仄仄仄仄仄平平，平平平仄平仄。仄仄平平，仄平平仄仄。仄仄平平平仄仄。仄仄平平仄。仄仄仄平仄，平平仄、仄平平仄。仄平平、仄仄平平，仄仄平平平仄。,0,40,51,91,"[4, 4, 7, 5, 5, 3, 4, 7, 6, 4, 5, 7, 5, 5, 3, 4, 3, 4, 6]"
法曲献仙音 ,周邦彦,平仄平平，仄平平仄，仄仄平平平仄。仄仄平平，仄平平仄，平平仄平平仄。仄仄仄平平仄。平平仄平仄。仄平仄。仄平平、仄平平仄，平仄仄、平仄仄平仄仄。仄仄仄平平，仄平平、平仄平仄。平仄平平，仄平平、平仄平仄。仄平平仄仄，仄仄仄平平仄。,0,46,46,92,"[4, 4, 6, 4, 4, 6, 6, 5, 3, 3, 4, 3, 6, 5, 3, 4, 4, 3, 4, 5, 6]"
法曲献仙音 ,姜夔,平仄平平，仄平平仄，仄仄平平平仄。仄仄平平，仄平平仄，平平仄平平仄。仄仄仄、平平仄。平平仄平仄。仄平仄。仄平平、仄平仄仄。平仄仄、平仄仄平仄仄。平仄仄平平，仄平平、仄仄平仄。仄仄平平，仄平平、平仄平仄。仄仄平平仄，仄仄平平平仄。,0,45,47,92,"[4, 4, 6, 4, 4, 6, 3, 3, 5, 3, 3, 4, 3, 6, 5, 3, 4, 4, 3, 4, 5, 6]"
法曲献仙音 ,姜夔,平仄平平，仄平平仄，仄仄平平平仄。仄仄平平，仄平平仄，平平仄仄平仄。仄仄仄、平平仄，平平仄平仄。仄平仄。仄平平、仄平平仄，平仄仄、平仄仄平平仄。仄仄仄平平，仄平平、平仄平仄。仄仄平平，仄平平、仄仄仄仄。仄平平平仄，仄仄平平平仄。,0,45,47,92,"[4, 4, 6, 4, 4, 6, 3, 3, 5, 3, 3, 4, 3, 6, 5, 3, 4, 4, 3, 4, 5, 6]"
法曲献仙音 ,李彭老,平仄平平，仄平平仄，仄仄仄平平仄。仄仄平平，仄平平仄，平平仄平平仄。仄平仄、平平仄，平平仄平仄。仄平仄。仄平平、仄平平仄，平仄仄平平，仄平平仄。平仄仄平平，平仄仄、平平平仄。平仄平平，仄平仄平平仄仄。仄平平平仄，仄仄平平平仄。,0,50,42,92,"[4, 4, 6, 4, 4, 6, 3, 3, 5, 3, 3, 4, 5, 4, 5, 3, 4, 4, 7, 5, 6]"
法曲献仙音 ,柳永,平仄平平平仄，平平仄仄，平平仄仄。仄仄平平仄，仄平仄、平平平仄平仄。仄仄仄平平，平仄仄平仄。仄平仄。平平仄，仄平平平仄，仄平平仄平平仄。仄仄仄平仄，仄仄仄平平仄。仄仄平平，仄平平、仄仄平仄。仄平仄、平平仄仄，仄平平仄平仄。,0,43,48,91,"[6, 4, 4, 5, 3, 6, 5, 5, 3, 3, 5, 7, 5, 6, 4, 3, 4, 3, 4, 6]"
法曲献仙音 ,柳永,平仄平平，平仄平平，仄仄平平仄仄。仄仄平平仄，仄平仄平平，平平平仄。仄平仄、平平仄仄仄平仄。仄仄仄。仄平平，仄平平平仄，仄仄平仄平平仄。平仄仄、平仄仄平平仄。仄仄平平，仄平平、仄平仄仄。仄平仄、仄平平仄，仄平平仄。,0,42,45,87,"[4, 4, 6, 5, 5, 4, 3, 7, 3, 3, 5, 7, 3, 6, 4, 3, 4, 3, 4, 4]"
金盏倒垂莲 ,晁补之,平仄平平，仄平平仄仄，平仄平平。仄仄平平，仄仄仄平平。仄仄仄、平平平仄，仄平平仄平平。仄仄仄仄，平平仄仄平平。平平仄平仄仄，仄平平仄仄，平仄平平。仄仄平平，平仄仄平平。仄仄仄、平平平仄，仄平平仄平平。仄仄仄仄，平平仄仄平平。,0,47,45,92,"[4, 5, 4, 4, 5, 3, 4, 6, 4, 6, 6, 5, 4, 4, 5, 3, 4, 6, 4, 6]"
金盏倒垂莲 ,无名氏,平仄平平，仄平平平仄，仄仄平平。平仄平平，仄仄仄平平。仄仄仄平平仄，仄仄仄、仄仄平平。平仄平仄平平，仄仄平平。平平平平仄仄，仄仄平仄仄，仄仄平平。仄仄平平，平仄仄平平。仄仄仄平平仄，仄仄仄、平仄平平。平仄平仄平平，仄仄平平。,0,46,46,92,"[4, 5, 4, 4, 5, 6, 3, 4, 6, 4, 6, 5, 4, 4, 5, 6, 3, 4, 6, 4]"
金盏倒垂莲 ,曹勛,仄仄平平，仄仄平仄仄，仄平平仄。仄平平仄，仄平平平仄。仄平仄平仄仄，仄仄仄、平平平仄。仄仄仄仄，平平仄平平仄。平平仄平仄仄。平仄仄、仄仄平平平仄。仄平平仄。仄平平平仄。仄平仄平仄仄，仄仄仄、平平平仄。平平仄仄，仄仄平平仄仄。,0,40,52,92,"[4, 5, 4, 4, 5, 6, 3, 4, 4, 6, 6, 3, 6, 4, 5, 6, 3, 4, 4, 6]"
塞翁吟 ,周邦彦,仄仄平平仄，平仄仄仄平平。仄仄仄，仄平平。仄仄仄平平。平平仄仄平平仄，平仄仄仄平平。仄仄仄，仄平平。仄平仄平平。平平。平平仄、平平仄仄，平仄仄、平平仄平。仄仄仄、平平仄仄，仄平仄、仄仄平平，仄仄平平。平平仄仄，仄仄平平，平仄平平。,0,45,47,92,"[5, 6, 3, 3, 5, 7, 6, 3, 3, 5, 2, 3, 4, 3, 4, 3, 4, 3, 4, 4, 4, 4, 4]"
意难忘 ,苏轼,平仄平平。仄仄平仄仄，仄仄平平。平平平仄仄，平仄仄平平。平仄仄、仄平平。仄平仄平平。仄仄平、平平仄仄，仄仄平平。仄平平仄平平。仄平平仄仄，仄仄平平。平平平仄仄，仄仄仄平平。平仄仄、仄平平。仄平仄平平。仄仄平、平平仄仄，仄仄平平。,0,47,45,92,"[4, 5, 4, 5, 5, 3, 3, 5, 3, 4, 4, 6, 5, 4, 5, 5, 3, 3, 5, 3, 4, 4]"
东风齐著力 ,胡浩然,平仄平平，平平平仄，仄仄平平。平平仄仄，仄仄仄平平。仄仄平平仄仄，平平仄、仄仄平平。平平仄，平平仄仄，平仄平平。仄仄仄平平。平仄仄、仄平仄仄平平。仄平仄仄，仄仄仄平平。仄仄平平仄仄，平平仄、仄仄平平。平平仄，平平仄仄，仄仄平平。,0,46,46,92,"[4, 4, 4, 4, 5, 6, 3, 4, 3, 4, 4, 5, 3, 6, 4, 5, 6, 3, 4, 3, 4, 4]"
远朝归 ,赵耆孙,平仄平平，仄仄平平平，平平仄仄。平平仄仄，平仄仄平平仄。平平仄仄，仄仄仄、仄平平仄。平平仄。仄平平仄仄，平仄平仄。平仄仄仄平平，仄仄仄平平，仄平平仄。平平仄仄，平仄仄平平仄。平平仄仄，仄平仄、平平平仄。平平仄。仄平仄仄平仄仄。,0,45,47,92,"[4, 5, 4, 4, 6, 4, 3, 4, 3, 5, 4, 6, 5, 4, 4, 6, 4, 3, 4, 3, 7]"
露华 ,王沂孙,仄平仄仄。仄仄仄平平，仄仄平仄。仄仄仄平，平仄平平平仄。仄平仄仄平平，仄仄仄平平仄。平平仄，平平仄平，仄仄平仄。平平仄仄平仄。仄仄仄平平，平仄平仄。仄仄仄平平仄，仄仄平仄。仄仄仄仄平平，仄仄仄平平仄。平仄仄，平平仄平仄仄。,0,38,54,92,"[4, 5, 4, 4, 6, 6, 6, 3, 4, 4, 6, 5, 4, 6, 4, 6, 6, 3, 6]"
露华 ,王沂孙,仄平仄仄，仄平平仄仄，平仄平平。仄平仄仄，平平平仄平平。仄仄仄平平仄，仄仄平、平仄平平。平仄仄，平平仄仄，仄仄平平。平平仄平平仄，仄仄仄平平，平仄平平。平平仄仄，仄平仄仄平平。仄仄仄平平仄，仄仄平、平仄平平。平仄仄，平平仄仄仄平。,0,47,47,94,"[4, 5, 4, 4, 6, 6, 3, 4, 3, 4, 4, 6, 5, 4, 4, 6, 6, 3, 4, 3, 6]"
薄媚摘遍 ,赵以夫,仄平平，平仄仄，平仄平平仄。仄平平，平仄仄，平平平仄平仄。平平仄仄，仄仄平平，平仄仄平平。仄仄平平，平平仄仄仄平仄。平仄平平平仄。仄仄平平仄。平仄仄，仄平平，平平仄仄平仄。平平平仄，仄仄平平，仄仄仄平平。仄仄平平，平平仄仄仄。,0,48,44,92,"[3, 3, 5, 3, 3, 6, 4, 4, 5, 4, 7, 6, 5, 3, 3, 6, 4, 4, 5, 4, 5]"
恋香衾 ,吕渭老,仄仄平平平平仄，仄仄仄、仄仄平平。仄仄平平，仄仄平平。仄仄平平仄平仄，仄仄仄、平仄平平。仄仄仄平平仄，仄仄平平。仄仄平平仄平仄，仄仄仄、仄仄平平。仄仄平平，仄仄平平。仄仄平平仄平仄，平仄仄、仄仄平平。仄平平仄平仄，仄仄平平。,0,40,52,92,"[7, 3, 4, 4, 4, 7, 3, 4, 6, 4, 7, 3, 4, 4, 4, 7, 3, 4, 6, 4]"
满江红 ,柳永,仄仄平平，平平仄、平平仄仄。平仄仄、仄平平仄，仄平平仄。仄仄平平平仄仄，仄平平仄平平仄。仄平仄、平仄仄平平，平平仄。平平仄，平仄仄。平仄仄，平平仄。仄平平平仄，仄平平仄。平仄平平平仄仄，平平仄仄平平仄。平仄平、仄仄仄平平，平平仄。,0,49,44,93,"[4, 3, 4, 3, 4, 4, 7, 7, 3, 5, 3, 3, 3, 3, 3, 5, 4, 7, 7, 3, 5, 3]"
满江红 ,张元干,平仄平平，平平仄、仄平平仄。平仄仄、仄平平仄，仄平平仄。仄仄平平平仄仄。仄平仄仄平平仄。仄仄平、平仄仄平平，平平仄。平平仄，平平仄。平仄仄，平平仄。仄平平平仄，仄平平仄。平仄平平平仄仄。仄平平仄平平仄。仄仄平、仄仄仄平平，平平仄。,0,49,44,93,"[4, 3, 4, 3, 4, 4, 7, 7, 3, 5, 3, 3, 3, 3, 3, 5, 4, 7, 7, 3, 5, 3]"
满江红 ,戴复古,仄仄平平，仄平仄、仄平平仄。仄平平、平平平仄，仄平平仄。仄仄平平平仄仄，平平仄仄平平仄。仄平平、仄仄仄平平，平平仄。平仄仄。平平仄。平仄仄，平平仄。仄平平，仄仄仄平平仄。仄仄平平平仄仄，平平仄仄平平仄。仄仄平、平仄仄平平，平平仄。,0,48,45,93,"[4, 3, 4, 3, 4, 4, 7, 7, 3, 5, 3, 3, 3, 3, 3, 3, 6, 7, 7, 3, 5, 3]"
满江红 ,吕渭老,仄仄平平，平仄仄、仄平平仄。仄仄平平仄，仄平平仄。平仄平平平仄仄，平平仄仄平平仄。仄仄平、平仄仄平平，平平仄。平仄仄，平平仄。平仄仄，平平仄。仄平平平仄，仄平平仄。平仄平平平仄仄，仄平平仄平平仄。仄仄平、平仄仄平平，平平仄。,0,48,43,91,"[4, 3, 4, 5, 4, 7, 7, 3, 5, 3, 3, 3, 3, 3, 5, 4, 7, 7, 3, 5, 3]"
满江红 ,吕渭老,仄仄平平，平平仄、平平仄仄。平平仄、仄平平仄。平仄仄平平仄仄，平平平仄平平仄。仄仄平、仄仄仄平平，平平仄。平仄仄，平平仄。平仄仄，平平仄。仄平平平仄，仄平平仄。平仄平平平仄仄，平平仄仄平平仄。仄仄平、平仄仄平平，平平仄。,0,48,41,89,"[4, 3, 4, 3, 4, 7, 7, 3, 5, 3, 3, 3, 3, 3, 5, 4, 7, 7, 3, 5, 3]"
满江红 ,苏轼,平仄平平，平平仄、平平平仄。仄仄仄、平平平仄，仄平平仄。平仄平平平仄仄，仄平仄仄平平仄。仄仄平、平仄仄平平，平平仄。平仄仄，平平仄。平仄仄，平平仄。平平仄仄仄，仄平平仄。平仄仄、平平平仄仄，平平仄仄平平仄。仄平平、平仄仄平平，平平仄。,0,51,43,94,"[4, 3, 4, 3, 4, 4, 7, 7, 3, 5, 3, 3, 3, 3, 3, 5, 4, 3, 5, 7, 3, 5, 3]"
满江红 ,赵鼎,仄仄平平，平平仄、平平仄仄。平仄仄、平平仄仄，仄平平仄。仄仄平平平仄仄，仄平仄仄平平仄。仄平平、仄仄仄平平，平平仄。平平仄，平仄仄。平仄仄，平平仄。平平仄平仄，仄平平仄。仄仄平平平仄仄，仄仄平仄仄平平仄。仄仄平、平仄仄平平，平平仄。,0,46,48,94,"[4, 3, 4, 3, 4, 4, 7, 7, 3, 5, 3, 3, 3, 3, 3, 5, 4, 7, 8, 3, 5, 3]"
满江红 ,辛弃疾,仄仄平平，仄仄仄、平平平仄。平仄仄、仄平平平仄，仄平平仄。仄仄仄平平仄仄，平平仄仄平平仄。仄平平、仄仄仄平平，平平仄。平平仄，平平仄。平平仄，平平仄。仄仄平平仄，仄平平仄。平仄仄平平仄仄，仄平仄仄平平仄。仄平平、仄仄仄平平，平平仄。,0,47,47,94,"[4, 3, 4, 3, 5, 4, 7, 7, 3, 5, 3, 3, 3, 3, 3, 5, 4, 7, 7, 3, 5, 3]"
满江红 ,柳永,仄仄平平，平平仄、平平平仄。平仄仄、仄平平仄，仄平平仄。仄仄仄、仄平平仄仄。仄平平、仄仄平平仄。仄仄仄、平仄仄平平，平平仄。平平仄，平平仄。平仄仄，平平仄。平平仄平平，仄仄平仄。仄仄仄、平平平仄仄。仄仄仄、仄仄平平仄。仄仄平、平仄仄平仄，平平仄。,0,45,52,97,"[4, 3, 4, 3, 4, 4, 3, 5, 3, 5, 3, 5, 3, 3, 3, 3, 3, 5, 4, 3, 5, 3, 5, 3, 5, 3]"
满江红 ,杜衍,平仄平平，平平平仄，平平平仄。仄平平、仄平仄仄，仄平仄仄。仄仄平平平仄仄，仄平平仄平平仄。仄仄平、仄仄仄平平，平平仄。平仄仄，平平仄。平平仄，平平仄。仄平平平仄，仄平平仄。仄仄平平平仄仄，仄平平仄平仄仄。仄平平、平仄仄平平，平平仄。,0,50,44,94,"[4, 4, 4, 3, 4, 4, 7, 7, 3, 5, 3, 3, 3, 3, 3, 5, 4, 7, 7, 3, 5, 3]"
满江红 ,叶梦得,仄仄平平，平平仄、平平平仄。平仄仄，平仄仄平平仄。仄仄平平平仄仄，仄平仄仄平平仄。仄仄平、平仄仄平平，平平仄。平平仄，平平仄。平仄仄，平平仄。仄平平仄仄，仄平平仄。仄仄平平平仄仄，仄平平仄平平仄。仄平平、仄仄仄平平，平平仄。,0,47,44,91,"[4, 3, 4, 3, 6, 7, 7, 3, 5, 3, 3, 3, 3, 3, 5, 4, 7, 7, 3, 5, 3]"
满江红 ,叶梦得,仄仄平平，平平仄、平平平仄。仄平平平仄，仄平平仄。仄仄平平平仄仄，仄平平仄平平仄。仄平平、仄仄仄平平，平平仄。平仄仄平平仄。平仄仄，平平仄。仄平平仄仄，仄平平仄。平仄仄平平仄仄，平平仄仄平平仄。仄平平、平仄仄平平，平平仄。,0,49,42,91,"[4, 3, 4, 5, 4, 7, 7, 3, 5, 3, 6, 3, 3, 5, 4, 7, 7, 3, 5, 3]"
满江红 ,王之道,仄仄平平，平仄仄、仄平平仄。仄平平、平平平仄，仄平平仄。仄仄平平平仄仄。仄平仄仄平平仄。仄仄平平仄仄，平仄平平仄。平仄仄平平仄。平仄平仄平仄。平仄平仄。仄平平仄。平仄平平平仄仄。平平仄仄平平仄。仄平平、平平仄，平仄平平仄。,0,48,44,92,"[4, 3, 4, 3, 4, 4, 7, 7, 6, 5, 6, 6, 4, 4, 7, 7, 3, 3, 5]"
满江红 ,姜夔,平仄平平，仄仄仄、平仄仄平。平平仄、仄平平仄，平仄平平。仄仄平平平仄仄，平平平仄仄平平。仄仄平、平仄仄平平，平仄平。平平仄，平仄平。仄平仄，仄平平。仄仄平平仄，仄仄平平。平仄平平平仄仄，仄平平仄仄平平。仄仄平、平仄仄平平，平仄平。,0,51,42,93,"[4, 3, 4, 3, 4, 4, 7, 7, 3, 5, 3, 3, 3, 3, 3, 5, 4, 7, 7, 3, 5, 3]"
凄凉犯 ,姜夔,仄平仄仄。平平仄、平平仄仄平仄。仄平仄仄，平平仄仄，仄平平仄。平平仄仄。仄平仄平平仄仄。仄平平、平平仄仄，平仄仄平仄。平仄平平仄，仄仄平平，仄平平仄。仄平仄仄，仄平平、仄平平仄。仄仄平平，仄平仄平平仄仄。仄平平、仄仄仄仄，仄仄仄。,0,41,52,93,"[4, 3, 6, 4, 4, 4, 4, 7, 3, 4, 5, 5, 4, 4, 4, 3, 4, 4, 7, 3, 4, 3]"
凄凉犯 ,张炎,平平仄仄平平仄，平平仄仄平仄。平平仄仄，平平平仄，仄平平仄。平平仄仄。仄仄仄、平平仄仄。仄平平、仄仄平平，平仄仄平仄。仄仄平平仄，平仄平平，仄平平仄。仄平仄仄，仄平平、仄平平仄。平仄平平，仄平仄、平平仄仄。仄平仄仄平平仄，仄仄仄。,0,45,48,93,"[7, 6, 4, 4, 4, 4, 3, 4, 3, 4, 5, 5, 4, 4, 4, 3, 4, 4, 3, 4, 7, 3]"
凄凉犯 ,张炎,平平仄仄平平仄，平平平、平仄平仄。平仄仄平，仄平平仄，仄平平仄。平平仄仄。仄平仄、平平仄仄。仄平平、平平平仄，仄仄仄平仄。平仄平平仄，仄仄平平，仄平平仄。平平仄仄，仄平平、仄平平仄。仄仄平平，仄平仄、平平仄仄。仄平平、平平仄仄，仄仄仄。,0,48,46,94,"[7, 3, 4, 4, 4, 4, 4, 3, 4, 3, 4, 5, 5, 4, 4, 4, 3, 4, 4, 3, 4, 3, 4, 3]"
浣溪沙慢 ,周邦彦,仄仄仄仄仄，平仄平平仄。仄平仄仄，平仄平平仄。平仄仄仄，仄仄平平仄。平仄平平仄。平仄仄平平，仄平平、平平仄仄。仄平仄。仄仄仄平平，仄平平仄仄，平仄仄平，仄仄平平仄。仄仄仄平，平仄仄平仄。仄仄平平仄。仄仄仄平平，仄平平、平平仄仄。,0,40,53,93,"[5, 5, 4, 5, 4, 5, 5, 5, 3, 4, 3, 5, 5, 4, 5, 4, 5, 5, 5, 3, 4]"
四犯剪梅花 ,刘过,仄仄平平，仄平平、仄仄仄平平仄。仄仄平平，仄平平平仄。平平仄仄。仄平仄、仄平平仄。平仄平平，仄平仄仄，仄平平仄。平平仄、平平仄仄，仄平平仄仄，仄平平仄。仄仄平平，仄平平平仄。平平仄仄。仄平仄、仄平平仄。平仄平平，平平仄仄，仄平平仄。,0,47,46,93,"[4, 3, 6, 4, 5, 4, 3, 4, 4, 4, 4, 3, 4, 5, 4, 4, 5, 4, 3, 4, 4, 4, 4]"
四犯剪梅花 ,刘过,仄平平仄。仄平平、仄仄仄平平仄。仄仄平平，仄平平平仄。平平仄仄。仄平仄、仄平平仄。仄仄平平，平平仄仄，平平平仄。平平仄、仄平仄仄。仄平平仄仄，仄平平仄。平仄平平，仄平平平仄。平平仄仄。仄平仄、仄平平仄。仄仄平平，平平仄仄，仄平平仄。,0,47,46,93,"[4, 3, 6, 4, 5, 4, 3, 4, 4, 4, 4, 3, 4, 5, 4, 4, 5, 4, 3, 4, 4, 4, 4]"
四犯剪梅花 ,卢祖皋,仄平平仄。仄平平仄仄，仄平平仄。仄仄平平，仄平平平仄。平平仄仄。仄平仄、仄平平仄。仄仄平平，平平仄仄，平平平仄。平平仄平仄仄。仄平平仄仄，平仄平仄。仄仄平平，仄平平平仄。平平仄仄。仄平仄、平平平仄。仄仄平平，平平仄仄，平平平仄。,0,48,44,92,"[4, 5, 4, 4, 5, 4, 3, 4, 4, 4, 4, 6, 5, 4, 4, 5, 4, 3, 4, 4, 4, 4]"
高平探芳新 ,吴文英,仄平平。仄仄平平仄，仄平平仄。仄仄平平，平仄平平平仄。平平仄，平仄仄，仄平平，平仄仄。仄平平，平平仄，仄仄平平平仄。平仄平平仄仄。仄仄仄平平，平平仄仄。仄仄平平，平仄平平平仄。平平平，平仄仄，仄平平，平仄仄。仄平平，平平仄，仄平平仄。,0,51,42,93,"[3, 5, 4, 4, 6, 3, 3, 3, 3, 3, 3, 6, 6, 5, 4, 4, 6, 3, 3, 3, 3, 3, 3, 4]"
临江仙慢 ,柳永,仄仄仄平仄，仄平仄仄，平仄平平。仄平仄、平平仄仄平平。平平。仄平仄仄，平平仄，仄仄平平。平平仄，仄仄平平仄，平仄平平。平平。平平仄仄，平仄平仄平平。仄平平、平仄仄仄平平。平平。仄平平仄，平平仄，仄仄平平。平平仄，仄仄平平仄，平仄平平。,0,52,41,93,"[5, 4, 4, 3, 6, 2, 4, 3, 4, 3, 5, 4, 2, 4, 6, 3, 6, 2, 4, 3, 4, 3, 5, 4]"
雪明鳷鹊夜 ,宋徽宗,仄仄平平仄，仄平平仄仄，仄仄平仄。仄平仄仄平，仄仄平仄。仄仄平平平仄平，仄仄平、仄平仄仄。仄平平，平仄平平，平仄仄仄。仄平平平仄仄，仄平仄仄平，仄仄仄仄。仄平平仄仄平平仄。仄仄平平仄仄，平仄仄、平仄平仄仄。仄平平仄仄，平平仄仄。,0,38,56,94,"[5, 5, 4, 5, 4, 7, 3, 4, 3, 4, 4, 6, 5, 4, 8, 6, 3, 5, 5, 4]"
玉漏迟 ,宋祁,仄平平仄仄，平平仄仄，平平平仄。仄仄平平，仄仄仄平平仄。仄仄平平仄仄，仄仄仄、平平平仄。平仄仄。仄平仄仄，平平平仄。仄仄仄仄平平，仄仄仄平平，仄平平仄。仄仄平平，仄仄仄平平仄。仄仄平平仄仄，仄平仄、仄平平仄。平仄仄。平平仄平平仄。,0,41,53,94,"[5, 4, 4, 4, 6, 6, 3, 4, 3, 4, 4, 6, 5, 4, 4, 6, 6, 3, 4, 3, 6]"
玉漏迟 ,吴文英,仄平平仄仄。平平仄仄，仄平平仄。仄仄平平，平仄仄平平仄。仄仄平平仄仄，仄平仄、仄平平仄。平仄仄。仄平平仄，仄平平仄。仄仄仄仄平平，仄仄仄平平，仄平平仄。仄仄平平，仄仄平平平仄。平仄仄平仄仄，仄平仄、平平平仄。平仄仄。平平仄平平仄。,0,43,51,94,"[5, 4, 4, 4, 6, 6, 3, 4, 3, 4, 4, 6, 5, 4, 4, 6, 6, 3, 4, 3, 6]"
玉漏迟 ,张翥,仄平平仄仄。平平仄仄，平平平仄。平仄平平，平仄仄平平仄。仄仄平平仄仄，仄仄仄、平平平仄。平仄仄。平平仄仄，平平平仄。仄仄。平仄平平，仄仄仄平平，仄平平仄。仄仄平平，平仄仄平平仄。仄仄平平仄仄，仄仄仄、平平平仄。平仄仄。平仄仄平平仄。,0,45,49,94,"[5, 4, 4, 4, 6, 6, 3, 4, 3, 4, 4, 2, 4, 5, 4, 4, 6, 6, 3, 4, 3, 6]"
玉漏迟 ,吴文英,仄平平仄仄，平平仄仄，仄平平仄。仄仄平平，仄仄仄平平仄。仄仄平平仄仄，仄平仄、平平平仄。平仄仄。仄平仄仄，平平仄仄。仄平仄、仄平平，仄仄仄平平，仄平平仄。仄仄平平，仄仄仄平平仄。平仄平平仄仄，仄平仄、平平平仄。平仄仄。平平仄平平仄。,0,43,51,94,"[5, 4, 4, 4, 6, 6, 3, 4, 3, 4, 4, 3, 3, 5, 4, 4, 6, 6, 3, 4, 3, 6]"
玉漏迟 ,程垓,仄平平仄仄，仄平仄仄，平平平仄。仄仄平平仄仄，仄平平仄。平仄平平仄仄，仄平仄、平平平仄。平仄仄。平平仄仄，平平平仄。仄仄仄仄平平，仄平仄平平，仄平平仄。仄仄平平，仄仄仄平平仄。仄仄平平仄仄，平仄仄、平平平仄。平仄仄。平平仄仄、平平平仄。,0,46,50,96,"[5, 4, 4, 6, 4, 6, 3, 4, 3, 4, 4, 6, 5, 4, 4, 6, 6, 3, 4, 3, 4, 4]"
玉漏迟 ,蒋捷,仄平平仄仄。平平仄仄，平平平仄。平仄仄平，仄仄平平平仄。仄仄平平仄仄，仄仄仄、平平平仄。平仄仄。平平仄仄，平平平仄。仄仄仄仄平平，仄仄仄平平，仄平平仄。平仄平平，仄仄平平平仄。仄仄平平仄仄，仄仄平平平仄。平仄仄。平平仄平平仄。,0,45,48,93,"[5, 4, 4, 4, 6, 6, 3, 4, 3, 4, 4, 6, 5, 4, 4, 6, 6, 6, 3, 6]"
玉漏迟 ,滕宾,仄平平仄仄。平平仄仄平平仄。平仄平平，仄仄仄平平仄。仄仄平平仄仄，仄仄仄、平平平仄。平仄仄。平平仄仄，平平平仄。仄仄平仄平平，仄平仄、平平仄。仄仄平平，平仄仄平平仄。仄仄平平仄仄，仄仄仄、平平平仄。平仄仄。平仄仄平平仄。,0,42,48,90,"[5, 7, 4, 6, 6, 3, 4, 3, 4, 4, 6, 3, 3, 4, 6, 6, 3, 4, 3, 6]"
尾犯 ,柳永,仄仄仄平平，平仄仄平，平仄平仄。仄仄平平，仄平平平仄。平仄仄、平平仄仄，仄平平、平平仄仄。仄平平仄，仄仄平平，仄仄平平仄。平平平仄仄，仄仄仄仄平仄。仄仄平平，仄平平平仄。仄平仄、平平平仄，仄平平、平平仄仄。仄平平仄，仄仄平仄平平仄。,0,46,48,94,"[5, 4, 4, 4, 5, 3, 4, 3, 4, 4, 4, 5, 5, 6, 4, 5, 3, 4, 3, 4, 4, 7]"
尾犯 ,蒋捷,仄仄仄平平，平仄仄平，平仄平仄。平仄平平，仄平平平仄。平仄仄、平平仄仄，仄平平、平平仄仄。仄平平仄，仄仄平平，仄仄平平仄。平平平仄仄，仄仄仄、仄仄平仄。仄仄平平，仄平平平仄。仄平仄、平平平仄，仄平平、平平仄仄。仄平平仄，仄平仄、平平仄仄。,0,47,48,95,"[5, 4, 4, 4, 5, 3, 4, 3, 4, 4, 4, 5, 5, 3, 4, 4, 5, 3, 4, 3, 4, 4, 3, 4]"
尾犯 ,柳永,平平仄仄。仄平平平仄，仄平平仄。仄平平仄，平平仄仄，平平平仄。仄平仄仄，仄仄仄、平平仄。仄平平、仄仄平平，仄平平仄平仄。仄仄平平平仄。仄平平，仄仄仄。平仄平平仄，仄仄平平，平平平仄。仄仄平平仄。平仄仄、仄平平仄。平仄仄、仄仄平平，仄平平仄平仄。,0,48,50,98,"[4, 5, 4, 4, 4, 4, 4, 3, 3, 3, 4, 6, 6, 3, 3, 5, 4, 4, 5, 3, 4, 3, 4, 6]"
尾犯 ,晁补之,平平仄仄。仄平平平仄，仄平平仄。仄平平仄平平，平仄平平平仄。平平仄仄，仄仄仄、平平仄。仄平平、平仄平平，仄仄平、仄平平仄。仄仄平平平仄。仄平平，平仄仄。平仄平平仄，仄仄平平，平平平仄。平仄平平仄。平仄仄、仄平平仄。仄仄仄、平仄平平，仄平平仄平仄。,0,53,46,99,"[4, 5, 4, 6, 6, 4, 3, 3, 3, 4, 3, 4, 6, 3, 3, 5, 4, 4, 5, 3, 4, 3, 4, 6]"
尾犯 ,无名氏,平平仄仄。仄平平平仄，仄平仄仄。仄平仄仄，平平平仄，仄平平仄。平平仄仄。平仄仄、仄平平仄。仄平平、仄仄平平，仄平仄仄平仄。仄仄平平平仄。仄仄平、平平仄仄。平仄平平仄，仄平平仄，平平仄仄。仄仄平平仄。平仄仄、仄平平仄。平仄仄、平仄平平，仄平仄仄平仄。,0,47,53,100,"[4, 5, 4, 4, 4, 4, 4, 3, 4, 3, 4, 6, 6, 3, 4, 5, 4, 4, 5, 3, 4, 3, 4, 6]"
驻马听 ,柳永,仄仄平平。仄平仄、平平仄仄平平。平平仄仄，平平平仄，平平仄仄平平。仄平平。仄仄平、仄仄平平。平仄平平，仄平平仄，仄仄平平。平平仄平仄仄，仄仄平仄平平。仄仄仄平平仄，平仄平平。仄仄平平仄仄，平仄平仄平平。仄仄仄，仄仄平平，平仄平平。,0,50,44,94,"[4, 3, 6, 4, 4, 6, 3, 3, 4, 4, 4, 4, 6, 6, 6, 4, 6, 6, 3, 4, 4]"
雪梅香 ,柳永,仄平仄，平平仄仄仄平平。仄平平平仄，平平仄仄平平。平仄平平仄平仄，仄平平仄仄平平。仄平仄，仄仄平平，平仄平平。平平。仄平仄，仄仄平平，仄仄平平。仄仄平平，仄平仄仄平平。仄仄平平仄平仄，仄平平仄仄平平。平平仄，仄仄平平，平仄平平。,0,52,42,94,"[3, 7, 5, 6, 7, 7, 3, 4, 4, 2, 3, 4, 4, 4, 6, 7, 7, 3, 4, 4]"
雪梅香 ,无名氏,仄平仄，平平平仄仄平平。仄平平平仄，仄平仄仄平平。平仄仄平仄平仄，仄平平仄仄平平。平平仄，仄仄平平，仄仄平平。平平仄平仄，仄仄平平，仄仄平平。平仄平平，仄平仄仄平平。平仄平平仄平仄，仄平平仄仄平平。平平仄，仄仄平平，仄仄平平。,0,52,42,94,"[3, 7, 5, 6, 7, 7, 3, 4, 4, 5, 4, 4, 4, 6, 7, 7, 3, 4, 4]"
六幺令 ,柳永,仄平平仄，平仄平平仄。平平仄平平仄，平仄仄平仄。仄仄平平仄仄，仄仄平平仄。平平平仄。平平仄仄，仄仄仄平仄平仄。仄仄平平平仄，平仄平平仄。平仄平仄平平，仄仄平仄仄。平仄平平仄仄，仄仄平平仄。仄平平仄。平平仄仄，仄仄仄平仄平仄。,0,44,50,94,"[4, 5, 6, 5, 6, 5, 4, 4, 7, 6, 5, 6, 5, 6, 5, 4, 4, 7]"
六幺令 ,贺铸,仄平平仄，平仄仄平仄。平平仄仄仄仄，仄仄平平仄。平仄平平仄仄。仄仄平平仄。平平平仄。平平仄仄，平仄平平仄平仄。平仄平平仄仄。仄仄平平仄。平仄平仄平平，仄仄平平仄。平仄平平仄仄。平仄平平仄。平平平仄。仄平平仄，平仄平平仄平仄。,0,48,46,94,"[4, 5, 6, 5, 6, 5, 4, 4, 7, 6, 5, 6, 5, 6, 5, 4, 4, 7]"
六幺令 ,陈允平,仄平平仄，平仄仄平仄。平平仄平平仄，仄仄平平仄。平仄平平仄仄，仄仄平平仄。仄平平仄。平平仄仄，平仄平平仄平仄。仄平平仄仄仄，仄仄平平仄。平仄仄、仄平平，仄仄平平仄。平仄平平仄仄，仄仄平平仄。平平平仄。平平平仄，仄仄平平仄平仄。,0,46,48,94,"[4, 5, 6, 5, 6, 5, 4, 4, 7, 6, 5, 3, 3, 5, 6, 5, 4, 4, 7]"
保寿乐 ,曹勛,平仄仄平平仄，仄仄平平平仄仄。仄仄仄平平，仄仄平平，仄平平仄。仄仄平平，仄平平仄仄，平平仄平平仄。仄仄仄平仄，仄仄平仄。仄平平平平仄。仄仄仄、平平平仄。平平仄平仄，平仄仄，仄平仄。平仄仄仄仄，平平仄平平仄。仄仄仄平仄，平平仄仄。,0,42,52,94,"[6, 7, 5, 4, 4, 4, 5, 6, 5, 4, 6, 3, 4, 5, 3, 3, 5, 6, 5, 4]"
惜秋华 ,吴文英,仄仄平平，仄平平、仄仄平平平仄。仄仄仄平，平平仄平平仄。平平仄仄平平，仄仄仄平平平仄。平仄。仄平平、仄平平平仄仄。仄仄仄平仄。仄平平平仄，仄仄平平仄。平仄仄、仄仄仄，仄平平仄。平平仄仄平平，仄仄平、仄平平仄。平仄。仄平平、仄平平仄。,0,46,48,94,"[4, 3, 6, 4, 6, 6, 7, 2, 3, 6, 5, 5, 5, 3, 3, 4, 6, 3, 4, 2, 3, 4]"
惜秋华 ,吴文英,仄仄平平，仄仄平仄仄，平平平仄。仄仄仄平，平平仄平平仄。平平仄仄平平，仄仄仄平平平仄。平平。仄平平仄仄，平平平仄。平仄仄平仄。仄仄平仄仄，平平平仄。仄仄仄平，平仄仄平平仄。平平仄仄仄平，仄仄仄、仄平平仄。平仄。仄平平、平平仄仄。,0,45,48,93,"[4, 5, 4, 4, 6, 6, 7, 2, 5, 4, 5, 5, 4, 4, 6, 6, 3, 4, 2, 3, 4]"
惜秋华 ,吴文英,仄仄平平，仄平平、仄仄平平平仄。仄仄仄平，平平仄平平仄。平平仄仄平平，仄仄仄、平平平仄。平平，仄平平、仄仄平平平仄。平仄仄平仄。仄平平仄仄，平平平仄。仄仄仄、平仄仄，仄平平仄。平平仄仄平平，仄仄平、仄平平仄。平仄。仄平平、仄平平仄。,0,48,45,93,"[4, 3, 6, 4, 6, 6, 3, 4, 2, 3, 6, 5, 5, 4, 3, 3, 4, 6, 3, 4, 2, 3, 4]"
惜秋华 ,吴文英,仄仄平平，仄平平仄仄，平平平仄。平仄仄平，平平仄平平仄。平平仄仄平平，仄仄仄、平平平仄。平平，仄平平仄仄，平平平仄。仄仄仄平仄。仄平平仄仄，仄平平仄。仄仄仄仄，仄仄仄平仄仄。平平仄仄平平，仄仄仄平平平仄。平仄。仄仄平、仄平平仄。,0,44,49,93,"[4, 5, 4, 4, 6, 6, 3, 4, 2, 5, 4, 5, 5, 4, 4, 6, 6, 7, 2, 3, 4]"
惜秋华 ,吴文英,仄仄平平，仄平平仄仄，平平平仄。平仄仄平，平平仄平平仄。平平仄仄平平，仄平仄、平平仄仄。平平，仄平平、仄仄平平平仄。平仄仄平仄。仄仄仄平平，仄平平仄。仄平仄、仄仄仄，仄平平仄。平平仄仄平平，仄仄平、仄平平仄。平仄。仄平平、仄平平仄。,0,48,45,93,"[4, 5, 4, 4, 6, 6, 3, 4, 2, 3, 6, 5, 5, 4, 3, 3, 4, 6, 3, 4, 2, 3, 4]"
古香慢 ,吴文英,仄平仄仄，平仄平平，平仄平仄。仄仄平平，仄仄仄平仄仄。平仄仄平平，仄平仄、平平仄仄。仄平平仄仄仄仄，仄平仄仄平仄。仄仄仄、平平平仄。平仄平平，平仄平仄。仄仄平平，仄仄仄平平仄。仄仄仄平平，仄平仄、平平仄仄。仄平平，仄平仄、仄平平仄。,0,41,53,94,"[4, 4, 4, 4, 6, 5, 3, 4, 7, 6, 3, 4, 4, 4, 4, 6, 5, 3, 4, 3, 3, 4]"
芙蓉月 ,赵以夫,平仄仄平仄，平仄仄、仄仄平平平仄。平平仄仄，仄仄平平平仄。平仄平平平仄，仄仄仄平平仄。平仄仄，仄平平，仄仄仄平平仄。平平仄平仄。仄平平仄仄，平仄平仄。平平仄仄，平仄平平平仄。仄仄平平平仄，仄平仄。平平仄。平仄仄，仄平平，仄平平仄。,0,46,48,94,"[5, 3, 6, 4, 6, 6, 6, 3, 3, 6, 5, 5, 4, 4, 6, 6, 3, 3, 3, 3, 4]"
一枝春 ,杨缵,仄仄平平，仄平平、仄仄平平平仄。平平仄仄，仄仄仄平平仄。平平仄仄，仄平仄、仄平平仄。平仄仄、平仄平平，仄平仄平平仄。平平仄平仄仄。仄平平、仄仄平平平仄。平平仄仄，平仄仄平平仄。平平仄仄，仄平仄仄平平仄。平仄仄、仄仄平平，仄平仄仄。,0,45,49,94,"[4, 3, 6, 4, 6, 4, 3, 4, 3, 4, 6, 6, 3, 6, 4, 6, 4, 7, 3, 4, 4]"
一枝春 ,张炎,仄仄平平，仄平平仄仄，平平仄仄。平平仄仄，仄仄仄平平仄。平平仄仄，仄平仄、仄平平仄。平仄仄。平仄平平，仄仄仄平平仄。平仄仄平平仄。仄平平仄仄，平仄平仄。平平仄仄，仄仄仄平仄仄。平平仄仄，仄平仄、仄平平仄。平仄平、仄仄平平，仄平仄仄。,0,41,53,94,"[4, 5, 4, 4, 6, 4, 3, 4, 3, 4, 6, 6, 5, 4, 4, 6, 4, 3, 4, 3, 4, 4]"
梅子黄时雨 ,张炎,平仄平平，仄平仄仄平，平仄平仄。仄仄仄平平，仄平平仄。平仄平平平仄仄，仄平仄仄平平仄。平平仄。仄仄仄平，平仄平仄。平仄。平平平仄。仄平平仄仄，平仄平仄。仄仄仄平平，平平平仄。平仄平平平仄仄，仄平平仄平平仄。平平仄。仄平仄平平仄。,0,49,45,94,"[4, 5, 4, 5, 4, 7, 7, 3, 4, 4, 2, 4, 5, 4, 5, 4, 7, 7, 3, 6]"
如鱼水 ,柳永,平仄平平，仄平仄仄，仄仄仄仄平平。仄仄平平。平平平仄平平。仄平平。平平仄、平仄平平。仄仄仄、平仄平平，仄平平仄仄平平。平仄仄，仄平平。平仄仄仄平平。仄仄平平。平平平仄平平。仄平平。平仄仄、仄仄平平。仄平仄、仄仄平平仄仄，仄仄仄平平。,0,50,44,94,"[4, 4, 6, 4, 6, 3, 3, 4, 3, 4, 7, 3, 3, 6, 4, 6, 3, 3, 4, 3, 6, 5]"
赏松菊 ,曹勛,平平仄仄平平仄，仄仄仄平平仄。仄平仄仄，仄平平平仄。仄仄平平仄仄，仄平仄、平平仄仄。仄平平，仄平平仄仄，仄平平仄。仄仄平平仄仄。仄平平、仄平平平仄。仄仄仄平仄，仄平平平仄。仄仄平平仄仄，仄平仄、平平仄仄。仄平平，仄平平，平仄仄仄。,0,42,52,94,"[7, 6, 4, 5, 6, 3, 4, 3, 5, 4, 6, 3, 5, 5, 5, 6, 3, 4, 3, 3, 4]"
二色莲 ,曹勛,仄仄仄仄，平仄平仄，平仄平仄。仄平仄仄，平仄仄平平仄。仄仄平平仄仄，仄仄仄、平平平仄。平仄仄平平仄，平平仄平平仄。平平仄平仄，仄仄平平仄。平仄平仄仄。仄平仄仄，平仄仄平平仄。仄仄平平仄仄，仄仄仄、平平平仄。平仄仄，平平仄，平平仄仄。,0,41,54,95,"[4, 4, 4, 4, 6, 6, 3, 4, 6, 6, 5, 5, 5, 4, 6, 6, 3, 4, 3, 3, 4]"
塞孤 ,柳永,仄平平，仄仄平平仄。仄仄平平平仄。仄仄仄平平仄仄。平仄仄，平平仄。平平仄、仄平平，平仄仄、平平仄。仄平平仄，平仄平仄。平仄仄仄平，仄仄平平仄。仄仄平平平仄。仄仄平平平仄仄。平仄仄，平平仄。平仄仄、仄平平，平仄仄、平平仄。仄平平、仄仄平仄。,0,45,50,95,"[3, 5, 6, 7, 3, 3, 3, 3, 3, 3, 4, 4, 5, 5, 6, 7, 3, 3, 3, 3, 3, 3, 3, 4]"
塞孤 ,朱雍,仄平平，仄仄平平仄。仄仄平平平仄。仄仄平平平仄仄。平仄仄，平平仄。平平仄、仄平平，平仄仄、平平仄。仄平平、仄仄平仄。平仄仄仄平，仄仄平平仄。仄仄平平平仄。平仄平平平仄仄。仄仄平平仄。平仄仄、仄平平，平仄仄、平平仄。仄平平、仄仄平仄。,0,45,48,93,"[3, 5, 6, 7, 3, 3, 3, 3, 3, 3, 3, 4, 5, 5, 6, 7, 5, 3, 3, 3, 3, 3, 4]"
水调歌头 ,毛滂,仄平平仄仄，仄仄仄平平。平平平仄，平仄平仄仄平平。仄仄平平平仄，仄仄仄平平仄，仄仄仄平平。平平仄平仄，仄仄仄平平。平平仄，平平仄，仄平平。平平仄仄，平仄仄仄仄平平。平仄平平仄仄，平仄平平仄仄，平仄仄平平。仄仄平平仄，仄仄仄平平。,0,47,48,95,"[5, 5, 4, 7, 6, 6, 5, 5, 5, 3, 3, 3, 4, 7, 6, 6, 5, 5, 5]"
水调歌头 ,周紫芝,仄仄仄平仄，平仄仄平平。仄平平仄平仄，平仄仄平平。仄仄平平仄仄，仄仄平平仄仄，平仄仄平平。平仄平平仄，平仄仄平平。平仄仄，仄平仄，仄平平。仄平仄仄平仄，平仄仄平平。平仄平平平仄，平仄平平平仄，平仄仄平平。仄仄平平仄，平仄仄平平。,0,48,47,95,"[5, 5, 6, 5, 6, 6, 5, 5, 5, 3, 3, 3, 6, 5, 6, 6, 5, 5, 5]"
水调歌头 ,苏轼,平仄仄平仄，仄仄仄平平。仄平平仄平仄，平仄仄平平。仄仄平平平仄。仄仄平平仄仄。平仄仄平平。仄仄仄平仄，平仄仄平平。仄平仄，平仄仄，仄平平。仄平仄仄，平仄平仄仄平平。平仄平平平仄。仄仄平平平仄。仄仄仄平平。仄仄平平仄，平仄仄平平。,0,45,50,95,"[5, 5, 6, 5, 6, 6, 5, 5, 5, 3, 3, 3, 4, 7, 6, 6, 5, 5, 5]"
水调歌头 ,贺铸,平仄仄平仄。仄仄仄平平。平平平仄。仄平平仄仄平平。平仄平平平仄。仄仄平平平仄。平仄仄平平。平仄平平仄。仄仄仄平平。仄平平，平仄仄。仄平平。仄平平仄。平平平仄仄平平。平仄平平仄仄。平仄平平平仄。平仄仄平平。平仄平平仄。平仄仄平平。,0,54,41,95,"[5, 5, 4, 7, 6, 6, 5, 5, 5, 3, 3, 3, 4, 7, 6, 6, 5, 5, 5]"
水调歌头 ,王之道,平平平仄仄，仄仄仄平平。仄平平仄，仄平平仄，仄仄仄平平。平仄仄平平仄，仄仄平平仄仄，平仄仄平平。平仄仄平仄，平仄仄平平。仄平仄，平仄仄，仄平平。仄平平仄，仄仄平仄仄平平。仄仄平平仄仄，仄仄平平仄仄，仄仄仄平平。仄仄平平仄，平仄仄平平。,0,44,53,97,"[5, 5, 4, 4, 5, 6, 6, 5, 5, 5, 3, 3, 3, 4, 7, 6, 6, 5, 5, 5]"
水调歌头 ,张孝祥,仄仄仄平仄，平仄仄平平。平平仄仄平仄，平仄仄平平。平仄平平平仄，平仄平平平仄，仄仄仄平平。仄仄平平仄，仄仄仄平平。仄平平，平仄仄，仄平平。仄平平仄，平平平仄，平仄仄平平。仄仄平平仄仄，平仄平平平仄，仄仄仄平平。仄仄平平仄，仄仄仄平平。,0,49,48,97,"[5, 5, 6, 5, 6, 6, 5, 5, 5, 3, 3, 3, 4, 4, 5, 6, 6, 5, 5, 5]"
水调歌头 ,刘因,仄仄仄平仄，仄仄仄平平。平平仄仄平仄，平仄仄平平。平仄平平平仄，平仄平平仄仄，平仄仄平平。平仄仄平仄，平仄仄平平。平平仄，平仄仄，仄平平。仄平平仄仄仄，平仄仄，仄平平。平仄平平仄仄，平仄平平平仄，仄仄仄平平。平仄仄平仄，仄仄仄平平。,0,47,49,96,"[5, 5, 6, 5, 6, 6, 5, 5, 5, 3, 3, 3, 6, 3, 3, 6, 6, 5, 5, 5]"
水调歌头 ,傅公谋,仄仄平平仄，仄仄仄平平。仄平平仄，仄平平仄仄平平。仄仄平平平仄，仄仄仄平平仄，仄仄仄平平。平仄平平仄，平仄仄平平。平平平平仄，仄平平。仄平仄仄，平仄仄仄仄平平。仄仄仄平平仄，仄仄仄平平仄，仄仄仄平平。平仄平平仄，平仄仄平平。,0,45,49,94,"[5, 5, 4, 7, 6, 6, 5, 5, 5, 5, 3, 4, 7, 6, 6, 5, 5, 5]"
扫地游 ,周邦彦,仄平仄仄，仄仄仄平平，仄平平仄。仄平仄仄。仄平平仄仄，仄平仄仄。仄仄平平，仄仄平平仄仄。仄平仄。仄仄仄仄平，平仄平仄。平仄平仄仄。仄仄仄平平，仄平平仄。仄平仄仄。仄平平仄仄，仄平平仄。仄仄平平，仄仄平平仄仄。仄平仄。仄平平、仄平平仄。,0,37,58,95,"[4, 5, 4, 4, 5, 4, 4, 6, 3, 5, 4, 5, 5, 4, 4, 5, 4, 4, 6, 3, 3, 4]"
扫地游 ,杨无咎,仄平仄仄。仄仄仄平平，仄平平仄。仄平仄仄。仄平平仄仄，仄平平仄。仄仄平平，仄仄平平仄仄。仄平仄。仄仄仄仄平，平仄平仄。平仄平仄仄。仄仄仄平平，仄平平仄。仄平仄仄。仄平平仄仄，仄平平仄。仄仄平平，仄仄平平仄仄。仄平仄。仄平平、仄平平仄。,0,38,57,95,"[4, 5, 4, 4, 5, 4, 4, 6, 3, 5, 4, 5, 5, 4, 4, 5, 4, 4, 6, 3, 3, 4]"
扫地游 ,王沂孙,仄平仄仄，仄仄仄平平，仄平平仄。仄平仄仄。仄平平仄仄，仄平平仄。仄仄平平，仄仄平平仄仄。仄平仄。仄仄仄平，平仄平仄。平仄平仄仄。仄仄仄平平，仄平平仄。仄平仄仄。仄平平仄仄，仄平平仄。仄仄平平，仄仄平平仄仄。仄平仄。仄平平、仄平平仄。,0,38,56,94,"[4, 5, 4, 4, 5, 4, 4, 6, 3, 4, 4, 5, 5, 4, 4, 5, 4, 4, 6, 3, 3, 4]"
满庭芳 ,晏几道,平仄平平，平平平仄，仄平平仄平平。平平平仄，平仄仄平平。仄仄平平仄仄，仄平仄、平仄平平。仄平仄，仄平仄仄，仄仄仄平平。平平平仄仄，平平仄仄，仄仄平平。仄平仄，平平仄仄平平。仄仄平平仄仄，平平仄、仄仄平平。平平仄，平平仄仄，平仄仄平平。,0,51,44,95,"[4, 4, 6, 4, 5, 6, 3, 4, 3, 4, 5, 5, 4, 4, 3, 6, 6, 3, 4, 3, 4, 5]"
满庭芳 ,周邦彦,平仄平平，仄平平仄，仄平平仄平平。仄平平仄，平仄仄平平。平仄平平仄仄，仄平仄、平仄平平。平平仄，平平仄仄，仄仄仄平平。平平。平仄仄，平平仄仄，平仄平平。仄仄平平仄，平仄平平。平仄平平仄仄，仄平仄、仄仄平平。平平仄，平平仄仄，平仄仄平平。,0,53,42,95,"[4, 4, 6, 4, 5, 6, 3, 4, 3, 4, 5, 2, 3, 4, 4, 5, 4, 6, 3, 4, 3, 4, 5]"
满庭芳 ,黄公度,仄仄平平，平平仄仄，仄平仄仄平平。仄平平仄，平仄仄平平。仄仄平平仄仄，平平仄仄平平。平平仄，平平仄仄，仄仄仄平平。平平。平仄仄，平平仄仄，平仄平平。仄平平，仄平平仄平平。仄仄平平仄仄，平平仄仄平平。平平仄，平平仄仄，仄仄仄平平。,0,50,43,93,"[4, 4, 6, 4, 5, 6, 6, 3, 4, 5, 2, 3, 4, 4, 3, 6, 6, 6, 3, 4, 5]"
满庭芳 ,程垓,平仄平平，平平仄仄，仄平仄、平仄平平。仄平平仄，平仄仄平平。仄仄平平仄仄，仄仄仄、平仄平平。平平仄，平平仄仄，仄仄仄平平。平平平仄仄，平平仄仄，平仄平平。仄仄平平仄，平仄平平。仄仄平平仄仄，平仄仄、仄仄平平。平平仄，仄平仄仄，平仄仄平平。,0,49,47,96,"[4, 4, 3, 4, 4, 5, 6, 3, 4, 3, 4, 5, 5, 4, 4, 5, 4, 6, 3, 4, 3, 4, 5]"
满庭芳 ,赵长卿,平仄平平，平平平仄，仄平仄仄平平。平平平仄，仄仄仄平平。平仄仄、平平仄仄，平仄仄、平仄平平。平平仄，平平仄仄，仄仄仄平平。平平平仄仄，仄平仄仄，平仄平平。仄平平仄，仄仄平平。平仄仄、平平仄仄，平仄仄、平仄平平。平平仄，平平仄仄，平仄仄平平。,0,52,44,96,"[4, 4, 6, 4, 5, 3, 4, 3, 4, 3, 4, 5, 5, 4, 4, 4, 4, 3, 4, 3, 4, 3, 4, 5]"
满庭芳 ,元好问,平仄平平，仄平平仄，仄平仄仄平平。平平仄仄，平仄仄平平。平仄仄平平仄，仄仄仄、仄仄平平。平平仄，平平仄仄，平仄仄平平。平平平仄仄，仄平仄仄，仄仄平平。平平仄仄，平仄仄平平。仄仄平平仄仄，平平仄、仄仄平平。平平仄仄，平平仄仄，平仄仄平平。,0,49,47,96,"[4, 4, 6, 4, 5, 6, 3, 4, 3, 4, 5, 5, 4, 4, 4, 5, 6, 3, 4, 4, 4, 5]"
满庭芳 ,无名氏,平仄平平，平平平仄，仄平平仄平仄。仄平仄仄，仄仄仄平仄。仄仄平平仄仄，仄仄仄、平平平仄。平平仄，平平平仄，平仄仄平仄。平平平仄仄，平仄仄、仄仄平仄平仄。仄仄平平仄，平仄平仄。仄仄平平仄仄，平平仄、仄平平仄。平平仄，平平仄仄，平仄仄平仄。,0,45,51,96,"[4, 4, 6, 4, 5, 6, 3, 4, 3, 4, 5, 5, 3, 6, 5, 4, 6, 3, 4, 3, 4, 5]"
白雪 ,杨无咎,平平仄仄，平仄仄、平平仄仄平平。平仄仄平，平平仄仄，平平仄仄平平。仄平平。仄平仄、仄仄平平。仄平仄、仄平平仄，仄仄仄平平。平仄仄仄仄平，平平仄仄，仄平平。仄仄仄平平仄，平仄仄平平。平仄仄、仄平平仄，仄仄仄平平。仄平平仄，平平仄仄平平。,0,47,48,95,"[4, 3, 6, 4, 4, 6, 3, 3, 4, 3, 4, 5, 6, 4, 3, 6, 5, 3, 4, 5, 4, 6]"
徵招 ,赵以夫,仄平仄仄平平仄，平平仄平平仄。仄仄仄平平，仄平平平仄。仄平平仄仄。仄平仄、仄平平仄。仄仄平平，仄平平仄，仄平平仄。平仄仄平平，平平仄、平平仄平平仄。仄仄仄平平，仄平平仄仄。仄平平仄仄。仄平仄、仄平平仄。仄平仄、仄仄仄平，仄仄平平仄。,0,45,50,95,"[7, 6, 5, 5, 5, 3, 4, 4, 4, 4, 5, 3, 6, 5, 5, 5, 3, 4, 3, 4, 5]"
徵招 ,张炎,仄平平仄平平仄，平平仄平平仄。平仄仄平平，仄平平平仄。仄平平仄仄，仄平仄、平平平仄。仄仄平平，仄平平仄，仄平平仄。平仄仄平平，平平仄、仄仄平平仄仄。仄仄仄平平，仄平平仄仄。仄平平仄仄，平仄仄、仄平平仄。平平仄、仄仄平平，仄仄平平仄。,0,48,47,95,"[7, 6, 5, 5, 5, 3, 4, 4, 4, 4, 5, 3, 6, 5, 5, 5, 3, 4, 3, 4, 5]"
徵招 ,彭元逊,平平平仄平平仄，平仄平平仄仄。仄仄平平，仄仄平平仄仄。仄平平仄仄，仄平仄平平仄仄。平仄平平，仄平平仄，平平仄仄。平仄仄平平，平平仄、仄仄平平平仄。仄仄仄平，平仄平平平仄。仄仄平平仄，仄平仄、平平平仄。仄平仄、仄仄平平，仄仄平平仄。,0,48,47,95,"[7, 6, 4, 6, 5, 7, 4, 4, 4, 5, 3, 6, 4, 6, 5, 3, 4, 3, 4, 5]"
双瑞莲 ,赵以夫,平平平仄仄。仄仄仄平平，平平平仄。平平仄仄，仄仄仄平平仄。仄仄平平平仄，仄仄仄、平平平仄。平仄仄。仄平仄仄，平平平仄。仄仄仄仄平平，仄平仄平平，平平平仄。平平仄仄，平仄平平平仄。仄仄平平平仄，仄仄仄、仄平平仄。平仄仄。仄仄仄平平仄。,0,45,50,95,"[5, 5, 4, 4, 6, 6, 3, 4, 3, 4, 4, 6, 5, 4, 4, 6, 6, 3, 4, 3, 6]"
玉京秋 ,周密,平仄仄。平平仄平仄，仄平平仄。仄仄平平，仄平仄仄，平平平仄。平仄平平仄仄，仄平平、平仄平仄。仄平仄。仄平平仄，仄平平仄。仄仄平平平仄。仄平平、平平仄仄。仄仄平平，平平平仄，平平平仄。仄仄平平，仄仄仄、平仄平平平仄。仄平仄。平仄平平仄仄。,0,49,46,95,"[3, 5, 4, 4, 4, 4, 6, 3, 4, 3, 4, 4, 6, 3, 4, 4, 4, 4, 4, 3, 6, 3, 6]"
小圣乐 ,元好问,仄仄平平，仄平平仄仄，平仄平平。仄平平仄，仄仄仄平平。仄仄平平仄仄，仄平仄、平平平仄。仄仄仄，仄平平仄仄，仄仄平平。平平仄平仄仄，仄平平仄仄，平仄平平。仄平平仄，平仄仄平平。仄仄平平仄仄，仄平仄、仄平平平。仄仄仄，平平仄平，平仄平平。,0,46,49,95,"[4, 5, 4, 4, 5, 6, 3, 4, 3, 5, 4, 6, 5, 4, 4, 5, 6, 3, 4, 3, 4, 4]"
玉女迎春慢 ,彭元逊,平仄平平，平平仄、仄仄仄平平仄。仄仄平平仄仄。仄仄平平平仄。平平平仄。仄仄仄、仄平平仄。平平平仄，平仄仄平，平仄平仄。平平仄仄平平，平平仄仄，仄平平仄。仄仄平平仄仄，仄仄平平仄仄。仄平平仄。仄仄仄、仄平平仄。仄仄平平，仄仄仄平平仄。,0,44,51,95,"[4, 3, 6, 6, 6, 4, 3, 4, 4, 4, 4, 6, 4, 4, 6, 6, 4, 3, 4, 4, 6]"
玉梅香慢 ,无名氏,平仄平平，平仄仄仄。平仄平平平仄。仄仄平平，平平平仄，平仄平平平仄。仄平仄仄，平仄仄、仄平仄。平仄平平，仄仄平平，仄平平仄。平平仄平仄仄。仄平平、仄平平仄。仄仄平平，仄仄仄平平仄。仄仄平平仄仄，平仄仄、仄平仄仄仄。仄仄平平，平平仄仄。,0,46,49,95,"[4, 4, 6, 4, 4, 6, 4, 3, 3, 4, 4, 4, 6, 3, 4, 4, 6, 6, 3, 5, 4, 4]"
金浮图 ,尹鹗,平平仄。平平仄仄。仄仄平平，仄平平仄。仄平平、仄仄平平仄。仄仄平平，仄仄仄平平仄。仄仄仄平平仄。平平仄仄，平仄平平仄。平仄仄。平平仄仄。仄仄仄平，仄平平仄。仄平平仄仄平平仄。平仄平平，仄仄平平平仄。平仄仄平仄仄。平平仄仄，仄仄平平仄。,0,45,51,96,"[3, 4, 4, 4, 3, 5, 4, 6, 6, 4, 5, 3, 4, 4, 4, 8, 4, 6, 6, 4, 5]"
阳台路 ,柳永,仄平仄。仄仄平仄仄，平平平仄。仄平平、仄仄平平，平仄仄平平仄。平仄仄平平，仄仄仄平、仄平平仄。平平仄。仄仄平、平平平仄平仄。仄仄平平平仄，仄仄仄、平平仄仄。仄平平仄，仄仄仄、仄平平仄。平平仄、平平仄仄，仄仄仄平平仄。平平仄仄平平，平平平仄。,0,47,50,97,"[3, 5, 4, 3, 4, 6, 5, 4, 4, 3, 3, 6, 6, 3, 4, 4, 3, 4, 3, 4, 6, 6, 4]"
黄莺儿 ,柳永,平平平仄平平仄。仄仄平平，平仄平平，平平平平，仄平平仄。平仄仄仄平平，仄仄平平仄。仄平平仄平平，仄仄平平，平仄平仄。平仄。仄仄仄平平，仄仄平平仄。仄平平仄，仄仄平平，平平仄平平仄。平仄仄仄平平，仄仄平平仄。仄仄仄仄平平，平仄平平仄。,0,52,44,96,"[7, 4, 4, 4, 4, 6, 5, 6, 4, 4, 2, 5, 5, 4, 4, 6, 6, 5, 6, 5]"
黄莺儿 ,晁补之,平平平仄平平仄。仄仄平平，平平平仄仄平平，平平仄平平仄。平仄仄仄平平，仄仄平平仄。仄平平仄平平，仄仄平平，平仄平仄。平仄。仄仄仄平平，仄仄平平仄。仄平平仄，仄仄平平，平平仄平平仄。平仄仄仄平平，仄仄平平仄。仄平平仄平平，仄仄平平仄。,0,53,44,97,"[7, 4, 7, 6, 6, 5, 6, 4, 4, 2, 5, 5, 4, 4, 6, 6, 5, 6, 5]"
黄莺儿 ,无名氏,平平平仄平平仄。仄仄平平，平仄平平，仄仄平平，平仄平仄。平仄仄仄平平，仄仄平平仄。仄平平仄平平，仄仄平平，平仄平仄。平仄。仄仄仄平平，仄仄平平仄。仄平平平，仄仄平平，平平平仄平仄。仄仄仄平平，仄仄平平仄。仄仄平仄平平，仄仄平平仄。,0,50,45,95,"[7, 4, 4, 4, 4, 6, 5, 6, 4, 4, 2, 5, 5, 4, 4, 6, 5, 5, 6, 5]"
天香 ,贺铸,平仄平平，平平仄仄，平仄平平平仄。仄仄平平，平平平仄，仄仄平平平仄。仄平平仄。平仄仄、仄平平仄。平仄平平仄仄，平平仄平平仄。平平仄平仄仄。仄平平、仄平平仄。平仄平平仄仄，仄平平仄。平仄平平仄仄。仄平仄、平平仄平仄。仄仄平平，平平仄仄。,0,52,44,96,"[4, 4, 6, 4, 4, 6, 4, 3, 4, 6, 6, 6, 3, 4, 6, 4, 6, 3, 5, 4, 4]"
天香 ,王观,平仄平平，平平仄仄，平平仄仄平仄。仄仄平平，仄平平仄，仄仄仄平平仄。平平仄仄，平仄仄、平平仄仄。平仄平平仄仄，平平平仄平仄。平平仄平仄仄。仄平平、仄平平仄。仄仄仄平平仄，仄平平仄。仄仄平平仄仄，仄仄仄、平平仄平仄。仄仄平平，平平仄仄。,0,46,50,96,"[4, 4, 6, 4, 4, 6, 4, 3, 4, 6, 6, 6, 3, 4, 6, 4, 6, 3, 5, 4, 4]"
天香 ,毛滂,仄仄平平，平平仄仄，平平平仄平仄。平仄平平，平平平仄，仄仄仄平平仄。平平仄仄，平仄仄、平平平仄。仄仄平平平仄，平平仄仄平仄。平平仄平平仄。仄平平、仄平平仄。仄仄平平，仄仄仄平平仄。平仄平平仄仄。仄平仄、平平平仄仄。仄仄平平，平平仄仄。,0,51,45,96,"[4, 4, 6, 4, 4, 6, 4, 3, 4, 6, 6, 6, 3, 4, 4, 6, 6, 3, 5, 4, 4]"
天香 ,吴文英,仄仄平平，平平仄仄，平平仄仄平仄。仄仄平平，平平平仄，仄仄仄平平仄。仄平仄仄，仄仄仄、平平仄仄。平仄平平仄仄，平平仄仄平仄。平平仄平平仄。仄平平、仄平平仄。仄仄仄平平仄，仄平平仄。平仄平平仄仄。仄仄仄、平平仄平仄。平仄平平，平平仄仄。,0,46,50,96,"[4, 4, 6, 4, 4, 6, 4, 3, 4, 6, 6, 6, 3, 4, 6, 4, 6, 3, 5, 4, 4]"
天香 ,刘儗,仄仄平平，平平仄仄，平平仄平平仄。仄仄平平，仄平平仄，仄仄仄平平仄。平平仄仄，平仄仄平平平仄。仄仄平平仄仄，平平仄平平仄。平平仄平仄仄，仄仄仄平平仄。仄仄平平仄仄，仄平平仄。仄仄平平仄仄，仄平仄、平平仄平仄。仄仄平平，平平仄仄。,0,45,50,95,"[4, 4, 6, 4, 4, 6, 4, 7, 6, 6, 6, 6, 6, 4, 6, 3, 5, 4, 4]"
天香 ,吴文英,平仄平平，平平仄仄，平平仄仄平仄。仄仄平平，平平仄仄，仄平仄，平平仄。仄平仄仄，平仄仄、平平平仄。平仄平平仄仄，平平仄平平仄。平仄仄平仄仄。仄平平、仄平平仄。仄仄仄平平仄，仄平平仄。仄仄平平仄仄。仄仄仄、平平仄平仄。仄仄平平，平平仄仄。,0,46,50,96,"[4, 4, 6, 4, 4, 3, 3, 4, 3, 4, 6, 6, 6, 3, 4, 6, 4, 6, 3, 5, 4, 4]"
天香 ,景覃,仄仄平平，平平仄仄，平平仄平平仄。平仄平平，平平平仄，仄仄仄平平仄。仄平平仄，仄平仄、平平平仄。仄仄平平，仄平平仄，仄平平仄。平平仄平仄仄。仄平平、仄平平仄。平仄平平平仄，仄平平仄。平仄平平仄仄，仄仄仄平平仄平仄。仄仄平平，平平仄仄。,0,51,45,96,"[4, 4, 6, 4, 4, 6, 4, 3, 4, 4, 4, 4, 6, 3, 4, 6, 4, 6, 8, 4, 4]"
天香 ,景覃,仄仄平平，平平仄仄，平平仄平平仄。平仄平平，平平平仄，仄仄仄平平仄。仄平平仄，仄仄仄、平平平仄。仄仄平平，仄平仄仄，仄平平仄。平平仄平仄仄。仄平平、仄平平仄。仄仄平平，平仄仄平平仄。仄仄平平仄仄，仄仄仄、平平仄平仄。仄仄平平，平平仄仄。,0,47,49,96,"[4, 4, 6, 4, 4, 6, 4, 3, 4, 4, 4, 4, 6, 3, 4, 4, 6, 6, 3, 5, 4, 4]"
熙州慢 ,张先,仄平平、仄仄仄平平，仄仄平仄。仄仄平平，仄仄平平仄，平平平仄。仄仄仄平平仄，仄仄平仄平平。平仄仄仄，平平仄仄，仄平平仄。平仄平平仄仄。仄平仄、仄仄平平平仄。平仄仄平，平平仄平平仄。平平仄平仄平，仄仄仄、平平平仄。仄平仄。平平仄仄平仄。,0,46,50,96,"[3, 5, 4, 4, 5, 4, 6, 6, 4, 4, 4, 6, 3, 6, 4, 6, 6, 3, 4, 3, 6]"
汉宫春 ,晁冲之,仄仄平平，仄平平仄仄，平仄平平。平平仄平仄仄，平仄平平。平平仄仄，仄平平、仄仄平平。平仄仄、平平仄仄，平平仄仄平平。平仄仄平平仄，仄仄平仄仄，仄仄平平。平平仄平仄仄，仄仄平平。平平仄仄，平平平、平仄平平。平仄仄、平平仄仄，平平平仄平平。,0,53,43,96,"[4, 5, 4, 6, 4, 4, 3, 4, 3, 4, 6, 6, 5, 4, 6, 4, 4, 3, 4, 3, 4, 6]"
汉宫春 ,无名氏,仄仄平平，仄平平仄仄，仄仄平平。平平仄仄，仄平仄仄平平。平平仄仄，仄平平、仄仄平平。平仄仄、平平仄仄，平平仄仄平平。平仄仄平平仄，仄平平仄仄，平仄平平。平平仄仄，仄平仄仄平平。平平仄仄，仄平平、仄仄平平。平仄仄、平平仄仄，仄平平仄平平。,0,50,46,96,"[4, 5, 4, 4, 6, 4, 3, 4, 3, 4, 6, 6, 5, 4, 4, 6, 4, 3, 4, 3, 4, 6]"
汉宫春 ,无名氏,平仄平平，仄平平仄仄，仄仄平平。平平仄仄，仄平仄仄平平。平平仄仄，仄平平、平仄平平。平仄仄、平平仄仄，平平仄仄平平。仄仄仄，平平仄，仄仄平仄仄，平仄平平。平平仄平，仄仄仄仄平平。平平仄仄，仄平平、平仄平平。平仄仄、平平仄仄，平平仄仄平平。,0,51,45,96,"[4, 5, 4, 4, 6, 4, 3, 4, 3, 4, 6, 3, 3, 5, 4, 4, 6, 4, 3, 4, 3, 4, 6]"
汉宫春 ,无名氏,仄仄平平，仄平平仄仄，平仄平平。平平仄平仄仄，仄仄平平。平平仄仄，仄仄平、平仄平平。平仄仄、平平仄仄仄，平平平仄平平。平仄仄平平仄，仄仄平仄仄，平仄平平。平平仄仄仄仄，仄仄平平。平平仄仄，仄平平、仄仄平平。平仄仄、平平仄仄，仄平仄仄平平。,0,49,48,97,"[4, 5, 4, 6, 4, 4, 3, 4, 3, 5, 6, 6, 5, 4, 6, 4, 4, 3, 4, 3, 4, 6]"
汉宫春 ,彭元逊,仄仄平平，仄仄平平仄，仄仄平平。仄平平仄，平仄平仄平平。平平仄仄，仄仄平、仄仄平平。仄仄仄平仄仄，平平仄仄平平。平仄仄平平仄，平平仄仄，仄仄平平。平平仄平平仄，平仄平平。平平仄仄，仄平平、仄仄平平。平仄仄、平平平仄，平平仄仄平平。,0,50,44,94,"[4, 5, 4, 4, 6, 4, 3, 4, 6, 6, 6, 4, 4, 6, 4, 4, 3, 4, 3, 4, 6]"
汉宫春 ,张先,平仄平平。仄平平平仄，平仄平平。平平仄仄，仄平平仄平平。平平仄仄，仄仄平、仄仄平平。平仄仄、平平仄仄，平平仄仄平平。平平仄仄平平。仄平平仄仄，平仄平平。平平仄仄，仄平仄仄平平。平平仄仄，仄仄平、仄仄平平。平仄仄、平平仄仄，平平仄仄平平。,0,53,43,96,"[4, 5, 4, 4, 6, 4, 3, 4, 3, 4, 6, 6, 5, 4, 4, 6, 4, 3, 4, 3, 4, 6]"
汉宫春 ,沈会宗,仄仄平平。仄仄平仄仄，仄仄平平。平平仄平仄仄，仄仄平平。平平仄仄，仄仄平、仄仄平平。仄仄仄、平平仄平，平仄仄仄平平。平平仄仄平平。仄平平仄仄，平仄平平。平平仄仄，仄平仄仄平平。平平仄仄，仄仄平、仄仄平平。平仄仄、平平仄平仄仄，仄仄平平。,0,46,50,96,"[4, 5, 4, 6, 4, 4, 3, 4, 3, 4, 6, 6, 5, 4, 4, 6, 4, 3, 4, 3, 6, 4]"
汉宫春 ,京镗,仄仄平平。仄平平仄仄，仄仄平平。平平平平仄仄，仄仄平平。平平仄仄，仄平平、仄仄平平。平仄仄、仄平仄仄，仄平平仄平平。仄仄平平仄仄，仄仄平仄仄，仄仄平平。平平仄平仄仄，仄仄平平。平平仄仄，仄平平、仄仄平平。平仄仄、平平仄仄，平平仄仄平平。,0,47,49,96,"[4, 5, 4, 6, 4, 4, 3, 4, 3, 4, 6, 6, 5, 4, 6, 4, 4, 3, 4, 3, 4, 6]"
汉宫春 ,康与之,平仄平平，仄平平仄平，仄平平仄。平平仄仄，仄仄仄平平仄。平平仄仄，仄平平、仄平平仄。平仄仄、平平仄仄，平平仄平平仄。平平仄平平仄。仄平平仄仄，平平仄仄。平平仄仄，仄仄仄平平仄。平平仄仄，仄平平、平平平仄。平仄仄、平平仄仄，仄仄仄平平仄。,0,49,47,96,"[4, 5, 4, 4, 6, 4, 3, 4, 3, 4, 6, 6, 5, 4, 4, 6, 4, 3, 4, 3, 4, 6]"
汉宫春 ,无名氏,平仄平平，仄平平仄仄，平仄平仄。平平仄仄，仄仄仄平平仄。平平仄仄。仄仄仄、平平平仄。平仄仄、平平平仄，平仄仄平平仄。仄仄。仄平平仄，仄平平仄仄，仄平平仄。平平仄仄，仄仄仄平平仄。平平仄仄。仄仄仄、平平平仄。平仄仄、平平仄仄，平平仄仄。,0,43,51,94,"[4, 5, 4, 4, 6, 4, 3, 4, 3, 4, 6, 2, 4, 5, 4, 4, 6, 4, 3, 4, 3, 4, 4]"
倦寻芳 ,王雱,仄平仄仄，平仄平平，仄仄平仄。仄仄平平，平仄仄平平仄。仄平平，平平仄，仄平仄仄平平仄。仄平平，仄平平仄仄，平平平仄。仄平仄、平平仄仄，仄仄平平，平仄平仄。仄仄平平，仄仄仄平平仄。仄仄平平平仄仄。仄平平仄平平仄。仄平平，仄平平，仄平平仄。,0,48,48,96,"[4, 4, 4, 4, 6, 3, 3, 7, 3, 5, 4, 3, 4, 4, 4, 4, 6, 7, 7, 3, 3, 4]"
倦寻芳 ,潘元质,仄平仄仄，平仄平平，平仄平仄。仄仄平平，平仄仄平平仄。仄仄平平平仄仄，仄平平仄平平仄。仄平平，仄平平仄仄，仄平平仄。仄仄仄、平平平仄，平仄平平，平仄平仄。仄仄平平，仄仄仄平平仄。平仄平平平仄仄，仄平平仄平平仄。仄平平，仄平平，仄平平仄。,0,50,47,97,"[4, 4, 4, 4, 6, 7, 7, 3, 5, 4, 3, 4, 4, 4, 4, 6, 7, 7, 3, 3, 4]"
剑器近 ,袁去华,仄平仄。仄仄仄、平平平仄。仄平仄平平仄。仄平仄。仄平仄。仄仄仄、平平仄仄。平平仄平平仄。仄平仄。平仄。仄平平仄仄。平平仄仄，仄仄仄，仄仄平平仄。平平平仄仄平平，仄平平仄平，仄平平仄平仄。仄平平仄。仄仄平平，仄仄平平仄仄。仄平仄仄平平仄。,0,43,53,96,"[3, 3, 4, 6, 3, 3, 3, 4, 6, 3, 2, 5, 4, 3, 5, 7, 5, 6, 4, 4, 6, 7]"
秋兰香 ,陈亮,仄仄平平，平仄仄仄，平平仄仄平平。平平平仄仄，平仄仄平平。仄平仄、平仄仄平平。仄平平仄平平。仄平仄、仄平平仄，仄仄平平。仄仄仄平平仄，仄仄仄平平，仄仄平平。仄平平、仄仄仄平平。平平仄平平。平仄仄平，平仄平平。仄仄仄、平平平仄，仄仄平平。,0,50,46,96,"[4, 4, 6, 5, 5, 3, 5, 6, 3, 4, 4, 6, 5, 4, 3, 5, 5, 4, 4, 3, 4, 4]"
凤鸾双舞 ,汪元量,平平仄，平平仄仄，仄平平平仄。平仄仄仄，平平仄仄，仄平平仄，仄平平仄。平平仄、平平仄平，平平仄仄。仄仄仄仄平平仄平，平平平仄，仄平平仄。仄平仄仄。仄仄仄、平平平仄。仄平平仄，仄平仄平仄。仄仄平平，平平仄、仄仄仄平平仄。平仄。仄仄仄平平仄。,0,46,50,96,"[3, 4, 5, 4, 4, 4, 4, 3, 4, 4, 8, 4, 4, 4, 3, 4, 4, 5, 4, 3, 6, 2, 6]"
行香子慢 ,无名氏,仄仄平平。仄平平仄平，平仄平平。平平平仄仄，平仄平平。平平仄、平仄平仄，平仄平仄平平。平仄仄，仄仄平平，仄仄仄平平。平平。仄仄平平。仄平仄仄平，平仄平平。平平仄仄，仄平仄平平。平平仄、仄平平仄，仄平平仄平平。平仄平平，平平仄仄，平仄平平。,0,57,39,96,"[4, 5, 4, 5, 4, 3, 4, 6, 3, 4, 5, 2, 4, 5, 4, 4, 5, 3, 4, 6, 4, 4, 4]"
甘露滴乔松 ,无名氏,平平仄仄，仄仄平平仄，平平平仄。仄仄平仄仄平，平仄平仄。仄平仄、仄平平。仄平仄、仄平仄仄。平平平仄，平平平仄，平平平仄。仄平仄仄平平，仄平仄平平，仄平平仄。仄平平仄，仄仄平平平仄。仄仄仄、仄平平。仄仄仄、平平平仄。仄平仄仄，仄仄仄平平仄。,0,46,50,96,"[4, 5, 4, 6, 4, 3, 3, 3, 4, 4, 4, 4, 6, 5, 4, 4, 6, 3, 3, 3, 4, 4, 6]"
庆千秋 ,无名氏,仄仄平平，仄平平仄仄，仄仄平平。平平仄仄，平仄仄仄平平。平平仄、仄仄平平，平仄平平。仄仄仄平平仄仄，平平平仄平平。仄仄平平平仄，仄仄平平仄，仄仄平平。平平仄平仄仄，平仄平平。平平仄、仄仄平平，平仄平平。平仄仄、平平仄仄，仄平仄仄平平。,0,51,45,96,"[4, 5, 4, 4, 6, 3, 4, 4, 7, 6, 6, 5, 4, 6, 4, 3, 4, 4, 3, 4, 6]"
塞垣春 ,周邦彦,仄仄平平仄。仄仄仄、平平仄。平平仄仄，仄平平仄，平仄平仄。仄仄平仄仄平平仄。仄仄仄、平平仄。仄平平、平平仄，仄平平仄平仄。平仄仄平平，平平仄、平仄平仄。仄仄仄平平，仄平仄平仄。仄平平、仄仄平仄，平平仄、仄平平平仄。仄仄仄平仄，仄平平仄仄。,0,44,52,96,"[5, 3, 3, 4, 4, 4, 8, 3, 3, 3, 3, 6, 5, 3, 4, 5, 5, 3, 4, 3, 5, 5, 5]"
塞垣春 ,方千里,仄仄平平仄。仄仄仄、平平仄。平平仄仄，仄平平仄，平仄平仄。仄仄平仄仄平平仄。仄仄仄、平平仄。仄平平、平平仄，仄平平平仄。平仄仄平平，平平仄、平仄平仄。仄仄仄平平，仄平仄平仄。仄平平、平仄平仄，平平仄、仄平平平仄。仄仄仄平仄，仄平平仄仄。,0,45,50,95,"[5, 3, 3, 4, 4, 4, 8, 3, 3, 3, 3, 5, 5, 3, 4, 5, 5, 3, 4, 3, 5, 5, 5]"
塞垣春 ,杨泽民,仄仄平平仄。仄仄仄、平平仄。平平仄仄，仄平平仄，平仄平仄。仄平平仄仄平平仄。仄仄仄、平平仄。仄平平、平平仄，仄平仄平仄。仄仄仄平平，平平仄平仄平仄。仄仄仄平平，仄平仄平仄。仄平平仄仄，平仄平平，仄仄平、平平仄。仄仄仄平仄，仄平平仄仄。,0,43,52,95,"[5, 3, 3, 4, 4, 4, 8, 3, 3, 3, 3, 5, 5, 7, 5, 5, 5, 4, 3, 3, 5, 5]"
塞垣春 ,吴文英,仄仄平平仄。仄仄仄、平平仄。平平仄仄，仄平平仄，平仄平仄。仄仄平、仄仄平平仄。仄仄仄、平平仄。仄平平、平平仄，仄平平仄平仄。平仄仄平平，仄平仄平平，平仄平仄。仄仄仄平平，仄平仄平仄。仄平平仄仄，平仄平平，仄平平、仄平仄。平仄仄平仄，仄平平平仄。,0,47,51,98,"[5, 3, 3, 4, 4, 4, 3, 5, 3, 3, 3, 3, 6, 5, 5, 4, 5, 5, 5, 4, 3, 3, 5, 5]"
望云间 ,赵可,平仄平平，平仄仄平，平平平仄平平。仄平平仄仄，平仄平平。平仄平平仄仄，平平仄仄平平。仄平平平仄，仄仄平平，平仄平平。平平仄仄，仄仄平平，仄平仄仄平平。平仄平平平仄，平仄平平。平仄仄平平仄，平平仄仄平平。仄平仄仄，仄平平仄，仄仄平平。,0,56,40,96,"[4, 4, 6, 5, 4, 6, 6, 5, 4, 4, 4, 4, 6, 6, 4, 6, 6, 4, 4, 4]"
步月 ,史达祖,仄仄平平，仄平平仄，仄平平仄平平。仄平平仄，仄仄仄平平。仄平仄、平平仄仄，仄仄仄、平仄平平。平平仄、平平仄仄，平仄仄平平。平平。平仄仄，仄平仄仄仄，平仄平平。仄平平仄，平仄仄平平。仄平仄、平平仄仄，仄仄平、平仄平平。平平仄，平平仄仄仄平平。,0,50,46,96,"[4, 4, 6, 4, 5, 3, 4, 3, 4, 3, 4, 5, 2, 3, 5, 4, 4, 5, 3, 4, 3, 4, 3, 7]"
步月 ,施岳,仄仄平平，仄平平仄。仄平仄仄平仄。仄平仄仄，仄仄平平仄。仄平仄、仄仄仄平，平平仄、仄平平仄。平平仄、平仄仄平，仄平平仄。平平平仄仄。平仄仄平平，平仄平仄。仄平仄仄，仄平平平仄。仄平仄、平仄平平，仄平仄、仄平平仄。平平仄，平仄仄平仄仄。,0,44,50,94,"[4, 4, 6, 4, 5, 3, 4, 3, 4, 3, 4, 4, 5, 5, 4, 4, 5, 3, 4, 3, 4, 3, 6]"
早梅香 ,无名氏,仄仄平平，仄仄仄仄平，仄平平仄。仄仄平平，仄平平平，平仄平仄。仄仄平平，平仄仄、仄平平仄。仄仄平，平平仄仄，仄平平仄。仄仄仄平平，仄平平平仄平仄。仄仄平平，平仄仄平，平平仄平平仄。仄仄平仄，仄平仄、仄平平仄。仄仄平平，平平仄仄，仄平平仄。,0,46,50,96,"[4, 5, 4, 4, 4, 4, 4, 3, 4, 3, 4, 4, 5, 7, 4, 4, 6, 4, 3, 4, 4, 4, 4]"
八声甘州 ,柳永,仄平平仄仄仄平平，仄平仄平平。仄平平平仄，平平仄仄，平仄平平。仄仄平平仄仄，仄仄仄平平。平仄平平仄，平仄平平。仄仄平平平仄，仄仄平仄仄，平仄平平。仄平平平仄，平仄仄平平。仄平平、平平平仄，仄仄平、平仄仄平平。平平仄、仄平平仄，仄仄平平。,0,53,44,97,"[8, 5, 5, 4, 4, 6, 5, 5, 4, 6, 5, 4, 5, 5, 3, 4, 3, 5, 3, 4, 4]"
八声甘州 ,张炎,仄仄平仄仄仄平平。平仄仄平平。仄平平仄仄，平平仄仄，仄仄平平。仄仄平平平仄，仄仄仄平平。仄仄平平仄，仄仄平平。仄仄仄平平仄，仄平平仄仄，仄仄平平。仄平平仄仄，平仄仄平平。仄平平、仄平平仄，仄平平、仄仄仄平平。平平仄、仄平平仄，仄仄平平。,0,46,51,97,"[8, 5, 5, 4, 4, 6, 5, 5, 4, 6, 5, 4, 5, 5, 3, 4, 3, 5, 3, 4, 4]"
八声甘州 ,刘过,仄仄平仄仄仄平平，仄平仄平平。平平仄平平仄，仄仄平平。平仄平平仄仄，平仄仄平平。平仄仄平仄，平仄平平。仄仄仄平仄仄，仄平平仄仄，仄仄平平。仄平平仄仄，仄仄仄平平。仄平平、平平仄仄，仄仄平、平仄仄平平。平平仄、仄平平仄仄，平仄平平。,0,47,48,95,"[8, 5, 6, 4, 6, 5, 5, 4, 6, 5, 4, 5, 5, 3, 4, 3, 5, 3, 5, 4]"
八声甘州 ,汤恢,仄平平仄仄，仄平平、平仄仄平平。仄仄平平仄，仄平仄仄，平仄平平。仄仄平平平仄，平仄平平。平仄平平仄，平仄平平。仄仄平平平仄，仄仄平仄仄，平仄平平。仄平平仄仄，仄仄平平。仄平平、仄平平仄，仄平平、平仄仄平平。平平仄、平平平仄，仄仄平平。,0,52,43,95,"[5, 3, 5, 5, 4, 4, 6, 4, 5, 4, 6, 5, 4, 5, 4, 3, 4, 3, 5, 3, 4, 4]"
八声甘州 ,萧列,仄平平、平平仄平平，平平仄平平。平平仄仄，平平仄仄，仄仄仄平平。平仄仄平平仄，平仄仄平平。平仄仄平仄，仄仄平平。仄仄平平仄仄，仄平平仄仄，仄仄平平。仄平平仄仄，平仄仄平平。仄仄平平仄，仄平平仄，仄仄平平。平平仄、平平平仄，平仄平平。,0,51,44,95,"[3, 5, 5, 4, 4, 5, 6, 5, 5, 4, 6, 5, 4, 5, 5, 5, 4, 4, 3, 4, 4]"
八声甘州 ,姚云文,仄平平、仄仄仄平平。仄平仄平平。仄平平仄仄，平平仄仄，平仄平平。平仄平平仄仄，平仄仄平平。仄仄平平仄，仄仄平平。平仄平平，平仄仄、平平平仄，仄仄平平。仄仄平仄仄，平仄仄平平。仄仄平、仄平平仄，仄平平、平仄仄仄平平。平平仄、平平仄仄，仄仄平平。,0,51,47,98,"[3, 5, 5, 5, 4, 4, 6, 5, 5, 4, 4, 3, 4, 4, 5, 5, 3, 4, 3, 6, 3, 4, 4]"
八声甘州 ,郑子玉,仄平平仄仄，仄平平、平仄仄平平。仄平平仄仄，平平平仄，平仄平平。仄仄仄平平仄，平仄仄平平。平仄平平仄，平仄平平。仄仄平平平仄，仄仄平平仄，平仄平平。仄平平平平，仄仄仄平平。仄平仄、平平仄仄，平仄平仄仄平平。平平仄、仄平平仄，仄仄平平。,0,53,43,96,"[5, 3, 5, 5, 4, 4, 6, 5, 5, 4, 6, 5, 4, 5, 5, 3, 4, 7, 3, 4, 4]"
迷神引 ,柳永,平仄平平平平仄。仄仄仄平平仄。平平仄仄，仄平平仄。仄平平，平平仄，仄平仄。平仄平平仄，仄平仄。仄仄平平仄，仄平仄。仄仄平平，仄仄平平仄。仄仄平平，平平仄。仄平仄仄，仄平平、平平仄。仄平平，平平仄，仄平仄。平仄平平仄，仄平仄。平平平平仄，仄仄仄。,0,49,48,97,"[7, 6, 4, 4, 3, 3, 3, 5, 3, 5, 3, 4, 5, 4, 3, 4, 3, 3, 3, 3, 3, 5, 3, 5, 3]"
迷神引 ,朱雍,仄仄平平平平仄。仄仄平平平仄。平平仄仄，仄平平仄。仄平平，平平仄。仄平仄。平仄平平仄。仄平仄。平仄平平仄，仄平仄。仄仄平平，仄仄平平仄。仄仄平平，平平仄。仄平仄仄，仄平仄、平平仄。仄平平，平平仄，平平仄。平仄平平仄，平仄仄。平平平平仄，仄平仄。,0,51,46,97,"[7, 6, 4, 4, 3, 3, 3, 5, 3, 5, 3, 4, 5, 4, 3, 4, 3, 3, 3, 3, 3, 5, 3, 5, 3]"
醉蓬莱 ,柳永,仄平平仄仄，仄仄平平，仄平平仄。平仄平平，仄平平平仄。仄仄平平，仄平平仄，仄仄平平仄。仄仄平平，平平仄仄，仄平平仄。仄仄平平，仄平平仄，仄仄平平，仄平平仄。平仄平平，仄仄平平仄。仄仄平平，仄仄平仄，仄仄平平仄。仄仄平平，平平平仄，仄平平仄。,0,49,48,97,"[5, 4, 4, 4, 5, 4, 4, 5, 4, 4, 4, 4, 4, 4, 4, 4, 5, 4, 4, 5, 4, 4, 4]"
醉蓬莱 ,苏轼,仄平平仄仄，平仄平平，仄平平仄。平仄平平，仄平平平仄。仄仄平平，仄仄平仄，仄仄平平仄。仄仄平平，平平仄仄，仄平平仄。仄仄平平仄仄，平仄仄仄平平，仄平平仄。平仄平平，仄仄平平仄。平仄平平，仄仄平仄，仄仄平平仄。仄仄平平，仄平平仄，仄平平仄。,0,48,49,97,"[5, 4, 4, 4, 5, 4, 4, 5, 4, 4, 4, 6, 6, 4, 4, 5, 4, 4, 5, 4, 4, 4]"
凤凰台上忆吹箫 ,晁补之,平仄平平，仄平仄仄，平平仄仄平平。仄仄仄、平平仄仄，平仄平平。仄仄平平仄仄，平仄仄、平仄平平。平平仄，仄仄仄平，平仄平平。平平仄平仄仄，平仄仄，平平仄仄平平。仄平仄、平平仄仄，仄仄平平。平仄平平仄仄，平仄仄、平仄平平。平平仄，平仄仄仄平平。,0,50,47,97,"[4, 4, 6, 3, 4, 4, 6, 3, 4, 3, 4, 4, 6, 3, 6, 3, 4, 4, 6, 3, 4, 3, 6]"
凤凰台上忆吹箫 ,曹勛,仄仄平平，仄平仄仄，平平平仄平平。仄仄仄、平平仄仄，仄仄平平。仄仄平平仄仄，平仄仄、仄仄平平。平平仄，平仄仄平，平仄平平。平平。仄平平仄，平仄仄、平平仄仄平平。仄仄仄、平平仄仄，仄仄平平。平仄平平仄仄，平仄仄、平仄平平。平平仄，平仄仄仄平平。,0,49,48,97,"[4, 4, 6, 3, 4, 4, 6, 3, 4, 3, 4, 4, 2, 4, 3, 6, 3, 4, 4, 6, 3, 4, 3, 6]"
凤凰台上忆吹箫 ,张台卿,平平平仄，仄仄平平，平平仄仄平平。平仄平平平仄，平仄平平。平平仄平仄仄，仄平平、平仄平平。平平仄，仄平平平仄，平仄平平。平仄仄平平仄，平平仄，平平仄仄平平。仄仄平平平仄，平仄平平。平平仄平仄仄，仄平仄、仄仄平平。平平仄，仄平平仄仄仄平。,0,58,39,97,"[4, 4, 6, 6, 4, 6, 3, 4, 3, 5, 4, 6, 3, 6, 6, 4, 6, 3, 4, 3, 7]"
凤凰台上忆吹箫 ,吴元可,仄仄平平，平平仄仄，仄平仄仄平平。仄仄平平仄仄，平仄平平。平仄平平平仄，平仄仄、仄仄平平。仄平仄，仄平仄仄，平仄平平。平平仄平仄仄，仄仄平平仄，仄仄平平。仄仄仄、平平仄仄，仄仄平平。仄仄平平仄仄，平平仄、仄仄平平。平平仄，仄平仄仄平平。,0,46,50,96,"[4, 4, 6, 6, 4, 6, 3, 4, 3, 4, 4, 6, 5, 4, 3, 4, 4, 6, 3, 4, 3, 6]"
凤凰台上忆吹箫 ,李清照,平仄平平，仄平平仄，仄平平仄平平。仄仄平平仄，仄仄平平。平仄平平仄仄，平仄仄、仄仄平平。平平仄，平平仄仄，仄仄平平。平平。仄平仄仄，平仄仄平平，仄仄平平。仄仄平平仄，平仄平平。平仄平平平仄，平仄仄、平仄平平。平平仄，平平仄平，仄仄平平。,0,53,42,95,"[4, 4, 6, 5, 4, 6, 3, 4, 3, 4, 4, 2, 4, 5, 4, 5, 4, 6, 3, 4, 3, 4, 4]"
凤凰台上忆吹箫 ,张翥,平仄平平，平平仄仄，仄平平仄平平。仄仄平平仄，仄仄平平。平仄平平仄仄，仄仄平、仄仄平平。平平仄，平平仄仄，仄仄平平。平平仄平仄仄，仄仄仄平平，平仄平平。仄仄平平仄，仄仄平平。仄仄平平仄仄，仄仄平、平仄平平。平平仄，平平仄仄，仄仄平平。,0,49,46,95,"[4, 4, 6, 5, 4, 6, 3, 4, 3, 4, 4, 6, 5, 4, 5, 4, 6, 3, 4, 3, 4, 4]"
夜合花 ,晁补之,仄仄平平，仄平平仄，仄平仄仄平平。平平仄仄，仄平仄仄平平。仄平仄平平。仄平平平仄平平。仄平平仄，平平仄仄，仄仄平平。平平仄仄平平。仄平平，仄平平仄平平。平平仄仄，平平仄仄平平。仄仄仄平平。仄平仄平仄平平。仄平平仄，平平仄仄，仄仄平平。,0,54,43,97,"[4, 4, 6, 4, 6, 5, 7, 4, 4, 4, 6, 3, 6, 4, 6, 5, 7, 4, 4, 4]"
夜合花 ,史达祖,仄仄平平，平平平仄，仄平平仄平平。平平仄仄，平平仄仄平平。平仄仄，仄平平。仄平平、平仄平平。仄平平仄，平平平仄，平仄平平。平平平仄平平。平仄平平仄仄，平仄平平。仄平仄仄，仄平仄仄平平。平仄仄，仄平平。仄平平、平仄平平。仄平平仄，平平仄仄，平仄平平。,0,61,39,100,"[4, 4, 6, 4, 6, 3, 3, 3, 4, 4, 4, 4, 6, 6, 4, 4, 6, 3, 3, 3, 4, 4, 4, 4]"
夜合花 ,高观国,平仄平平，平平仄仄，仄平平仄平平。平平仄仄，平平仄仄平平。仄仄仄，仄平平。仄平平、平仄平平。仄平平仄，平平仄仄，仄仄平平。平平。仄仄平平。平仄平平仄仄，平仄平平。平平仄仄，平平仄仄平平。仄仄仄，仄平平。仄仄平、平仄平平。仄平平仄，平平仄仄，平仄平平。,0,57,43,100,"[4, 4, 6, 4, 6, 3, 3, 3, 4, 4, 4, 4, 2, 4, 6, 4, 4, 6, 3, 3, 3, 4, 4, 4, 4]"
夜合花 ,曹勛,平仄平平，仄平平仄，仄平平仄平平。平平仄仄，平平仄仄平平。仄平平仄平平。仄平仄、仄仄平平。仄平平仄，仄平仄仄，平仄平平。平平仄仄平平。仄仄平平仄仄，平仄平平。平仄仄仄，平平仄仄平平。仄平仄仄平仄，仄平仄、仄仄平平。仄平平仄，平平仄仄，仄仄平平。,0,53,47,100,"[4, 4, 6, 4, 6, 6, 3, 4, 4, 4, 4, 6, 6, 4, 4, 6, 6, 3, 4, 4, 4, 4]"
夜合花 ,孙惟信,平仄平平，仄平平仄，仄平平仄平平。仄平仄仄，平平仄仄平平。仄仄仄，仄平平。仄平平、平仄平平。仄平平仄，平平仄仄，仄仄平平。平仄仄仄平平。仄平平仄仄，平仄平平。平平仄仄，平平仄仄平平。平仄仄，仄平平。仄平平、平仄平平。仄平平仄，仄平仄仄，仄仄平平。,0,54,45,99,"[4, 4, 6, 4, 6, 3, 3, 3, 4, 4, 4, 4, 6, 5, 4, 4, 6, 3, 3, 3, 4, 4, 4, 4]"
采明珠 ,杜安世,仄仄平、仄仄平平，平仄平平仄仄。仄仄仄平平，仄仄平平仄。仄仄平平仄。仄平平、仄仄平平，仄仄仄平，仄仄平平，平平仄仄平仄。平仄仄。平平仄。仄仄仄平仄。平仄仄。仄仄仄平，仄平平仄。平仄平平仄。仄平平、仄仄平平，仄仄仄平仄仄，平平平仄，仄平平仄。,0,43,54,97,"[3, 4, 6, 5, 5, 5, 3, 4, 4, 4, 6, 3, 3, 5, 3, 4, 4, 5, 3, 4, 6, 4, 4]"
庆清朝 ,王观,平仄平平，平平仄仄，平平平仄平平。平平仄平平仄，仄仄平平。仄仄仄平仄仄，平平平仄仄平平。平平仄，仄平仄仄，平仄平平。平仄仄、平仄仄，仄仄仄平仄，仄仄平平。平平平平仄仄，平仄平平。仄仄平平仄仄，平平平仄仄平平。平平仄，仄平仄仄，平仄平平。,0,53,44,97,"[4, 4, 6, 6, 4, 6, 7, 3, 4, 4, 3, 3, 5, 4, 6, 4, 6, 7, 3, 4, 4]"
庆清朝 ,史达祖,仄仄平平，平平仄仄，平平平仄平平。平平仄仄，仄平平仄平平。仄仄仄平平仄，仄平平仄仄平平。平平仄，仄平仄仄，仄仄平平。平仄仄平仄仄，仄仄平平仄，仄仄平平。平平仄仄，平仄平仄平平。仄仄仄平仄仄，仄平平仄仄平平。平平仄，仄平仄仄，平仄平平。,0,49,48,97,"[4, 4, 6, 4, 6, 6, 7, 3, 4, 4, 6, 5, 4, 4, 6, 6, 7, 3, 4, 4]"
庆清朝 ,曹勛,仄平平仄，平平仄仄，仄仄仄仄平平。平平仄仄平仄，平仄平平。仄仄仄平仄仄，平平平仄仄平平。平平仄，仄仄仄仄，平仄平平。平仄仄平仄仄，仄仄仄，平平仄仄平平。平平仄仄，平仄平仄平平。仄仄仄平平仄，仄平平仄仄平平。平仄仄，仄平平仄，仄仄平平。,0,46,51,97,"[4, 4, 6, 6, 4, 6, 7, 3, 4, 4, 6, 3, 6, 4, 6, 6, 7, 3, 4, 4]"
庆清朝 ,李清照,仄仄平平，平平仄仄，仄平仄仄平平。平平仄仄仄仄，平仄平平。仄仄平平仄仄，仄平平仄仄平平。平平仄，仄平仄仄，平仄平平。平平平、平仄仄，仄仄平平仄，仄仄平平。仄平仄仄，平平仄仄平平。仄仄平平平仄，仄平平仄仄平平。平平仄，平仄仄仄，仄仄平平。,0,49,48,97,"[4, 4, 6, 6, 4, 6, 7, 3, 4, 4, 3, 3, 5, 4, 4, 6, 6, 7, 3, 4, 4]"
黄鹂绕碧树 ,周邦彦,平仄平平仄，平平仄仄，仄平平仄。仄仄平平，仄平平仄仄，仄平平仄。仄平仄仄，仄平仄、平平平仄。平仄仄、仄仄平平仄仄，平平平仄。仄仄平平仄仄。仄平平、仄平平仄。仄平仄、仄平平仄仄，平仄平仄。仄仄仄平仄仄，仄仄仄平平仄。平平仄仄平平，仄平平仄。,0,44,53,97,"[5, 4, 4, 4, 5, 4, 4, 3, 4, 3, 6, 4, 6, 3, 4, 3, 5, 4, 6, 6, 6, 4]"
帝台春 ,李甲,平仄仄仄。平平仄平仄。仄仄仄平，仄仄平平，平平平仄。仄仄平平仄仄仄，仄平仄、仄平平仄。仄平平，仄仄平平，平平仄仄。平仄仄。平仄仄。仄仄仄。仄平仄。仄仄仄平平，仄平平，仄仄仄、仄平平仄。平仄平平仄平仄，平仄仄平仄平仄。仄平仄平平，仄平平平仄。,0,43,54,97,"[4, 5, 4, 4, 4, 7, 3, 4, 3, 4, 4, 3, 3, 3, 3, 5, 3, 3, 4, 7, 7, 5, 5]"
瑶台第一层 ,张元干,仄仄平平，平仄仄、平平仄仄平。仄平平仄，平平平仄，平仄平平。仄平平仄仄，仄仄平、平仄平平。仄平仄，仄仄平平仄，平仄平平。平平。仄平平仄，仄平仄仄仄平平。仄平平仄，平平平仄，仄仄平平。仄平平仄仄，仄仄平、平仄平平。仄平平。仄平平平仄，仄仄平平。,0,53,44,97,"[4, 3, 5, 4, 4, 4, 5, 3, 4, 3, 5, 4, 2, 4, 7, 4, 4, 4, 5, 3, 4, 3, 5, 4]"
瑶台第一层 ,张元干,平仄平平，平仄仄、平平仄仄平。仄平平仄，平平仄仄，仄仄平平。仄平平仄仄，仄仄平、仄仄平平。仄平仄，仄平平平仄，平仄平平。平平。仄平平仄，仄平平仄仄仄平平。仄平平仄，仄平平仄，平仄平平。仄平平仄仄，仄仄仄、仄仄平平。仄平平。仄平平平仄，仄仄平平。,0,51,47,98,"[4, 3, 5, 4, 4, 4, 5, 3, 4, 3, 5, 4, 2, 4, 8, 4, 4, 4, 5, 3, 4, 3, 5, 4]"
瑶台第一层 ,赵与䥏,仄仄平平。平仄仄、平平仄仄平。仄平平仄，平平平仄，平仄平平。仄平仄平仄仄，仄仄仄、仄仄平平。平平仄，仄平平平仄，仄仄平平。平平。平平仄仄，仄平平仄仄平平。仄平平仄，平平仄仄，平仄平平。仄平平仄仄，仄仄平、平仄平平。仄平平。仄平平平仄，仄仄平平。,0,53,45,98,"[4, 3, 5, 4, 4, 4, 6, 3, 4, 3, 5, 4, 2, 4, 7, 4, 4, 4, 5, 3, 4, 3, 5, 4]"
暗香 ,姜夔,仄平仄仄。仄仄平仄仄，平平平仄。仄仄仄平，仄仄平平仄平仄。平仄平平仄仄，平平仄、平平平仄。仄仄仄、仄仄平平，平仄仄平仄。平仄。仄仄仄。仄仄仄仄平，仄仄平仄。仄平仄仄。平仄平平仄平仄。平仄平平仄仄，平仄仄、平平平仄。仄仄仄、平仄仄，仄平仄仄。,0,38,59,97,"[4, 5, 4, 4, 7, 6, 3, 4, 3, 4, 5, 2, 3, 5, 4, 4, 7, 6, 3, 4, 3, 3, 4]"
暗香 ,张炎,平平平仄。仄仄平仄仄，仄平平仄。仄仄平平，仄仄平平仄平仄。仄仄平平仄仄，平仄仄、仄平平仄。仄平平、仄仄平平，仄仄仄平仄。平仄。仄平仄。仄仄平仄平，仄平平仄。仄平仄仄。平仄仄平仄平仄。平仄仄、平仄仄，平仄仄、平平平仄。仄仄仄、平仄仄，仄平仄仄。,0,39,58,97,"[4, 5, 4, 4, 7, 6, 3, 4, 3, 4, 5, 2, 3, 5, 4, 4, 7, 3, 3, 3, 4, 3, 3, 4]"
梦芙蓉 ,吴文英,平平平仄仄。仄平平仄仄，仄平仄仄。仄平平仄，平仄仄平仄。仄平平仄仄。平平平仄平仄。仄仄平平，仄平平仄仄，平仄仄平仄。仄仄平平仄仄。平仄平平，仄仄平平仄。仄平平仄，平仄仄平仄。仄平平仄仄。平平仄仄平仄。仄仄平平，仄平平仄仄，平仄仄平仄。,0,44,53,97,"[5, 5, 4, 4, 5, 5, 6, 4, 5, 5, 6, 4, 5, 4, 5, 5, 6, 4, 5, 5]"
西子妆 ,吴文英,平仄仄平，仄平仄仄，仄仄平平平仄。仄平平仄仄平平，仄平平、仄平平仄。平平仄仄。仄仄仄、平平仄仄。仄平平，仄仄平平仄，平平平仄。平平仄。仄仄平平，仄仄平仄仄。仄平平仄仄平平，仄仄平、仄平平仄。平平仄仄。仄平仄、平平平仄。仄平平，仄仄平平仄仄。,0,47,50,97,"[4, 4, 6, 7, 3, 4, 4, 3, 4, 3, 5, 4, 3, 4, 5, 7, 3, 4, 4, 3, 4, 3, 6]"
玉京谣 ,吴文英,仄仄平平仄，仄仄平平，仄仄平平仄。仄仄平平，平平平仄平仄。仄仄仄、平仄平平，仄仄仄、平平平仄。平平仄。平平仄仄，平平平仄。平平仄仄平平，仄仄平平，仄仄平仄仄。平仄平平，平平平仄平仄。仄仄平、平仄平平，仄仄仄、仄平平仄。平仄仄。平仄仄平平仄。,0,49,48,97,"[5, 4, 5, 4, 6, 3, 4, 3, 4, 3, 4, 4, 6, 4, 5, 4, 6, 3, 4, 3, 4, 3, 6]"
被花恼 ,杨缵,平平仄仄仄平平，平仄仄平平仄。仄仄平平仄平仄。平平仄仄，平平仄仄，仄仄平平仄。平仄仄，仄平平，仄平平仄平平仄。平仄仄平平，平仄平平仄平仄。平平仄仄，仄仄平平，仄仄平平仄。仄平平仄仄仄平平，仄平仄、平平仄平仄。仄仄仄，仄仄平平平仄仄。,0,47,50,97,"[7, 6, 7, 4, 4, 5, 3, 3, 7, 5, 7, 4, 4, 5, 8, 3, 5, 3, 7]"
绿盖舞风轻 ,周密,仄仄仄平平，仄仄平平，平平仄平仄。平仄平平，平平平仄仄，仄仄平仄。仄仄平平，仄平仄、平平平仄。仄平平，仄仄平平，平仄平仄。平仄。仄仄平平，仄仄仄平平，仄仄平仄。仄仄平平，仄平平、仄仄仄平平仄。仄仄平平，仄平仄、平平平仄。仄平平，仄仄仄平平仄。,0,48,49,97,"[5, 4, 5, 4, 5, 4, 4, 3, 4, 3, 4, 4, 2, 4, 5, 4, 4, 3, 6, 4, 3, 4, 3, 6]"
月边娇 ,周密,平仄平平，仄仄仄平平，平平平仄。仄平仄仄，平平仄仄，仄仄仄平平仄。仄仄平平，仄仄仄、平平平仄。平平平仄，仄仄仄、平平平仄。仄平平仄平平，仄平平仄，仄平平仄。仄平平仄，平平仄仄，平仄仄平平仄。平平仄仄。仄仄仄、平平平仄。平平仄仄，仄仄平平仄。,0,48,49,97,"[4, 5, 4, 4, 4, 6, 4, 3, 4, 4, 3, 4, 6, 4, 4, 4, 4, 6, 4, 3, 4, 4, 5]"
松梢月 ,曹勛,仄仄平平。平平仄仄仄，平仄平平。平仄平仄，平仄仄仄平平。仄仄平平平平仄，仄仄仄、仄仄平平。仄仄平仄，平平仄，仄平仄平平。仄平平仄仄，仄仄平仄仄，平仄平平。仄仄平仄，平仄仄仄平平。仄仄平平平平仄，仄仄仄、仄仄平平。仄仄平仄，平平仄，仄平平。,0,45,52,97,"[4, 5, 4, 4, 6, 7, 3, 4, 4, 3, 5, 5, 5, 4, 4, 6, 7, 3, 4, 4, 3, 3]"
四槛花 ,曹勛,平仄平平。仄平平仄，仄平仄平。平平平仄仄，平平仄平平。仄仄平平，仄平平，平仄仄，仄仄平平。仄平平。平仄仄平仄仄，平仄平平。平仄仄仄平平。仄平仄、平平仄仄平。平仄平仄仄，平平仄平平。仄仄平平，仄平仄，平平仄，仄仄平平。平平仄，平仄仄，仄仄平平。,0,53,44,97,"[4, 4, 4, 5, 5, 4, 3, 3, 4, 3, 6, 4, 6, 3, 5, 5, 5, 4, 3, 3, 4, 3, 3, 4]"
长亭怨慢 ,姜夔,仄平仄、平平平仄。仄仄平平，仄平平仄。仄仄平平，仄平平仄仄平仄。仄平平仄，平仄仄、平平仄。仄仄仄平平，仄仄仄、平平平仄。仄仄。仄平平仄仄，仄仄仄平平仄。平平仄仄，仄平仄、仄平平仄。仄仄仄、仄仄平平，仄平仄、平平平仄。仄仄仄平平，平仄平平平仄。,0,44,53,97,"[3, 4, 4, 4, 4, 7, 4, 3, 3, 5, 3, 4, 2, 5, 6, 4, 3, 4, 3, 4, 3, 4, 5, 6]"
长亭怨慢 ,周密,仄平仄仄平平仄。仄仄平平，仄平平仄。仄仄平平，平平平仄仄平仄。仄平平仄。平仄仄、平平仄。平仄仄平平，仄仄仄、仄平平仄。平仄。仄平平仄仄，仄仄仄平平仄。仄平仄仄，仄平仄、仄平平仄。仄平仄仄仄平平，仄平仄、平平平仄。仄仄仄平平，仄仄平平平仄。,0,44,53,97,"[7, 4, 4, 4, 7, 4, 3, 3, 5, 3, 4, 2, 5, 6, 4, 3, 4, 7, 3, 4, 5, 6]"
长亭怨慢 ,张炎,仄平仄、仄平平仄。仄仄平平，仄平平仄。仄仄平平，仄平平仄仄平仄。仄平平仄。平平仄、平平仄仄。仄仄平平，平仄仄、平平平仄。平仄。仄平平仄仄。仄仄仄平平仄。平平仄仄。仄仄仄、仄平平仄。平平仄、平仄平平，仄平仄、平平平仄。仄仄仄平平，仄仄平平平仄。,0,47,50,97,"[3, 4, 4, 4, 4, 7, 4, 3, 4, 4, 3, 4, 2, 5, 6, 4, 3, 4, 3, 4, 3, 4, 5, 6]"
长亭怨慢 ,张炎,仄平仄、仄平平仄，平仄平平，仄平平仄。仄仄平平，仄平平仄仄平仄。仄平平仄，平平仄、平平仄仄。仄仄平平，平平仄、平平平仄。平仄。仄平平仄仄，平仄仄平平仄。平平仄仄，仄平仄、平平平仄。仄平平、仄仄平平，仄仄仄、仄平平仄。仄平仄平平，平仄仄平平仄。,0,50,47,97,"[3, 4, 4, 4, 4, 7, 4, 3, 4, 4, 3, 4, 2, 5, 6, 4, 3, 4, 3, 4, 3, 4, 5, 6]"
玉簟凉 ,史达祖,平仄平平。仄仄仄仄平，仄仄平平。平平平仄仄，仄仄仄平平。平平平仄仄仄，仄仄仄、仄仄平平。平仄仄，仄仄平平仄，平仄平平。平平。平平仄仄，平仄仄平，平仄仄仄平平。平平平仄仄，仄仄仄平平。平平仄仄仄仄，仄仄仄、仄仄平平。平仄仄，仄仄平、平仄平平。,0,45,52,97,"[4, 5, 4, 5, 5, 6, 3, 4, 3, 5, 4, 2, 4, 4, 6, 5, 5, 6, 3, 4, 3, 3, 4]"
留客住 ,柳永,仄平仄。仄仄平、仄平平仄，仄平平仄，仄仄平平仄仄。平仄平平仄仄，仄仄平平，平平平仄仄。平平仄仄，仄平平、仄仄仄平平仄。仄平仄。仄仄仄平平，平平仄仄。仄仄平平，仄仄平平平仄。平仄仄平平仄，仄仄平平，平平平仄仄。平平仄仄，仄平平、仄仄仄平平仄。,0,46,52,98,"[3, 3, 4, 4, 6, 6, 4, 5, 4, 3, 6, 3, 5, 4, 4, 6, 6, 4, 5, 4, 3, 6]"
留客住 ,周邦彦,平平仄。仄平平、平平平仄，仄仄平平平仄，平平平仄。仄仄平平仄仄，仄仄平仄，仄仄平平平仄，仄仄平平，平平仄平平仄。仄平仄。仄仄仄平平，平平平仄。平仄平平，仄仄平平平仄。仄仄平平仄仄，仄平平仄。仄仄平仄平仄仄，仄平仄、仄平仄仄平仄。,0,46,48,94,"[3, 3, 4, 6, 4, 6, 4, 6, 4, 6, 3, 5, 4, 4, 6, 6, 4, 7, 3, 6]"
昼夜乐 ,柳永,仄平仄仄平平仄。仄仄仄、平平仄。平平仄仄平平，仄仄仄平平仄。仄仄平平平仄仄。仄仄仄、仄平平仄。仄仄仄平平，仄平平平仄。仄平仄仄平平仄。仄平平、仄平仄。仄平仄仄平平，仄仄平平平仄。平仄平平平仄仄，仄仄仄、仄平平仄。仄仄仄平平，仄平平平仄。,0,44,54,98,"[7, 3, 3, 6, 6, 7, 3, 4, 5, 5, 7, 3, 3, 6, 6, 7, 3, 4, 5, 5]"
昼夜乐 ,无名氏,仄平平仄平平仄。仄平仄、平仄仄。平平仄仄平平，平仄平平仄仄。仄平平仄平平仄。仄平平、仄平平仄。仄仄仄平平，仄平仄平仄。仄平平仄平平仄。仄平平、平平仄。仄平仄仄平平，平仄平平仄仄。仄仄平仄平平仄。平平仄、仄平平仄。仄仄仄平平，仄平平仄仄。,0,50,48,98,"[7, 3, 3, 6, 6, 7, 3, 4, 5, 5, 7, 3, 3, 6, 6, 7, 3, 4, 5, 5]"
雨中花慢 ,苏轼,平仄平平平仄，仄仄平平，仄仄平平。仄仄仄平平仄，仄仄平平。平仄平平，平平仄仄，仄仄平平。仄仄仄仄仄，平平仄仄，仄仄平平。平平仄仄，平平平仄，仄仄仄仄平平。平仄仄、仄平平仄，仄仄平平。平仄平平仄仄，平平仄仄平平。仄平平仄，仄平平仄，仄仄平平。,0,48,50,98,"[6, 4, 4, 6, 4, 4, 4, 4, 5, 4, 4, 4, 4, 6, 3, 4, 4, 6, 6, 4, 4, 4]"
雨中花慢 ,张孝祥,仄仄平平，仄仄仄平，平平仄仄平平。仄仄平平仄仄，仄仄平平。平仄平平仄仄，仄平仄仄平平。仄平平仄仄，仄仄平平，平仄平平。平平仄仄，平仄平平，仄平仄仄平平。平仄仄、平平平仄，平仄平平。仄仄平平平仄，平平仄仄平平。仄平平仄，平平仄仄，平仄平平。,0,53,45,98,"[4, 4, 6, 6, 4, 6, 6, 5, 4, 4, 4, 4, 6, 3, 4, 4, 6, 6, 4, 4, 4]"
雨中花慢 ,刘褒,仄仄平平，仄仄仄平，仄平平仄平平。仄仄仄、平平仄仄，仄仄平平。平仄平平仄仄，仄平平仄平平。仄平平仄仄，仄仄平平，仄仄平平。平平平仄，仄仄平平，仄平仄仄平平。仄平平、仄平仄仄，仄仄平平。平仄仄平平仄，仄平平仄平平。仄平平仄，平平平仄，仄仄平平。,0,51,48,99,"[4, 4, 6, 3, 4, 4, 6, 6, 5, 4, 4, 4, 4, 6, 3, 4, 4, 6, 6, 4, 4, 4]"
雨中花慢 ,柳永,仄仄平平，平平仄仄，平仄仄仄平平。仄平平平仄，平仄平平。仄仄仄、平平仄仄，仄平仄、仄平平。仄平平仄仄，仄仄平平，平仄平平。平平仄仄仄仄，仄平平仄仄，平仄平平。仄平仄平平，平仄平平。仄平仄、平平仄仄，平平平、仄仄平平。仄平平仄仄，仄平平仄，仄仄平平。,0,52,48,100,"[4, 4, 6, 5, 4, 3, 4, 3, 3, 5, 4, 4, 6, 5, 4, 5, 4, 3, 4, 3, 4, 5, 4, 4]"
雨中花慢 ,吴礼之,仄平平仄，平平仄仄，平平仄仄平平。仄平平平仄，仄仄平平。平仄平平仄仄，仄平平仄平平。仄平平平仄，平平平仄，平仄平平。平平仄仄，仄平平仄，仄平仄仄平平。仄仄仄、平平仄仄，平仄平平。仄仄仄平平仄，平平仄仄平平。仄平平仄，平平平仄，平仄平平。,0,55,42,97,"[4, 4, 6, 5, 4, 6, 6, 5, 4, 4, 4, 4, 6, 3, 4, 4, 6, 6, 4, 4, 4]"
雨中花慢 ,京镗,仄仄平平，平平仄仄，仄平仄仄平平。仄仄平仄仄，平仄平平。仄仄平平仄仄，平平平仄平平。平平仄仄，仄平仄仄，仄仄平平。仄平平仄，平仄平平，平平仄仄平平。平仄仄、平平仄仄，仄仄平平。仄仄仄平仄仄，平平仄仄平平。平平仄仄，平平平仄，仄仄平平。,0,49,47,96,"[4, 4, 6, 5, 4, 6, 6, 4, 4, 4, 4, 4, 6, 3, 4, 4, 6, 6, 4, 4, 4]"
雨中花慢 ,高观国,仄仄平平，仄仄仄平，平平仄仄平平。仄仄平平，平平仄仄平平。平仄平平平仄，仄平仄仄平平。仄平平平仄，仄仄平平，仄仄平平。平平仄仄，仄仄平平，平仄仄仄平平。平仄仄、平平仄仄，仄仄平平。平仄平平平仄，仄平仄仄平平。仄平仄仄，平平平仄，仄仄平平。,0,52,46,98,"[4, 4, 6, 4, 6, 6, 6, 5, 4, 4, 4, 4, 6, 3, 4, 4, 6, 6, 4, 4, 4]"
雨中花慢 ,葛立方,仄仄平平，仄仄仄平，平平平仄平平。仄仄仄平，平仄仄平平。平仄平平仄仄，仄平平仄平平。仄平平平仄，仄仄平平，平仄平平。仄平仄仄，平仄平平，仄平平仄平平。平仄仄、平平平仄，仄仄平平。仄仄平平仄仄，平平平仄平平。仄平平仄，仄平平仄，仄仄平平。,0,54,43,97,"[4, 4, 6, 4, 5, 6, 6, 5, 4, 4, 4, 4, 6, 3, 4, 4, 6, 6, 4, 4, 4]"
雨中花慢 ,无名氏,仄仄平平，平仄仄仄平平，仄仄平平。仄仄平平仄，仄仄平平。平仄仄平平仄，平平仄仄平平。平平仄仄，平平平仄，仄仄平平。平平仄仄，仄平平仄，仄仄仄仄平平。平仄仄、平平平仄，平仄平平。仄仄仄平平仄，仄平平仄平平。仄平平仄，仄平平仄，仄仄平平。,0,50,46,96,"[4, 6, 4, 5, 4, 6, 6, 4, 4, 4, 4, 4, 6, 3, 4, 4, 6, 6, 4, 4, 4]"
雨中花慢 ,秦观,仄仄平平平仄，仄平平平，仄仄平仄。仄平平平仄，仄平平仄。仄仄平平平仄，平仄仄平平仄。仄仄平平仄，仄仄平平，仄平平仄。平平仄仄，平仄平平，仄仄仄平平仄。平仄仄、平平仄仄，仄平平仄。仄仄平平仄仄，仄平平仄平仄。仄平平仄仄，仄平平仄，仄仄平仄。,0,46,52,98,"[6, 4, 4, 5, 4, 6, 6, 5, 4, 4, 4, 4, 6, 3, 4, 4, 6, 6, 5, 4, 4]"
雨中花慢 ,无名氏,仄仄平平平仄，仄仄平平，仄平平仄。仄仄平平平仄，仄平平仄。平仄平平，平平仄仄，仄平平仄。仄仄平平仄，平平平仄，仄平平仄。平平平仄，仄仄仄平，仄仄仄平平仄。平仄仄、平平仄仄，仄平平仄。仄仄仄平平仄，平平平仄平仄。仄平仄仄，平平平仄，仄平平仄。,0,49,49,98,"[6, 4, 4, 6, 4, 4, 4, 4, 5, 4, 4, 4, 4, 6, 3, 4, 4, 6, 6, 4, 4, 4]"
雨中花慢 ,黄庭坚,仄仄平平，平仄仄仄，平平仄平平仄。仄平平平仄，仄仄平仄。平仄平平，平平仄仄，仄平平仄。仄仄平平仄，平平平仄，仄仄平仄。平平仄仄，仄平平仄，平仄仄平平仄。平平仄、平平平仄，仄平平仄。仄仄仄平仄仄，平平仄仄平仄。仄平仄仄，仄平平仄，仄平平仄。,0,47,50,97,"[4, 4, 6, 5, 4, 4, 4, 4, 5, 4, 4, 4, 4, 6, 3, 4, 4, 6, 6, 4, 4, 4]"
雨中花慢 ,无名氏,仄仄仄平平仄，仄仄平平，仄平平仄。仄仄平平平仄，仄仄平仄。仄仄平平，平平仄仄，仄平平仄。仄仄平平仄。平平平仄，仄平平仄。平平仄、仄平平仄，仄仄仄平平仄。平仄仄、平平平仄，仄平平仄。仄仄平平仄仄，平平仄仄平仄。仄平仄仄。平平平仄，仄平平仄。,0,46,51,97,"[6, 4, 4, 6, 4, 4, 4, 4, 5, 4, 4, 3, 4, 6, 3, 4, 4, 6, 6, 4, 4, 4]"
万年欢 ,王安礼,仄仄平平。仄平平仄仄，仄仄平平。仄仄平平，平仄仄仄平平。平仄平平仄仄，仄仄仄、仄仄平平。平平仄、平仄平平，仄平仄仄平平。平平仄仄仄仄，仄平平仄仄，平仄平平。平仄平平平仄，仄仄平平。仄仄平平仄仄，仄仄仄、平仄平平。平平仄、仄仄仄平，平仄平平。,0,48,50,98,"[4, 5, 4, 4, 6, 6, 3, 4, 3, 4, 6, 6, 5, 4, 6, 4, 6, 3, 4, 3, 4, 4]"
万年欢 ,无名氏,仄仄平平。仄仄平平仄，仄仄平平。仄仄平平，平平平仄平平。仄仄平平仄仄，仄平平、平仄平平。平平仄、平仄平平，仄平仄仄平平。平平平仄平平。仄仄仄平平，仄仄平平。仄仄平平，平平仄仄平平。仄仄平平仄仄，仄平平、仄仄平平。平平仄、仄仄平平，仄平平仄平平。,0,57,43,100,"[4, 5, 4, 4, 6, 6, 3, 4, 3, 4, 6, 6, 5, 4, 4, 6, 6, 3, 4, 3, 4, 6]"
万年欢 ,赵师侠,仄仄平平，平平平仄，仄平平仄平平。仄仄平平平仄，仄仄平平。仄仄平平仄仄，平平仄、平仄平平。平平仄，平仄平平，仄平仄仄平平。平平仄平仄仄，仄仄平平仄，仄仄平平。仄仄平平平仄，仄仄平平。仄仄平平仄仄，平仄仄、仄仄平平。平平仄，仄仄平平，仄平平仄平平。,0,54,47,101,"[4, 4, 6, 6, 4, 6, 3, 4, 3, 4, 6, 6, 5, 4, 6, 4, 6, 3, 4, 3, 4, 6]"
万年欢 ,贺铸,仄仄平平，仄平仄仄，仄平平仄平平。平仄平平，平仄平仄平平。仄仄平平仄仄，仄平平平仄平平。平平仄、仄仄平平，仄平仄仄平平。平平仄仄，仄平平仄，平平仄仄，仄仄平平。仄仄平平平仄，平仄平平。仄仄平平仄仄，仄平平、仄仄平平。平平仄、平仄平平，仄平平仄平平。,0,57,45,102,"[4, 4, 6, 4, 6, 6, 7, 3, 4, 6, 4, 4, 4, 4, 6, 4, 6, 3, 4, 3, 4, 6]"
万年欢 ,晁补之,仄仄平平，仄平平仄平，平仄平仄。仄仄平平，平仄仄平平仄。仄仄平平仄仄，仄平平、平平平仄。平平仄、平仄平平，仄平平仄平仄。平平仄平仄仄。仄平平仄平，平仄平仄。仄仄平平，平仄仄平仄仄。平仄平平仄仄，仄仄仄、平平平仄。仄仄仄、平仄平平，仄平平仄平仄。,0,51,49,100,"[4, 5, 4, 4, 6, 6, 3, 4, 3, 4, 6, 6, 5, 4, 4, 6, 6, 3, 4, 3, 4, 6]"
万年欢 ,晁补之,平仄平平，仄平平仄平，平仄平仄。仄仄平平，平仄仄平平仄。仄仄平平仄仄。仄仄仄、平平仄仄。平平仄、平仄平平，仄平平仄平仄。平平仄平仄仄。仄平平仄平，平仄平仄。平仄平平，平平仄平平仄。平仄平平仄仄。仄平仄、平平平仄。平平仄、平仄平平，仄平平仄平仄。,0,55,45,100,"[4, 5, 4, 4, 6, 6, 3, 4, 3, 4, 6, 6, 5, 4, 4, 6, 6, 3, 4, 3, 4, 6]"
万年欢 ,程大昌,仄仄平平，仄仄平仄仄，平仄平仄。仄仄平平，仄仄平平仄仄。仄仄平平仄仄，仄平仄、仄平平仄。仄仄平、仄仄平平，仄平平仄平仄。平平仄，平仄仄。仄平平仄仄，平平仄仄。平仄平平，平仄仄平平仄。仄仄仄平平仄，仄平平、仄平平仄。平平仄仄仄平平，仄平平仄平仄。,0,46,54,100,"[4, 5, 4, 4, 6, 6, 3, 4, 3, 4, 6, 3, 3, 5, 4, 4, 6, 6, 3, 4, 7, 6]"
万年欢 ,程大昌,仄仄平平，仄仄平仄仄，仄平仄仄。平仄平平，平仄仄平平仄。平仄平平平仄。仄平平、平平仄仄。仄平仄、仄仄平平，仄平平仄平仄。平平仄，仄仄仄。仄仄平仄仄，仄仄平仄。仄仄平平，仄仄平平仄仄。平仄平平仄仄。仄仄仄仄、平平仄仄。仄平仄、仄仄平平，仄平仄仄平仄。,0,42,59,101,"[4, 5, 4, 4, 6, 6, 3, 4, 3, 4, 6, 3, 3, 5, 4, 4, 6, 6, 4, 4, 3, 4, 6]"
万年欢 ,史达祖,仄仄平平，仄平平、仄平平仄平仄。仄仄平平平仄，仄平平仄。仄仄平平仄仄，仄仄仄、平平平仄。平平仄、仄仄平平，仄平平仄平仄。平平仄平仄仄。仄平平仄仄，平仄平仄。仄仄平平，平仄仄平平仄。平仄平平仄仄，仄仄仄、平平平仄。平平仄、仄仄平平，仄平平仄平仄。,0,49,51,100,"[4, 3, 6, 6, 4, 6, 3, 4, 3, 4, 6, 6, 5, 4, 4, 6, 6, 3, 4, 3, 4, 6]"
万年欢 ,晁补之,仄仄平平，仄平平仄平，平仄平仄。仄仄平平，平仄仄平平仄。仄仄平平仄仄，仄平平、平平平仄。平仄仄、平仄平平，仄平平仄平仄。平平仄仄平仄，仄平平仄平，平仄平仄。仄仄平平平仄，仄平平仄。仄仄平平平仄。仄平平、平平平仄。平仄仄、平仄平平，仄平平仄平仄。,0,54,46,100,"[4, 5, 4, 4, 6, 6, 3, 4, 3, 4, 6, 6, 5, 4, 6, 4, 6, 3, 4, 3, 4, 6]"
万年欢 ,赵孟頫,平仄平平。仄平平仄仄，仄仄平平。仄仄平平仄仄，仄仄平平。仄仄平平仄仄，仄仄仄、平平平仄。平平仄、平仄平平，仄平平仄平平。平平仄仄仄平。仄平平仄仄，仄仄平平。仄仄平平，平仄仄平平仄。仄仄平平仄仄，仄平仄、平平平仄。平平仄、仄仄平平，仄仄仄平平仄。,0,49,51,100,"[4, 5, 4, 6, 4, 6, 3, 4, 3, 4, 6, 6, 5, 4, 4, 6, 6, 3, 4, 3, 4, 6]"
燕春台 ,张先,仄仄平平，仄平平仄，平平仄仄平平。仄仄平平，平平仄仄平平。仄平平仄平平。仄平平、仄仄平平。平平平仄，平平平仄，仄仄平平。平平平仄，仄仄平平，仄平仄仄，平仄平平。平平仄仄，平平仄仄平平。仄仄平平，仄平平、平仄平平。仄平平。平仄平仄仄，平仄平平。,0,59,39,98,"[4, 4, 6, 4, 6, 6, 3, 4, 4, 4, 4, 4, 4, 4, 4, 4, 6, 4, 3, 4, 3, 5, 4]"
燕春台 ,王之道,仄仄平平，平平仄仄，仄平平仄平平。平仄平平，平平平仄平平。平平仄仄平平。仄平平、平仄平平。平平平仄，仄平平仄，平仄平平。平平仄仄，仄仄平平，仄平平仄，平仄平平。平平仄仄，平平仄仄平平。仄仄平平，仄平平、平仄平平。仄平平。平平平仄，仄平仄平平。,0,63,35,98,"[4, 4, 6, 4, 6, 6, 3, 4, 4, 4, 4, 4, 4, 4, 4, 4, 6, 4, 3, 4, 3, 4, 5]"
燕春台 ,黄裳,仄仄平平，仄平平仄，平平仄仄平平。仄仄平平，仄平仄仄平平。仄平平仄平平。仄平平、仄仄平平。平平平仄，平平仄仄，平仄平平。平平平仄，仄仄平平，仄平仄仄，平仄平平。平平仄仄，平平仄仄平平。仄仄平平。仄平平、仄仄平平。仄平平。仄仄平平，平仄平平。,0,57,40,97,"[4, 4, 6, 4, 6, 6, 3, 4, 4, 4, 4, 4, 4, 4, 4, 4, 6, 4, 3, 4, 3, 4, 4]"
燕春台 ,曹冠,仄仄平平，仄平平仄，平平平仄平平。仄仄平平，仄平平仄平平。仄平平仄平平。仄平平、仄仄平平。平平平仄，平平仄平，平仄平平。平平平仄，仄仄平平，仄平平仄，平仄平平。平平仄仄，仄平仄仄平平。仄仄平平。仄平平、仄仄平平。仄平平，平仄仄平，仄仄平平。,0,59,38,97,"[4, 4, 6, 4, 6, 6, 3, 4, 4, 4, 4, 4, 4, 4, 4, 4, 6, 4, 3, 4, 3, 4, 4]"
逍遥乐 ,黄庭坚,平仄仄平平仄。仄仄平平，平仄仄平平仄。仄仄平平，仄仄平平，仄仄平平平仄。仄平平仄。仄平平、仄仄平平，仄平平仄。仄仄仄平平，仄仄平仄。平仄平平平仄。仄平平平仄仄。平平仄平仄，平仄仄、仄平仄。平平仄仄仄，平仄仄平平仄。平平仄平平仄，平平平仄。,0,50,48,98,"[6, 4, 6, 4, 4, 6, 4, 3, 4, 4, 5, 4, 6, 6, 5, 3, 3, 5, 6, 6, 4]"
八节长欢 ,毛滂,平仄平平。仄平平仄，仄仄平平。平平平仄仄，平仄仄平平。平平平仄仄平仄，仄仄平、平仄平平。仄仄平平仄仄，平仄平平。平平仄仄平平。平仄仄、平平仄仄平平。平仄仄平平，平仄仄、平平仄仄平平。平平仄，平仄仄、仄仄平平。平平仄、平平平仄，平平仄仄平平。,0,57,41,98,"[4, 4, 4, 5, 5, 7, 3, 4, 6, 4, 6, 3, 6, 5, 3, 6, 3, 3, 4, 3, 4, 6]"
八节长欢 ,毛滂,仄仄平平。仄平平仄，仄仄平平。平平仄平仄，平仄仄平平。平平平仄仄平平，仄平平、仄仄平平。仄平仄、仄平仄仄，仄仄平平。平平仄仄平平。平仄仄、平平仄仄平平。平仄仄平平，平平仄、仄平仄仄平平。平仄仄，仄仄平、仄仄平平。平平仄、平平平仄，平仄仄仄平平。,0,54,45,99,"[4, 4, 4, 5, 5, 7, 3, 4, 3, 4, 4, 6, 3, 6, 5, 3, 6, 3, 3, 4, 3, 4, 6]"
忆东坡 ,王之道,仄仄仄平平，仄仄平平仄。平仄仄平平平仄，平仄平平仄。仄仄仄平平仄，平平仄仄平平，仄仄平平仄。平平仄仄，平仄平平仄平仄。平平平仄，仄仄平平仄。仄平平仄平仄，平仄平平仄。平仄仄平仄仄，平平平仄平平，仄仄平平仄。平平平仄仄平，平仄平平仄。,0,52,46,98,"[5, 5, 7, 5, 6, 6, 5, 4, 7, 4, 5, 6, 5, 6, 6, 5, 6, 5]"
粉蝶儿慢 ,周邦彦,仄仄平平，平平仄仄，仄仄平平平仄。仄平平仄仄，仄平平平仄。仄仄平平平仄平，仄仄平平平仄。仄平平，仄仄平、仄仄平平平仄。仄仄。平平仄仄。平平平、仄仄平平平仄。仄平平仄仄，仄平平平仄。仄仄平平平仄仄，仄仄仄平平仄。仄平平、仄仄平平，仄平平仄。,0,49,49,98,"[4, 4, 6, 5, 5, 7, 6, 3, 3, 6, 2, 4, 3, 6, 5, 5, 7, 6, 3, 4, 4]"
并蒂芙蓉 ,晁端礼,仄仄平平，仄仄平仄仄，平平平仄。平仄仄平平，仄平仄平仄。平平仄平仄仄，仄仄平平仄平仄。仄平仄仄。仄平平、仄仄平平平仄。平平仄平仄仄，仄平平仄仄，平平平仄。仄仄仄平平，仄平仄平仄。平平仄平仄仄，仄仄平平平平仄。仄平仄仄。仄平平、仄平平仄。,0,47,51,98,"[4, 5, 4, 5, 5, 6, 7, 4, 3, 6, 6, 5, 4, 5, 5, 6, 7, 4, 3, 4]"
黄河清慢 ,晁端礼,平仄平平平仄仄。平平平仄平仄。仄仄仄平平仄，平平平仄。平仄平平仄仄，仄平仄、平平仄仄。仄平平仄平平，仄仄平、仄仄平仄。平平仄仄平平，平平仄、仄平平仄平仄。仄仄仄平，仄仄平平仄仄。仄仄平平仄仄，仄平仄、平平仄仄。仄平平仄，平平仄、仄平平仄。,0,48,50,98,"[7, 6, 6, 4, 6, 3, 4, 6, 3, 4, 6, 3, 6, 4, 6, 6, 3, 4, 4, 3, 4]"
春草碧 ,万俟咏,仄平平仄平，仄仄平仄平，平仄平仄。平平仄，平仄仄平仄，仄平平仄。平平仄仄，仄仄仄、平平仄仄。平仄仄仄，平平仄，仄仄仄平仄。平仄。仄平平仄平，仄仄平仄仄，仄仄平仄。平平仄，仄仄仄平仄，仄平平仄。平平仄平，仄平仄、平平仄仄。仄仄仄平，平平仄，仄平仄。,0,42,56,98,"[5, 5, 4, 3, 5, 4, 4, 3, 4, 4, 3, 5, 2, 5, 5, 4, 3, 5, 4, 4, 3, 4, 4, 3, 3]"
芰荷香 ,万俟咏,仄平平。仄平仄仄仄，平仄平平。仄平平仄，仄仄仄仄平平。平平仄仄，仄仄仄、仄仄平平。平仄仄平平平。平平仄仄，平仄平平。仄仄平平仄平仄，仄平平仄仄，平仄平平。仄平仄仄，平仄平仄平平。平平仄仄，仄仄仄、仄仄平平。仄仄仄仄平平。平平仄仄，仄仄平平。,0,46,52,98,"[3, 5, 4, 4, 6, 4, 3, 4, 6, 4, 4, 7, 5, 4, 4, 6, 4, 3, 4, 6, 4, 4]"
芰荷香 ,赵彦端,仄平平。仄平平仄仄，仄仄平平。仄平平仄，仄平仄仄平平。平平仄仄，仄仄平、平仄平平。仄仄仄仄平平。平平仄仄，平仄平平。仄仄平平仄仄，仄仄平平仄，平仄平平。仄平平仄，仄平平仄平平。仄平平仄，仄仄平、平仄平平。平仄仄仄平平。平平仄仄，仄仄平平。,0,50,47,97,"[3, 5, 4, 4, 6, 4, 3, 4, 6, 4, 4, 6, 5, 4, 4, 6, 4, 3, 4, 6, 4, 4]"
绣停针 ,陆游,仄仄仄，仄仄仄平平，仄仄平仄。平仄平平，平仄仄平，仄仄仄平平仄。仄平平仄。仄仄仄、平平平仄。仄平仄仄平平，仄平仄平平仄。平平仄仄仄。仄仄仄仄仄，仄平平仄。仄仄平平，平仄仄平，平仄仄平平仄。仄平平仄。仄仄仄、平平平仄。仄平平仄，仄平仄平仄仄。,0,41,57,98,"[3, 5, 4, 4, 4, 6, 4, 3, 4, 6, 6, 5, 5, 4, 4, 4, 6, 4, 3, 4, 4, 6]"
扬州慢 ,姜夔,平仄平平，仄平平仄，仄平仄仄平平。仄平平仄仄，仄仄仄平平。仄平仄、平平仄仄，仄平平仄，平仄平平。仄平平、平仄平平，平仄平平。仄平仄仄，仄平平、平仄平平。仄仄仄平平，平平仄仄，平仄平平。仄仄仄平平仄，平平仄、仄仄平平。仄平平平仄，平平平仄平平。,0,55,43,98,"[4, 4, 6, 5, 5, 3, 4, 4, 4, 3, 4, 4, 4, 3, 4, 5, 4, 4, 6, 3, 4, 5, 6]"
扬州慢 ,吴元可,仄仄平平，平平平仄，平平仄仄平平。仄平平、仄仄仄，平仄平平。仄平仄、平平仄仄，仄平平仄，平仄平平。仄平平、仄仄平平，平仄平平。平平仄仄，仄平平、仄仄平平。仄平仄平平，平平仄仄，仄仄平平。仄仄平平平仄，平平仄、平仄平平。仄仄平平仄，仄平仄仄平平。,0,55,43,98,"[4, 4, 6, 3, 3, 4, 3, 4, 4, 4, 3, 4, 4, 4, 3, 4, 5, 4, 4, 6, 3, 4, 5, 6]"
扬州慢 ,郑觉斋,仄仄平平，平平仄仄，仄平仄仄平平。仄平平平仄，仄平仄平平。仄仄仄、平平平仄，平平仄仄，平仄平平。仄平平仄仄，仄平平仄平平。平平平仄，仄平平、平仄平平。仄仄仄平平，平平平仄，平仄平平。仄仄平平平仄，平平仄、仄仄平平。仄平平平仄，平平平仄平平。,0,58,40,98,"[4, 4, 6, 5, 5, 3, 4, 4, 4, 5, 6, 4, 3, 4, 5, 4, 4, 6, 3, 4, 5, 6]"
舞杨花 ,康与之,仄平仄仄平平仄，平仄仄仄平平。仄仄平平，平仄仄平平。仄平平仄仄平仄，仄平平、仄仄平平。平仄仄仄平平。仄仄平仄平平。平仄平平仄仄，仄平平平仄，平仄平平。平仄仄平，平仄仄平平。平平仄仄仄平仄，仄平平、平仄平平。平仄仄仄平平。仄仄平仄平平。,0,52,46,98,"[7, 6, 4, 5, 7, 3, 4, 6, 6, 6, 5, 4, 4, 5, 7, 3, 4, 6, 6]"
双双燕 ,史达祖,仄平仄仄，仄平仄平平，仄平平仄。平平仄仄，仄仄仄平平仄。平仄平平仄仄。仄仄仄、平平仄仄。平平仄仄平平，仄仄平平平仄。平仄。平平仄仄。仄仄仄平平，仄平平仄。平平平仄，仄仄仄平平仄。平仄平平仄仄。仄平仄、平平平仄。平仄仄仄平平，仄仄仄平仄仄。,0,45,53,98,"[4, 5, 4, 4, 6, 6, 3, 4, 6, 6, 2, 4, 5, 4, 4, 6, 6, 3, 4, 6, 6]"
双双燕 ,吴文英,仄平仄仄，平平仄，平平仄平平仄。平平仄仄，平仄仄平平仄。平仄平平仄仄，仄平仄、平平平仄。平平仄仄平平，仄仄平平平仄。平仄。平平仄仄。平仄仄，平平仄平平仄。仄平平仄，仄仄仄平平仄。平仄平平仄仄。仄仄仄、平平平仄。平平仄仄仄平，平仄仄平平仄。,0,50,48,98,"[4, 3, 6, 4, 6, 6, 3, 4, 6, 6, 2, 4, 3, 6, 4, 6, 6, 3, 4, 6, 6]"
孤鸾 ,朱敦儒,平平平仄。仄仄仄平平，平平平仄。仄仄平平，仄仄仄平平仄。平平仄平仄仄，仄平平、仄平平仄。仄仄平平仄仄，仄仄平平仄。仄仄平、平仄仄平仄。仄仄仄平平，平仄平仄。仄仄平平仄，仄仄平平仄。仄平仄平仄仄，仄平平、仄平平仄。平平平平仄仄，仄平平平仄。,0,47,51,98,"[4, 5, 4, 4, 6, 6, 3, 4, 6, 5, 3, 5, 5, 4, 5, 5, 6, 3, 4, 6, 5]"
孤鸾 ,马庄父,平平平仄。仄仄仄平平，仄平平仄。仄仄平平，仄仄仄平平仄。平平仄平仄仄，仄平平、仄平平仄。仄仄仄平平仄，仄仄平平仄。仄仄平、平仄仄平仄。仄仄仄平平，平仄平仄。仄仄仄平，仄仄仄平平仄。仄平仄平仄仄，仄平平、仄平平仄。平仄平平仄仄，仄仄平平仄。,0,43,55,98,"[4, 5, 4, 4, 6, 6, 3, 4, 6, 5, 3, 5, 5, 4, 4, 6, 6, 3, 4, 6, 5]"
孤鸾 ,赵以夫,平平平仄。仄平仄平平，仄平平仄。仄仄平平仄，仄仄平平仄。平平仄平仄仄，仄平平、仄平平仄。平仄平平仄仄，仄仄平平仄。仄平平、平仄平平仄。仄仄仄平平，仄平平仄。仄仄平平仄，仄平平仄仄。平平仄平仄仄，仄平平、仄平平仄。仄仄平平仄仄，仄平平平仄。,0,49,49,98,"[4, 5, 4, 5, 5, 6, 3, 4, 6, 5, 3, 5, 5, 4, 5, 5, 6, 3, 4, 6, 5]"
孤鸾 ,张榘,平平平仄。仄仄仄平平，仄平平仄。仄仄平平，仄仄仄平平仄。平平仄平仄仄，仄平平、仄平平仄。仄仄平平平仄，仄仄平平仄。仄仄平平，仄平仄仄。仄仄仄平平，平平仄仄。仄仄平平仄，仄仄平平仄。平平仄平仄仄，仄平平、仄平平仄。平仄仄平平仄，仄平平平仄。,0,47,51,98,"[4, 5, 4, 4, 6, 6, 3, 4, 6, 5, 4, 4, 5, 4, 5, 5, 6, 3, 4, 6, 5]"
云仙引 ,冯伟寿,仄仄平平，平平仄仄，平平仄仄平平。平平仄，仄平平。平平仄平仄仄，仄仄平平平仄平。平仄仄平，仄平仄仄，平仄平平。平平平仄平平。仄平仄、平平平仄平。仄仄平平，仄平平仄，仄仄平平。平仄平平，仄平仄仄，仄仄平平平仄平。仄平平仄，仄平平仄，仄仄平平。,0,55,43,98,"[4, 4, 6, 3, 3, 6, 7, 4, 4, 4, 6, 3, 5, 4, 4, 4, 4, 4, 7, 4, 4, 4]"
玲珑玉 ,姚云文,平仄平平，仄平仄、仄仄平平。平平仄仄，仄平平仄平平。仄仄平平仄仄，仄平平平仄，平仄平平。平平。平平平、平仄仄平。仄仄平平仄仄，仄平平平仄，平仄平平。仄仄平平，仄平平、仄仄平平。平平平平平仄，仄平仄、平平仄仄，仄仄平平。仄平仄，仄平平、平仄仄平。,0,56,42,98,"[4, 3, 4, 4, 6, 6, 5, 4, 2, 3, 4, 6, 5, 4, 4, 3, 4, 6, 3, 4, 4, 3, 3, 4]"
陌上花 ,张翥,平平仄仄平平，平仄仄平平仄。仄仄平平，平仄仄平平仄。仄平仄仄平平仄，仄仄仄平平仄。仄平平、仄仄仄平平仄，仄平平仄。仄平平、仄仄平平仄，仄仄平平平仄。仄仄平平，仄仄仄平平仄。仄平仄仄平平仄，平仄平平平仄。仄平平、仄仄平平平仄，仄平平仄。,0,48,50,98,"[6, 6, 4, 6, 7, 6, 3, 6, 4, 3, 5, 6, 4, 6, 7, 6, 3, 6, 4]"
福寿千春 ,卢挚,仄仄平平，平平仄仄。仄仄平平平仄。仄仄仄平平仄仄，仄仄平平仄仄。仄仄仄平平仄，仄仄平平仄。仄平平，仄平平，仄平仄平仄仄。仄平仄仄平仄。仄平平仄平，仄仄平仄。仄仄平平，平平仄平平，平平仄仄。平仄仄平仄，仄平平平仄。仄平平，仄平仄，仄平平仄。,0,45,53,98,"[4, 4, 6, 7, 6, 6, 5, 3, 3, 6, 6, 5, 4, 4, 5, 4, 5, 5, 3, 3, 4]"
夏日燕黉堂 ,无名氏,仄平平。仄平平仄仄，平仄平平。平仄仄仄，仄仄仄平平。平平仄仄平平仄，仄平平、仄仄平平。仄仄平平仄，平平平仄，仄仄平平。仄仄仄平平。仄平平仄仄，平仄平平。平平仄仄，仄平仄平平。仄平平仄平平仄，仄平平、平仄平平。仄仄平平仄，平平平仄，仄仄平平。,0,53,45,98,"[3, 5, 4, 4, 5, 7, 3, 4, 5, 4, 4, 5, 5, 4, 4, 5, 7, 3, 4, 5, 4, 4]"
夏日燕黉堂 ,赵必□,仄平平。仄仄平仄仄，仄仄平平。平仄仄仄仄，仄仄仄平平。平平平仄平平仄，仄平平、仄仄平平。仄平平仄仄，平平仄仄，平仄平平。平仄仄平平。平平平仄仄，平仄平平。仄平仄仄，平仄仄平平。平平仄仄平平仄，仄仄平、平仄平平。仄仄平仄仄，仄平平仄，仄仄平平。,0,50,49,99,"[3, 5, 4, 5, 5, 7, 3, 4, 5, 4, 4, 5, 5, 4, 4, 5, 7, 3, 4, 5, 4, 4]"
水晶帘 ,无名氏,平仄平平仄。仄平仄、平平平仄。仄仄平平，仄仄仄平平，仄平平仄。仄仄平平平仄仄，仄仄仄、平平仄仄。仄平平，仄仄平平，仄平仄仄。平平仄平仄。仄平平仄仄，平平平仄。仄仄平平仄，仄平仄仄。平仄平平平仄仄，仄平仄、平平仄仄。仄平平，平仄平平，仄平仄仄。,0,47,51,98,"[5, 3, 4, 4, 5, 4, 7, 3, 4, 3, 4, 4, 5, 5, 4, 5, 4, 7, 3, 4, 3, 4, 4]"
三部乐 ,苏轼,仄平平仄。仄仄仄仄平，仄平平仄。仄平平仄，平仄平平平仄。平平仄、平仄平平，仄仄平仄仄，仄仄平仄。仄仄仄平，仄仄仄平平仄。平平仄仄仄仄，仄仄平仄仄，仄平平仄。平仄仄平仄仄，平平平仄。仄平平、仄平仄仄。仄平仄、仄平仄仄。平仄仄仄。仄仄仄、仄平平仄。,0,39,60,99,"[4, 5, 4, 4, 6, 3, 4, 5, 4, 4, 6, 6, 5, 4, 6, 4, 3, 4, 3, 4, 4, 3, 4]"
三部乐 ,周邦彦,平仄平平，仄仄仄仄平，仄平平仄。仄平平仄，平仄平平平仄。仄平仄、平仄平平，仄仄平仄仄，仄平平仄。仄平仄仄，仄仄平平平仄。平平仄平仄仄，仄仄平仄仄，仄平平仄。仄平仄平仄仄，平平平仄。仄平平、仄平仄仄。平仄仄、平平仄仄。仄仄仄仄，平仄仄、平仄平仄。,0,43,56,99,"[4, 5, 4, 4, 6, 3, 4, 5, 4, 4, 6, 6, 5, 4, 6, 4, 3, 4, 3, 4, 4, 3, 4]"
三部乐 ,方千里,平仄平平，仄仄仄仄平，仄平平仄。仄平平仄，平仄平平仄。仄平仄、平仄平平，仄仄平仄仄，仄仄平仄。仄平仄仄，仄仄平平平仄。平平平仄仄仄，仄仄平仄仄，仄仄平平仄。平平仄平仄仄，平平平仄。仄平平、仄平仄仄。平仄仄、平平仄仄。仄仄仄仄，平平仄、平仄平仄。,0,43,56,99,"[4, 5, 4, 4, 5, 3, 4, 5, 4, 4, 6, 6, 5, 5, 6, 4, 3, 4, 3, 4, 4, 3, 4]"
三部乐 ,吴文英,平仄平平，仄仄仄仄平，仄平平仄。仄平平仄，仄仄平平平仄。仄平仄、平仄平平，仄仄平仄仄，仄平平仄。仄平仄仄，仄仄仄平平仄。仄平仄仄平平，仄平仄仄，仄仄平平仄。平平仄平仄仄，平平平仄。仄平平、仄平仄仄。平仄仄、平平仄仄。平仄仄仄，平平仄、平仄平仄。,0,44,55,99,"[4, 5, 4, 4, 6, 3, 4, 5, 4, 4, 6, 6, 4, 5, 6, 4, 3, 4, 3, 4, 4, 3, 4]"
梦扬州 ,秦观,仄平平。仄仄平平仄，平仄平平。仄仄仄平，仄仄平平平平。仄平平仄平平仄，仄仄平、平仄平平。平平仄，平平平仄，仄平平仄平平。平仄平平仄平。平仄仄平平，仄仄平平。仄仄仄平，仄仄平平平平。仄平仄仄平平仄，仄仄平、平仄平平。平仄仄，平平仄仄，平仄平平。,0,56,43,99,"[3, 5, 4, 4, 6, 7, 3, 4, 3, 4, 6, 6, 5, 4, 4, 6, 7, 3, 4, 3, 4, 4]"
声声慢 ,晁补之,平平平仄，仄仄平平，平平仄仄平平。仄平平仄平仄，仄仄平平。平平仄平仄仄，仄平平、平仄平平。仄仄仄、仄平平平仄，平仄平平。平仄平平仄仄，仄仄仄、平平仄仄平平。仄仄平平平仄，仄仄平平。平平仄平仄仄，仄平平、平仄平平。仄平仄、仄平平平仄，仄仄平平。,0,54,45,99,"[4, 4, 6, 6, 4, 6, 3, 4, 3, 5, 4, 6, 3, 6, 6, 4, 6, 3, 4, 3, 5, 4]"
声声慢 ,贺铸,平平仄仄，仄仄平平，平平平仄平平。仄仄平平平仄，仄仄平平。平平平平仄仄，仄平平、仄仄平平。平平仄仄，仄平平仄，仄仄平平。平平平平平仄，平平仄、平平仄仄平平。仄仄仄平平仄，仄仄平平。平平仄平仄仄，仄平平仄仄平平。平平平仄，仄平平，仄仄平。,0,56,41,97,"[4, 4, 6, 6, 4, 6, 3, 4, 4, 4, 4, 6, 3, 6, 6, 4, 6, 7, 4, 3, 3]"
声声慢 ,曹勛,仄平平仄，平平仄仄，仄仄平仄平平。平平仄仄，平仄平仄平平。仄仄仄平平仄，平平平仄仄平平。平平仄，仄平仄仄，仄仄平平。平仄仄平仄仄，仄平仄平平，仄仄平平。平平仄仄，仄仄仄仄平平。仄仄仄平仄仄，仄平平仄仄平平。平平仄，仄平仄仄，仄仄平平。,0,46,51,97,"[4, 4, 6, 4, 6, 6, 7, 3, 4, 4, 6, 5, 4, 4, 6, 6, 7, 3, 4, 4]"
声声慢 ,吴文英,平平平仄，仄仄平平，平平仄仄平平。仄仄平平，仄平仄仄平平。平平仄平仄仄，仄平平、平仄平平。平仄仄，仄平平平仄，仄仄平平。平仄平平平仄，仄平平、平仄平仄平平。仄仄平平，平平平仄平平。平平仄平仄仄，仄平平、平仄平平。平仄仄，仄平平、平仄仄平。,0,58,39,97,"[4, 4, 6, 4, 6, 6, 3, 4, 3, 5, 4, 6, 3, 6, 4, 6, 6, 3, 4, 3, 3, 4]"
声声慢 ,王沂孙,平平平仄，仄仄平平，平平仄仄平平。仄仄平平，平平仄仄平平。仄平仄仄仄仄，仄仄平、平仄平平。仄平仄，仄仄平仄仄，仄仄平平。仄仄平平平仄，仄平平平仄，仄仄平平。仄仄平平，平平平仄平平。平平仄平仄仄，仄平平、平仄平平。仄平仄，仄平平、平仄平平。,0,53,44,97,"[4, 4, 6, 4, 6, 6, 3, 4, 3, 5, 4, 6, 5, 4, 4, 6, 6, 3, 4, 3, 3, 4]"
声声慢 ,周密,平仄平平，仄平平仄，平平仄仄平平。仄仄平平，平平仄仄平平。平平仄平仄仄，仄平平、仄仄平平。平仄仄，仄平平仄仄，仄仄平平。平仄仄平平仄仄，仄平平平仄，仄仄平平。仄仄平平，平平仄仄平平。平平仄平仄仄，仄平平、仄仄平平。平仄仄，仄平平、平仄仄平。,0,53,45,98,"[4, 4, 6, 4, 6, 6, 3, 4, 3, 5, 4, 7, 5, 4, 4, 6, 6, 3, 4, 3, 3, 4]"
声声慢 ,石孝友,平平仄仄，仄仄平平，平仄仄仄平平。仄仄平平，平仄仄仄平平。平平平仄仄仄，仄平平、仄仄平平。仄仄仄、平平仄仄，仄仄平平。平仄仄平平仄，平仄仄、平平仄仄平平。仄仄平平，仄仄仄仄平平。平平仄平平仄，仄平平、仄仄平平。仄平仄，仄平平、仄仄仄平。,0,47,49,96,"[4, 4, 6, 4, 6, 6, 3, 4, 3, 4, 4, 6, 3, 6, 4, 6, 6, 3, 4, 3, 3, 4]"
声声慢 ,元好问,平平平仄，平仄平平，平平仄仄平平。仄仄平平，仄仄仄仄平平。平平仄平仄仄，仄平平、仄仄平平。仄平仄、平平仄仄，平仄平平。仄仄平平仄仄，仄平平仄仄，仄仄平平。仄仄平平，仄仄平仄平平。平平平平仄仄，仄平平、仄仄平平。仄平仄，仄平平、平仄仄平。,0,51,45,96,"[4, 4, 6, 4, 6, 6, 3, 4, 3, 4, 4, 6, 5, 4, 4, 6, 6, 3, 4, 3, 3, 4]"
声声慢 ,高观国,平平平仄，仄仄平平，平平仄平平仄。仄仄仄平，平仄仄平平仄。平平仄平仄仄，仄平平、平平平仄。仄仄仄，平平平仄仄，仄平平仄。仄仄平平仄仄，仄仄仄、平平仄平平仄。仄仄平平，平仄仄平平仄。平平仄平仄仄，仄平平、平平平仄。仄仄仄，仄平平、平仄仄仄。,0,48,49,97,"[4, 4, 6, 4, 6, 6, 3, 4, 3, 5, 4, 6, 3, 6, 4, 6, 6, 3, 4, 3, 3, 4]"
声声慢 ,赵长卿,平平仄仄，仄仄平平，平平仄仄平仄。平仄平平，平仄仄平平仄。仄平仄平平仄，仄平平、平平平仄。仄仄仄，仄仄平平仄，仄仄平仄。仄仄仄平仄仄，仄平仄平平，仄平平仄。平仄平平，仄仄仄平平仄。平平仄平仄仄，仄平仄、仄平仄仄。平平仄，仄平平平仄，仄平平仄。,0,47,52,99,"[4, 4, 6, 4, 6, 6, 3, 4, 3, 5, 4, 6, 5, 4, 4, 6, 6, 3, 4, 3, 5, 4]"
声声慢 ,陈合,平平平仄，仄仄平平，平平仄平仄仄。平仄平平，平仄仄平平仄。平平仄平仄仄，仄平平、仄平平仄。平仄仄，仄仄平平仄，仄平平仄。平仄仄平平仄。平平仄、平仄仄平平仄。仄仄平平，仄仄仄平平仄。平平仄平仄仄，仄平平、仄平平仄。平仄仄，仄平平、仄平平仄。,0,50,47,97,"[4, 4, 6, 4, 6, 6, 3, 4, 3, 5, 4, 6, 3, 6, 4, 6, 6, 3, 4, 3, 3, 4]"
声声慢 ,张翥,平平仄仄。仄仄平平，平平仄仄平仄。仄仄平平，平仄仄平平仄。平平仄仄仄仄，仄平平、仄平平仄。平仄仄，仄平平仄仄，仄平平仄。仄仄平平平仄。平平仄、平平仄平平仄。仄仄平平，平仄仄平平仄。平平仄平仄仄，仄平平、仄仄仄仄。仄仄仄，仄仄平、平仄仄仄。,0,44,53,97,"[4, 4, 6, 4, 6, 6, 3, 4, 3, 5, 4, 6, 3, 6, 4, 6, 6, 3, 4, 3, 3, 4]"
声声慢 ,李清照,平平仄仄。仄仄平平，平平仄仄仄仄。仄仄平平，平仄仄平平仄。平平仄仄仄仄，仄仄平、仄平平仄。仄仄仄，仄平平、仄仄仄平平仄。仄仄平平平仄。平仄仄、平平仄平平仄。仄仄平平，仄仄仄平仄仄。平平仄平仄仄，仄平平、仄仄仄仄。仄仄仄，仄仄仄、平仄仄仄。,0,37,60,97,"[4, 4, 6, 4, 6, 6, 3, 4, 3, 3, 6, 6, 3, 6, 4, 6, 6, 3, 4, 3, 3, 4]"
声声慢 ,何梦桂,平平仄仄。仄仄平仄平平，平仄平仄。仄仄平平，平仄仄平平仄。平平仄平仄仄，仄平平、仄平平仄。仄仄仄，仄平平、仄仄平平平仄。平仄仄平平仄。平仄仄、仄平平仄。仄仄平平，仄仄平平平仄。仄仄仄平平仄，仄平平、仄仄平仄。平仄仄，仄平平、平仄仄仄。,0,44,51,95,"[4, 6, 4, 4, 6, 6, 3, 4, 3, 3, 6, 6, 3, 4, 4, 6, 6, 3, 4, 3, 3, 4]"
紫玉箫 ,晁补之,平仄平平，平平平仄，仄平平仄平平。平平仄仄，仄仄平平仄，平仄平平。仄仄平仄，平仄仄、仄仄平平。平平仄，平平仄平，仄仄平平。平平仄仄平仄，平仄仄平平，仄仄平平。平平仄仄，仄平平、平仄仄仄平平。仄平平仄，平仄仄、仄仄平平。平平仄，平仄仄平，仄仄平平。,0,54,45,99,"[4, 4, 6, 4, 5, 4, 4, 3, 4, 3, 4, 4, 6, 5, 4, 4, 3, 6, 4, 3, 4, 3, 4, 4]"
无闷 ,程垓,平仄平平，仄仄仄仄，仄仄平平平仄。仄仄仄平平，仄平平仄。仄仄平平平仄。仄仄仄、仄平平平仄。仄仄仄、平仄平平仄仄，仄平平仄。平仄。仄仄平，仄仄仄。仄仄平平平仄。仄平仄仄，仄仄仄仄。平仄仄平平仄。仄仄仄、平平平平仄。仄仄仄、平仄平平，仄平仄仄仄仄。,0,38,61,99,"[4, 4, 6, 5, 4, 6, 3, 5, 3, 6, 4, 2, 3, 3, 6, 4, 4, 6, 3, 5, 3, 4, 6]"
月下笛 ,周邦彦,仄仄平平，平平仄仄，仄平平仄。平平仄仄。仄仄平平平仄。仄平平、平仄仄平，仄平仄仄平仄仄。仄平平仄仄，平平平仄，仄平平仄。平平平仄仄，仄仄仄平平，仄平平仄。平平仄仄，仄仄平平平仄。仄平平、仄平仄平，仄平仄仄平仄仄。仄平平，仄仄平平，仄仄平仄仄。,0,47,52,99,"[4, 4, 4, 4, 6, 3, 4, 7, 5, 4, 4, 5, 5, 4, 4, 6, 3, 4, 7, 3, 4, 5]"
月下笛 ,张炎,平仄平平，平平仄仄，仄平平仄。平平仄仄。仄平平仄平仄。平平仄仄平平仄，仄仄仄、平平仄仄。仄平平仄仄，平平平仄，仄平平仄。仄仄。平平仄。仄仄仄平平，仄平平仄。平平仄仄。仄平平仄平仄。仄平仄仄平平仄，仄仄仄、平平仄仄。仄平仄，仄平平，平仄平平仄仄。,0,47,52,99,"[4, 4, 4, 4, 6, 7, 3, 4, 5, 4, 4, 2, 3, 5, 4, 4, 6, 7, 3, 4, 3, 3, 6]"
月下笛 ,张炎,仄仄平平，平平仄仄，仄平平仄。平平仄仄。平仄平平仄平仄。平平仄仄平平仄，仄仄仄、平平仄仄。仄平平平仄，平平仄仄，仄平平仄。平仄。平平仄。仄平仄平平，仄平平仄。平平仄仄。仄平平仄平仄。仄平平仄平平仄，仄仄仄、平平仄仄。仄仄仄，仄平平，平仄平平仄仄。,0,49,51,100,"[4, 4, 4, 4, 7, 7, 3, 4, 5, 4, 4, 2, 3, 5, 4, 4, 6, 7, 3, 4, 3, 3, 6]"
月下笛 ,曾允元,平仄平平，平平仄仄，仄平平仄。平平仄仄。仄平平、仄平仄。平平仄仄平平仄，仄平仄、平平仄仄。仄平平仄仄，平平仄仄，平仄平仄。平仄。平平仄。仄仄仄平平，平平平仄。平平仄仄，平平平仄平仄。平平平仄平平仄，仄仄仄、平平仄仄。仄平仄，仄仄平平仄，仄仄仄仄。,0,49,50,99,"[4, 4, 4, 4, 3, 3, 7, 3, 4, 5, 4, 4, 2, 3, 5, 4, 4, 6, 7, 3, 4, 3, 5, 4]"
月下笛 ,彭元逊,平仄平平，仄平平仄，仄平平仄。平平仄仄。仄平平仄平仄。平平仄仄平平仄，平仄平平仄仄。平平仄仄，平平平仄，平仄平仄。平仄平平仄仄，仄平仄平平，仄平平仄。平平平仄，仄平平仄平仄。仄平仄仄平平仄，仄仄平平仄仄。平平仄，仄平平平仄，仄仄平仄。,0,51,46,97,"[4, 4, 4, 4, 6, 7, 6, 4, 4, 4, 6, 5, 4, 4, 6, 7, 6, 3, 5, 4]"
玲珑四犯 ,周邦彦,平仄平平，仄仄仄平平，平仄平仄。仄仄平平，平仄仄平平仄。平仄仄仄平平，仄仄仄、仄平平仄。仄仄平仄仄平仄。平仄仄平平仄。仄平平仄平平仄。仄平平、仄平平仄。平平仄仄平平仄，平仄平平仄。平仄仄仄仄平，仄仄仄、平平仄仄。仄仄平仄仄，平仄仄，平平仄。,0,45,54,99,"[4, 5, 4, 4, 6, 6, 3, 4, 7, 6, 7, 3, 4, 7, 5, 6, 3, 4, 5, 3, 3]"
玲珑四犯 ,曹邍,仄仄平平，仄仄仄平平，平仄平仄。仄仄平平，平仄仄平平仄。平仄仄仄平平，仄仄仄、仄平平仄。仄仄平仄仄平仄，仄仄仄平平仄。仄平平仄平平仄。仄平平、仄平平仄。仄平仄仄平平仄，平仄平平仄。平仄仄仄仄平，平仄仄、仄平平仄。仄仄平平仄，平平平仄，仄平平仄。,0,46,55,101,"[4, 5, 4, 4, 6, 6, 3, 4, 7, 6, 7, 3, 4, 7, 5, 6, 3, 4, 5, 4, 4]"
玲珑四犯 ,史达祖,仄仄平平，仄仄仄平平，平仄平仄。仄仄平平，仄仄仄平平仄。平仄仄仄平平，仄仄仄、仄平平仄。仄仄平、平仄平仄，平仄仄平平仄。仄平平仄平平仄，仄平平、仄平平仄。平平仄仄平平仄，平仄平平仄。平仄仄仄仄平，平仄仄、平平平仄。仄仄平、平仄平平平仄，仄平平仄。,0,49,52,101,"[4, 5, 4, 4, 6, 6, 3, 4, 3, 4, 6, 7, 3, 4, 7, 5, 6, 3, 4, 3, 6, 4]"
玲珑四犯 ,高观国,仄仄平平，仄仄仄平平，平仄平仄。仄仄平平，平仄仄平平仄。仄仄仄仄平平，仄仄仄平平仄。仄仄平、仄仄平平，仄仄仄平平仄。仄平平仄平平仄，仄平平、仄仄平仄。平平仄仄平平仄，平仄平平仄。仄仄仄仄仄平，仄仄平、平平平仄。仄仄平、仄仄平平，平仄仄平平仄。,0,45,55,100,"[4, 5, 4, 4, 6, 6, 6, 3, 4, 6, 7, 3, 4, 7, 5, 6, 3, 4, 3, 4, 6]"
玲珑四犯 ,张炎,平仄平平，仄仄仄平平，仄仄平仄。仄仄平平，仄仄仄平平仄。平仄仄仄平平，仄仄仄、仄平平仄。仄仄平、仄仄平仄。仄仄平平平仄。仄平仄仄平平仄。仄平平、仄平平仄。平平仄仄平平仄，平仄仄仄平仄。平仄仄平仄仄，仄仄仄、平平平仄。仄仄平平仄，仄仄平，平平仄。,0,43,57,100,"[4, 5, 4, 4, 6, 6, 3, 4, 3, 4, 6, 7, 3, 4, 7, 6, 6, 3, 4, 5, 3, 3]"
玲珑四犯 ,周密,平仄平平，仄仄仄平平，平仄平仄。仄仄平平，平仄仄平平仄。平仄仄仄平平，仄仄仄、仄平平仄。仄仄平、仄仄平平，平仄仄平平仄。仄平平仄平平仄。仄平平、仄平平仄。平平仄仄平平仄，平仄平平仄。平仄仄仄仄平，平仄仄、平平平仄。仄仄平平仄，平仄仄，平平仄。,0,49,50,99,"[4, 5, 4, 4, 6, 6, 3, 4, 3, 4, 6, 7, 3, 4, 7, 5, 6, 3, 4, 5, 3, 3]"
玲珑四犯 ,姜夔,仄仄仄平，平平平仄，平平平仄平仄。仄平平仄仄，仄仄平平仄。平平仄平仄仄。仄平平、仄平平仄。仄仄平平，仄平平仄，平仄仄平仄。平平仄、平平仄。仄平平仄仄，平仄平仄。仄平平仄仄，仄仄平平仄。平平仄仄平平仄，仄平仄、平平平仄。平仄仄。平平仄、平平仄仄。,0,50,49,99,"[4, 4, 6, 5, 5, 6, 3, 4, 4, 4, 5, 3, 3, 5, 4, 5, 5, 7, 3, 4, 3, 3, 4]"
丁香结 ,周邦彦,平仄平平，仄平平仄，平仄仄平平仄。仄仄平平仄。仄仄仄、仄仄平平平仄。仄平平仄仄，平平仄、仄仄仄仄。平平平仄，仄仄仄仄平平仄仄。平仄。仄仄仄平平，仄仄平平仄仄。仄仄平平，平平仄仄，仄平平仄。平仄平仄仄仄，仄仄平平仄。平平平平仄，仄仄平平仄仄。,0,43,56,99,"[4, 4, 6, 5, 3, 6, 5, 3, 4, 4, 8, 2, 5, 6, 4, 4, 4, 6, 5, 5, 6]"
琐寒窗 ,周邦彦,仄仄平平，平平仄仄，仄平平仄。平平仄仄，仄仄仄平平仄。仄平平、平平仄平，仄平仄仄平平仄。仄仄平仄仄，平平平仄，仄平平仄。平仄。平平仄。仄仄仄平平，仄平仄仄。平平仄仄，仄仄平平平仄。仄平平、平仄仄平，仄平仄仄平仄仄。仄平平、仄仄平平，仄仄平平仄。,0,47,52,99,"[4, 4, 4, 4, 6, 3, 4, 7, 5, 4, 4, 2, 3, 5, 4, 4, 6, 3, 4, 7, 3, 4, 5]"
琐寒窗 ,张炎,仄仄平平，平平仄仄，仄平平仄。平平仄仄，仄仄仄平平仄。仄平平、仄平平仄，仄平仄仄平平仄。仄平平、仄仄平平，仄仄仄平平仄。平仄。平平仄。仄平平仄仄，仄平平仄。平平仄仄，仄仄仄平平仄。仄仄平、平仄仄平，仄平仄平平仄仄。仄平平、仄仄平平，仄平平仄仄。,0,46,53,99,"[4, 4, 4, 4, 6, 3, 4, 7, 3, 4, 6, 2, 3, 5, 4, 4, 6, 3, 4, 7, 3, 4, 5]"
琐寒窗 ,杨无咎,仄仄平平，平平仄仄，仄平平仄。平平仄仄，仄仄仄平平仄。仄平平、平仄仄平，仄平仄仄平平仄。仄平平、仄仄平平，平仄仄平平仄。平仄。平平仄仄。仄平仄平平，仄平平仄。平仄仄仄。仄仄仄平平仄。仄平平、平仄仄平，仄仄仄仄平平仄。仄平平、仄仄平平，仄仄平平仄。,0,47,53,100,"[4, 4, 4, 4, 6, 3, 4, 7, 3, 4, 6, 2, 4, 5, 4, 4, 6, 3, 4, 7, 3, 4, 5]"
琐寒窗 ,张炎,仄仄平平，平平仄仄，仄平平仄。平平仄仄。平仄仄平平仄。仄平平、仄平仄仄，仄平仄仄平平仄。仄平平仄仄，平平仄仄，仄平平仄。平仄。平平仄。仄仄仄平平，仄平平仄。平平平仄。仄平仄、平平平仄。仄平平、平仄仄平，平平仄仄平平仄。仄仄平、平仄平平，仄平平仄仄。,0,51,49,100,"[4, 4, 4, 4, 6, 3, 4, 7, 5, 4, 4, 2, 3, 5, 4, 4, 3, 4, 3, 4, 7, 3, 4, 5]"
琐寒窗 ,程先,仄仄平平，平平仄仄，仄平平仄。平平仄仄，仄仄平平平仄。仄仄平、仄平仄平，仄平平仄平平仄。仄仄平仄仄，平平平仄，仄平平仄。平仄平平仄。仄仄平平，仄平仄仄。平平仄仄，仄仄平平平仄。仄平平、平仄仄平，仄平仄仄平仄仄。仄平平、仄仄平平，仄仄平平仄。,0,47,51,98,"[4, 4, 4, 4, 6, 3, 4, 7, 5, 4, 4, 5, 4, 4, 4, 6, 3, 4, 7, 3, 4, 5]"
大有 ,潘希白,仄仄平平，仄平平仄，仄仄平、平仄平仄。仄平平、平平仄仄平仄。平平仄仄平平仄，平仄仄、平平平仄。仄仄仄仄平平，仄平仄平平仄。平平仄，平仄仄。平仄仄平平，仄平平仄。平仄平平，仄仄仄平平仄。仄仄仄平平仄，平平仄、平平平仄。仄平仄、仄仄平平，平平仄仄。,0,50,49,99,"[4, 4, 3, 4, 3, 6, 7, 3, 4, 6, 6, 3, 3, 5, 4, 4, 6, 6, 3, 4, 3, 4, 4]"
燕山亭 ,曾觌,平仄平平，平仄仄平，仄仄平平平仄。平仄仄平，仄仄平平，平仄仄平平仄。仄仄平平，仄平仄、仄平平仄。平仄。仄仄仄平平，仄平平仄。平仄平仄平平，仄平仄平平，仄平平仄。平仄仄平，仄仄平平，平平仄平平仄。仄仄平平，仄仄仄、平平平仄。平仄。平仄仄、平平仄仄。,0,51,48,99,"[4, 4, 6, 4, 4, 6, 4, 3, 4, 2, 5, 4, 6, 5, 4, 4, 4, 6, 4, 3, 4, 2, 3, 4]"
聒龙谣 ,朱敦儒,平仄平平，仄平仄仄，仄仄仄平平仄。平仄平平，仄平平平仄。仄平仄、平仄平平，仄仄仄、仄平平仄。仄平平、仄仄平平，仄平仄，仄平仄。平平仄，仄平平，仄仄仄平仄，平平平仄。平平仄仄，仄平平平仄。仄平平、平仄平平，仄仄仄、仄平平仄。仄平平、仄仄平平，仄平平仄。,0,50,49,99,"[4, 4, 6, 4, 5, 3, 4, 3, 4, 3, 4, 3, 3, 3, 3, 5, 4, 4, 5, 3, 4, 3, 4, 3, 4, 4]"
聒龙谣 ,朱敦儒,平仄平平，仄平仄仄。仄仄仄平平仄。平仄平平，仄平平平仄。仄平平、仄仄平平，仄仄仄、仄平平仄。仄平平、仄仄平平，仄平仄，仄平仄。平平仄，仄平平，仄仄仄平仄，平平平仄。平平仄仄，仄平平平仄。仄仄仄、仄仄平平，平仄平、仄平平仄。仄平平、仄仄平平，仄平平仄。,0,49,50,99,"[4, 4, 6, 4, 5, 3, 4, 3, 4, 3, 4, 3, 3, 3, 3, 5, 4, 4, 5, 3, 4, 3, 4, 3, 4, 4]"
金菊对芙蓉 ,康与之,平仄平平，仄平平仄，仄平平仄平平。仄平平平仄，仄仄平平。平平仄仄平平仄，仄仄平、平仄平平。仄平平仄，仄平仄仄，仄仄平平。仄仄仄仄平平。仄仄平仄仄，仄仄平平。仄平平平仄，仄仄平平。平平仄仄平平仄，仄仄平、仄仄平平。平平仄仄，平平仄仄，平仄平平。,0,51,48,99,"[4, 4, 6, 5, 4, 7, 3, 4, 4, 4, 4, 6, 5, 4, 5, 4, 7, 3, 4, 4, 4, 4]"
催雪 ,姜夔,平仄平平，平仄仄仄，仄仄平平仄仄。仄仄仄平平，仄平平仄。平仄仄平仄仄，仄仄仄、平平平平仄。仄平平仄，平平仄仄，仄平平仄。平仄。仄仄仄。仄仄仄仄平，仄平平仄。仄平仄、平平仄平平仄。仄仄平平仄仄，仄平仄、平平平平仄。仄仄仄、仄仄平平，仄仄仄平平仄。,0,42,57,99,"[4, 4, 6, 5, 4, 6, 3, 5, 4, 4, 4, 2, 3, 5, 4, 3, 6, 6, 3, 5, 3, 4, 6]"
十月桃 ,张元干,平平平仄，仄平平平仄，平仄平平。仄仄平平，平仄仄仄平平。平平仄平平仄，平仄仄、仄仄平平。平平仄仄，平仄平平，平仄平平。仄平平平仄平平。仄仄仄平平，仄仄平平。仄仄平平，仄平平仄平平。平平仄平仄仄，平仄仄、平仄平平。平平仄仄，平仄平平，仄仄平平。,0,58,41,99,"[4, 5, 4, 4, 6, 6, 3, 4, 4, 4, 4, 7, 5, 4, 4, 6, 6, 3, 4, 4, 4, 4]"
十月桃 ,无名氏,平平仄仄，仄平平仄仄，仄仄平平。仄仄平平，仄平平仄平平。平平仄仄平仄，平仄仄、仄仄平平。平平仄仄，仄仄平平，仄仄平平。仄仄平平仄平平。平仄仄、平平仄仄平平。仄仄平平仄仄，仄仄平平。平平仄仄平仄，平仄仄、仄仄平平。平平仄仄，仄平平仄，平仄平平。,0,50,49,99,"[4, 5, 4, 4, 6, 6, 3, 4, 4, 4, 4, 7, 3, 6, 6, 4, 6, 3, 4, 4, 4, 4]"
十月桃 ,无名氏,平平平仄，仄平仄仄，仄仄平平。仄仄平平，仄平平仄平平。平平仄仄平仄，平仄仄、平仄平平。平平仄仄，仄仄平平，仄仄平平。仄仄平平仄平平。平仄仄、平平仄仄平平。仄仄平平，平平平仄平平。平平仄仄平仄，平仄仄、平仄平平。平平仄仄，仄仄平平，平仄平平。,0,55,43,98,"[4, 4, 4, 4, 6, 6, 3, 4, 4, 4, 4, 7, 3, 6, 4, 6, 6, 3, 4, 4, 4, 4]"
蜀溪春 ,曹勛,仄仄平平，仄平平平，平仄平平。平仄平平，仄平平仄，平仄仄仄平平。平仄平仄仄，平仄仄、平仄平平。仄仄平，平仄平，仄仄仄平平。平平仄平仄仄，平仄仄平仄，平仄平平。仄仄平平，仄平平仄，平仄仄平平平。平仄平仄仄，平平仄、平仄平平。仄仄仄，平仄平，仄仄平。,0,53,46,99,"[4, 4, 4, 4, 4, 6, 5, 3, 4, 3, 3, 5, 6, 5, 4, 4, 4, 6, 5, 3, 4, 3, 3, 3]"
秋宵吟 ,姜夔,仄平平，仄仄仄。仄仄平平平仄。平平仄、仄仄仄平平，仄平平仄。仄平平，仄仄仄。仄仄平平平仄。平平仄、仄仄仄平平，仄平平仄。仄仄平平，仄仄仄、平平仄仄。仄平平仄，仄仄平平，仄仄仄平仄。平仄平平仄。仄仄平平，平仄仄仄。仄平平、仄仄平平，平仄平仄仄仄仄。,0,43,56,99,"[3, 3, 6, 3, 5, 4, 3, 3, 6, 3, 5, 4, 4, 3, 4, 4, 4, 5, 5, 4, 4, 3, 4, 7]"
三姝媚 ,史达祖,平平平仄仄。仄平平平平，仄平平仄。仄仄平平，仄仄平平仄，仄平平仄。仄仄平平，平仄仄、平平平仄。仄仄平平，平仄平平，仄平平仄。平仄平平平仄。仄仄仄平平，仄平平仄。仄仄平平，仄仄平平仄，仄平平仄。仄仄平平，平仄仄、平平平仄。仄仄平平平仄，平平仄仄。,0,53,46,99,"[5, 5, 4, 4, 5, 4, 4, 3, 4, 4, 4, 4, 6, 5, 4, 4, 5, 4, 4, 3, 4, 6, 4]"
三姝媚 ,吴文英,平平平仄仄。仄平平平平，仄平平仄。仄仄平平，仄仄平平仄，仄平平仄。平仄平平，平仄仄、平平平仄。仄仄平平，平仄平平，仄平平仄。平仄平平平仄。仄仄仄平平，仄平平仄。仄仄平平，仄仄平平仄，仄平平仄。仄仄平平，仄仄仄、平平平仄。仄仄平平，平平平仄，平平仄仄。,0,55,46,101,"[5, 5, 4, 4, 5, 4, 4, 3, 4, 4, 4, 4, 6, 5, 4, 4, 5, 4, 4, 3, 4, 4, 4, 4]"
三姝媚 ,薛梦桂,平平平仄仄。仄平平，平仄仄平平仄。仄仄平平，仄仄平平仄，仄平平仄。仄仄平平，仄平仄、仄平平仄。仄仄平平，平仄平平，仄平平仄。平仄平平平仄。仄仄仄，平平仄平平仄。仄仄平平，仄仄平平仄，仄平平仄。仄仄平平平仄，仄平平平仄。仄仄平平，平仄平平仄仄。,0,51,48,99,"[5, 3, 6, 4, 5, 4, 4, 3, 4, 4, 4, 4, 6, 3, 6, 4, 5, 4, 6, 5, 4, 6]"
凤池吟 ,吴文英,仄仄平平，仄平平仄，仄仄仄仄平平。仄平平仄仄，平平仄仄，仄仄平平。仄仄平平，仄平仄仄仄平平。平平仄仄，平平平仄，仄仄平平。平平仄仄平仄，仄仄平仄仄，仄仄平平。仄仄平平仄，仄平平仄，仄仄平平。仄仄平平，仄平平仄仄平平。平平仄，仄平平、仄仄平平。,0,48,51,99,"[4, 4, 6, 5, 4, 4, 4, 7, 4, 4, 4, 6, 5, 4, 5, 4, 4, 4, 7, 3, 3, 4]"
新雁过妆楼 ,吴文英,仄仄平平。平平仄、平平仄仄平平。仄平仄仄，平仄仄仄平平。仄仄平平平仄仄，平平仄仄仄平平。仄平平。仄平仄仄，平仄平平。平平平平仄仄，仄仄平仄仄，仄仄平平。仄平仄仄，平仄仄仄平平。平平仄平仄仄，仄仄仄平平平仄平。平平仄，仄仄平平仄，平仄平平。,0,50,49,99,"[4, 3, 6, 4, 6, 7, 7, 3, 4, 4, 6, 5, 4, 4, 6, 6, 8, 3, 5, 4]"
新雁过妆楼 ,吴文英,仄仄平平。平平仄、平平仄仄平平。仄平平仄，平仄仄仄平平。仄仄平平平仄仄，仄平仄仄仄平平。仄平平，仄平仄仄，仄仄平平。平平平平仄仄，仄仄平仄仄，仄仄平平。仄平平仄，平平仄仄平平。平平仄平仄仄，仄平仄、平平平仄平。平平仄，仄仄平平仄，平平仄平。,0,52,47,99,"[4, 3, 6, 4, 6, 7, 7, 3, 4, 4, 6, 5, 4, 4, 6, 6, 3, 5, 3, 5, 4]"
新雁过妆楼 ,张炎,平仄仄平，平仄仄、平仄仄仄平平。仄平平仄，平仄仄仄平平。仄仄平平平仄仄，仄平仄仄仄平平。仄平平。仄平仄仄，平仄平平。平平平平仄仄，仄仄平仄仄，平仄平平。仄仄平平，平仄仄仄平平。平平平仄仄仄，仄仄仄平平平仄平。平平仄，仄仄平仄仄，仄仄平平。,0,48,51,99,"[4, 3, 6, 4, 6, 7, 7, 3, 4, 4, 6, 5, 4, 4, 6, 6, 8, 3, 5, 4]"
新雁过妆楼 ,无名氏,仄仄平仄，平仄仄平，平平平仄平平。仄平平仄，平仄仄平平。平平仄仄平平仄，仄平平、平平仄仄平。仄平平、仄平仄仄，平仄仄、仄仄平平。平仄仄仄平平，平平仄仄，平平仄仄平平。仄平平仄，平仄仄平平。仄平仄仄平平仄，仄仄平、平平仄仄平。仄平平、仄仄平平，仄平平、平仄平平。,0,58,48,106,"[4, 4, 6, 4, 5, 7, 3, 5, 3, 4, 3, 4, 6, 4, 6, 4, 5, 7, 3, 5, 3, 4, 3, 4]"
月华清 ,洪瑹,平仄平平，平平平仄，仄平平仄平仄。平仄平平，仄仄仄平平仄。仄仄仄、平仄平平，仄仄仄、仄平平仄。平仄。仄平平仄仄，平平仄仄。仄仄平平仄仄。仄仄仄平平，仄平平仄。仄仄平平，仄仄平平平仄。仄平仄、仄仄平平，平仄仄、仄平平仄。平仄。仄平平平仄，仄平平仄。,0,47,52,99,"[4, 4, 6, 4, 6, 3, 4, 3, 4, 2, 5, 4, 6, 5, 4, 4, 6, 3, 4, 3, 4, 2, 5, 4]"
国香 ,张炎,平仄平平。仄平平仄仄，仄仄平平。仄平仄平平仄，仄仄平平。仄仄平平仄仄，仄平平、平仄平平。平平仄平仄，仄仄平平，仄仄平平。仄平平仄仄，仄平平仄仄，平仄平平。仄平平仄，平仄仄仄平平。仄仄平平平仄，仄平平、仄仄平平。平平仄平仄，仄仄平平，仄仄平平。,0,52,47,99,"[4, 5, 4, 6, 4, 6, 3, 4, 5, 4, 4, 5, 5, 4, 4, 6, 6, 3, 4, 5, 4, 4]"
国香 ,曹勛,仄仄平平。仄平仄仄仄，平仄平平。仄仄平平，平仄仄仄平平。仄仄平平仄仄，仄平平、仄仄平平。平平仄仄仄，仄仄平平，仄仄平平。平平平仄仄，仄平平仄仄，平仄平平。仄平平仄，平仄仄仄平平。仄仄平平仄仄，仄平平、平仄平平。平平仄仄仄，仄仄平平，仄仄平平。,0,49,50,99,"[4, 5, 4, 4, 6, 6, 3, 4, 5, 4, 4, 5, 5, 4, 4, 6, 6, 3, 4, 5, 4, 4]"
飞龙宴 ,宋媛苏氏,平平仄仄平，平平仄仄，平平平仄。仄仄平平，仄平平仄平仄。仄仄平平仄仄。仄仄仄、仄平平仄。仄平仄仄，平平平仄，仄仄平平仄。平仄。平仄平平仄。仄平平平仄，仄平平仄。仄仄平平，仄平仄仄平仄。平仄平平仄仄。仄平平、仄平平仄。仄平仄仄。平平仄仄平平仄。,0,48,51,99,"[5, 4, 4, 4, 6, 6, 3, 4, 4, 4, 5, 2, 5, 5, 4, 4, 6, 6, 3, 4, 4, 7]"
御带花 ,欧阳修,平平平仄平平仄，仄仄平仄平仄。仄平平仄，仄仄平平仄，仄平平仄。仄仄平平，仄仄仄、平平仄仄。平平仄、平平仄仄，平仄仄平仄。平平平平仄仄，仄仄仄平平，仄仄平仄。仄平平仄，仄仄仄平平，仄平平仄。仄仄平平，仄仄仄、仄平仄仄。平平仄、平平仄仄，仄仄仄平仄。,0,44,56,100,"[7, 6, 4, 5, 4, 4, 3, 4, 3, 4, 5, 6, 5, 4, 4, 5, 4, 4, 3, 4, 3, 4, 5]"
定风波慢 ,柳永,仄平平、仄仄平平，平平仄仄仄仄。仄仄平平，平平仄仄，平仄平平仄。仄平平，仄平仄。平仄平平仄平仄。平仄。仄仄平仄仄，平平平仄。仄平仄平仄。仄平平、仄仄平平仄。仄平平，仄仄平平仄仄，平仄平平仄。仄平平，仄平仄。平仄平平仄平仄。平仄。仄仄仄平，平平平仄。,0,50,50,100,"[3, 4, 6, 4, 4, 5, 3, 3, 7, 2, 5, 4, 5, 3, 5, 3, 6, 5, 3, 3, 7, 2, 4, 4]"
定风波慢 ,张翥,仄平平、仄仄平平，平平仄仄仄仄。仄仄平平，平平仄仄，仄仄平平仄。仄平平，仄平仄。仄仄平平仄平仄。平仄。仄平仄仄仄，平平平仄。仄平仄仄。仄平平、仄仄平平仄。仄平平平仄，平平仄仄，平仄平平仄。仄平平，仄平仄。平仄平平仄仄仄。平仄。仄平平仄，平平平仄。,0,48,51,99,"[3, 4, 6, 4, 4, 5, 3, 3, 7, 2, 5, 4, 4, 3, 5, 5, 4, 5, 3, 3, 7, 2, 4, 4]"
定风波慢 ,无名氏,仄平平、平仄平平，仄平仄平平仄。仄仄仄平平，平平仄仄，平仄平平仄。仄平平，平仄仄。平仄平平仄平仄。平仄。仄仄平平仄，平平仄仄。平平仄仄。仄平平、仄仄平平仄。仄平平，仄仄平平仄仄，平仄平平仄。仄平平，平仄仄。仄仄平平仄平仄。平仄。仄仄平平仄，平平平仄。,0,52,49,101,"[3, 4, 6, 5, 4, 5, 3, 3, 7, 2, 5, 4, 4, 3, 5, 3, 6, 5, 3, 3, 7, 2, 5, 4]"
定风波慢 ,柳永,仄仄平平，仄仄仄平仄。仄仄仄、仄仄平平，仄仄仄平，仄仄仄平平仄。仄平平仄仄，平平平平仄仄。仄仄仄、平仄平平，平仄平平仄平仄。平仄。仄仄平平，仄仄平平，仄平仄仄。仄仄仄仄仄，平平仄仄。仄平平仄、仄平平仄。仄平平、仄仄平平，平平仄仄。仄仄平、平仄平仄，仄仄平平仄。,0,44,61,105,"[4, 5, 3, 4, 4, 6, 5, 6, 3, 4, 7, 2, 4, 4, 4, 5, 4, 4, 4, 3, 4, 4, 3, 4, 5]"
芳草 ,韩缜,仄平平，平平平仄，平平仄仄平平。仄平平仄仄，仄平平仄仄，仄平平。平平平仄仄，仄平平、仄仄平平。仄仄仄、平平仄仄，仄仄平平。平平。平平平仄仄，平平仄、仄仄平平。仄平平仄仄，仄平平仄仄，仄仄平平。平平平仄仄，仄平平、平仄平平。仄仄仄、平平仄仄，仄仄平平。,0,53,47,100,"[3, 4, 6, 5, 5, 3, 5, 3, 4, 3, 4, 4, 2, 5, 3, 4, 5, 5, 4, 5, 3, 4, 3, 4, 4]"
芳草 ,奚淢,仄平平，平平平仄，平平平仄平平。仄平平仄仄，平平平仄仄，仄平平。平平平仄仄，仄仄平、仄仄平平。平仄仄、平平仄仄，仄仄平平。平平。平平平仄，仄平平仄，仄仄平平。仄平平仄仄，平平平仄仄，平仄平平。仄平平仄仄，仄仄平、仄仄平平。仄仄仄平平仄仄，仄仄平平。,0,54,46,100,"[3, 4, 6, 5, 5, 3, 5, 3, 4, 3, 4, 4, 2, 4, 4, 4, 5, 5, 4, 5, 3, 4, 7, 4]"
芳草 ,晁补之,仄平平。平平仄仄，平仄仄仄平平。仄平平仄仄，仄平平仄，仄仄仄平平。仄平平仄仄，仄平平、平仄平平。仄仄仄平平，仄平仄仄平平。平平。仄平平仄，仄平平仄，平仄平平。仄平平仄仄，仄平平仄仄，仄仄平平。仄平平仄仄，仄平平、平仄平平。仄仄仄、平平仄仄，平仄平平。,0,52,49,101,"[3, 4, 6, 5, 4, 5, 5, 3, 4, 5, 6, 2, 4, 4, 4, 5, 5, 4, 5, 3, 4, 3, 4, 4]"
芳草 ,曹勛,仄平平。平平平仄，平平仄仄平平。仄平平仄仄，仄平仄仄平，仄仄平平。平平平仄仄，仄平平、平仄平平。仄仄仄平平，仄仄平仄平平。平平。平平平仄，仄仄平平，仄仄平平。仄平平仄仄，仄平平仄仄，仄仄平平。平平平仄仄，仄平平、平仄平平。仄仄仄、平平仄仄，平仄平平。,0,56,45,101,"[3, 4, 6, 5, 5, 4, 5, 3, 4, 5, 6, 2, 4, 4, 4, 5, 5, 4, 5, 3, 4, 3, 4, 4]"
芳草 ,王之道,仄平平。平平平仄，平平仄仄平平。平平平仄仄，平平仄仄，平仄仄平平。平平平仄仄，仄平平、仄仄平平。仄平仄平平，仄平平仄平平。平平。平平平仄仄，仄平平、仄仄平平。仄平平仄，平仄平平，仄平平仄平平。仄平平仄仄，平平仄、仄仄平平。仄仄仄平平，仄平仄仄平平。,0,60,41,101,"[3, 4, 6, 5, 4, 5, 5, 3, 4, 5, 6, 2, 5, 3, 4, 4, 4, 6, 5, 3, 4, 5, 6]"
念奴娇 ,苏轼,平平仄仄，仄平平仄仄，仄平平仄。仄仄仄平平仄仄，仄仄仄平平仄。仄仄平平，平平平仄，平仄平平仄。平平平仄，仄平平仄仄仄。仄仄仄仄平平，仄平平仄，仄仄平平仄。仄仄平平平仄仄，平仄仄平平仄。仄仄平平，平平平仄，平仄平平仄。仄平平仄，仄平平仄平仄。,0,48,52,100,"[4, 5, 4, 7, 6, 4, 4, 5, 4, 6, 6, 4, 5, 7, 6, 4, 4, 5, 4, 6]"
念奴娇 ,苏轼,仄平平仄，仄平仄、平仄平平平仄。仄仄平平，平仄仄、平仄平平仄仄。仄仄平平，平平仄仄，仄仄平平仄。平平平仄，仄平平仄平仄。平仄平仄平平，仄平平仄仄，平平平仄。仄仄平平，平仄仄、平仄平平平仄。仄仄平平，平平仄仄仄，仄平平仄。平平平仄，仄平平仄平仄。,0,53,47,100,"[4, 3, 6, 4, 3, 6, 4, 4, 5, 4, 6, 6, 5, 4, 4, 3, 6, 4, 5, 4, 4, 6]"
念奴娇 ,姜夔,仄平仄仄，仄平平仄仄，平仄平仄。仄仄平平，仄仄仄、仄仄平平平仄。仄仄平平，平平平仄，仄仄平平仄。平平平仄，仄平仄仄平仄。平仄仄仄平平，平平仄仄，仄平平平仄。仄仄平平，仄仄仄、平仄平平平仄。仄仄平平，平平仄仄，仄仄平平仄。平平平仄，仄平仄仄平仄。,0,47,53,100,"[4, 5, 4, 4, 3, 6, 4, 4, 5, 4, 6, 6, 4, 5, 4, 3, 6, 4, 4, 5, 4, 6]"
念奴娇 ,姜夔,仄平仄仄，仄平平，平仄平平平仄。平仄仄平平仄仄，仄仄平平平仄。仄仄平平，仄平平仄，仄仄平平仄。平平平仄，仄平平仄平仄。仄仄。平仄平平，平平仄仄，平仄平平仄。仄仄仄平平仄仄，平仄平平平仄。平仄平平，仄平平仄，平仄平平仄。平平平仄，仄平平仄平仄。,0,53,47,100,"[4, 3, 6, 7, 6, 4, 4, 5, 4, 6, 2, 4, 4, 5, 7, 6, 4, 4, 5, 4, 6]"
念奴娇 ,张炎,平平仄仄。仄平平、平仄平平平仄。平仄仄平平仄仄，仄仄平平平仄。仄仄平平，平平仄仄，仄仄平平仄。平平平仄，仄平平仄平仄。平仄平仄平平，平平仄仄，仄仄平平仄。仄仄平平平仄仄，平仄平平平仄。仄仄平平，仄平平仄，仄仄平平仄。仄平平仄，仄仄仄仄平仄。,0,50,50,100,"[4, 3, 6, 7, 6, 4, 4, 5, 4, 6, 6, 4, 5, 7, 6, 4, 4, 5, 4, 6]"
念奴娇 ,张炎,平平仄仄。仄平平平仄，平平仄仄。平仄平平平仄仄，仄仄平平平仄。仄仄平平，仄平平仄，平仄平平仄。仄平平仄，仄平平仄平仄。平仄。仄仄平平，仄平平仄，平仄平平仄。平仄平平平仄仄，平仄平平平仄。仄仄平平，平平平仄，仄仄平平仄。平平平仄，平平平仄平仄。,0,56,44,100,"[4, 5, 4, 7, 6, 4, 4, 5, 4, 6, 2, 4, 4, 5, 7, 6, 4, 4, 5, 4, 6]"
念奴娇 ,张辑,仄平平仄，仄仄平平，平仄平平平仄。仄仄仄平平仄仄，平仄平平平仄。仄仄平平，平平仄仄，平仄平平仄。仄平平仄，仄平平仄平仄。仄仄平仄平平，仄平平仄，平仄平平仄。仄仄仄平平仄仄，平仄平平平仄。平仄平平，仄平平仄，仄仄平平仄。仄平平仄，仄平平仄平仄。,0,52,49,101,"[4, 4, 6, 7, 6, 4, 4, 5, 4, 6, 6, 4, 5, 7, 6, 4, 4, 5, 4, 6]"
念奴娇 ,赵长卿,平平平仄，仄平平、仄仄平平平仄。仄仄平平平仄仄，平仄平平平仄。仄仄平平，仄平仄仄，仄仄平平仄。平平仄仄，仄仄仄平，平仄平仄。平仄仄仄平平，仄平平仄，平仄平平仄。平仄平平，仄仄仄、仄仄平平平仄。仄仄平平，平平平仄，仄仄平平仄。平平平仄，仄平平仄平仄。,0,52,50,102,"[4, 3, 6, 7, 6, 4, 4, 5, 4, 4, 4, 6, 4, 5, 4, 3, 6, 4, 4, 5, 4, 6]"
念奴娇 ,陈允平,仄平仄仄，仄平平平仄，平仄平平。仄仄平平平仄仄，仄平平仄平平。仄仄平平，平平仄仄，平仄仄平平。平平平仄，平仄平仄平平。平仄仄仄平平，平平仄仄，平仄仄平平。仄仄平平平仄仄，平仄平仄平平。仄仄平平，平平平仄，平仄仄平平。仄平平仄，仄平平仄平平。,0,57,43,100,"[4, 5, 4, 7, 6, 4, 4, 5, 4, 6, 6, 4, 5, 7, 6, 4, 4, 5, 4, 6]"
念奴娇 ,张元干,平平平仄，仄平平平仄，平仄平平。平仄平平平仄仄，平仄平仄平平。仄仄平平，平平平仄，平仄仄平平。平平平仄，仄平平仄平平。平平平仄平平，平平平仄仄，平仄平平。仄仄平平平仄仄，平仄平仄平平。仄仄平平，仄平平仄，仄仄仄平平。仄平平仄，仄平平仄平平。,0,62,38,100,"[4, 5, 4, 7, 6, 4, 4, 5, 4, 6, 6, 5, 4, 7, 6, 4, 4, 5, 4, 6]"
念奴娇 ,叶梦得,仄平仄仄，仄平平平仄，平平平平。平仄平平，平仄仄、平仄平仄平平。仄仄平平，平平平仄，平仄仄平平。平平平仄，仄平仄仄平平。平仄平仄平平。平平平仄仄，平仄平平。仄仄平平，平仄仄、平仄平仄平平。仄仄平平，仄平平仄，平仄仄平平。仄平平仄，仄平仄仄平平。,0,59,41,100,"[4, 5, 4, 4, 3, 6, 4, 4, 5, 4, 6, 6, 5, 4, 4, 3, 6, 4, 4, 5, 4, 6]"
念奴娇 ,曹勛,仄平仄仄，仄平平、平仄平仄平平。仄仄平平，平仄仄、平仄仄仄平平。平仄平平。平平仄仄，仄仄仄平平。平平平仄，仄平仄仄平平。平仄仄仄平平。平平平仄，仄平仄平平。仄仄平平，平仄仄、平仄平仄平平。仄仄平平。平平平仄，仄仄仄平平。仄平平仄，仄平平仄平平。,0,55,45,100,"[4, 3, 6, 4, 3, 6, 4, 4, 5, 4, 6, 6, 4, 5, 4, 3, 6, 4, 4, 5, 4, 6]"
解语花 ,秦观,平平仄仄，仄仄平平，平仄平平仄。仄平仄仄。平平仄、仄仄平平平仄。平平平仄。仄仄仄、平平平仄。平仄平、仄仄平平，仄仄平平仄。平仄平平平仄。仄仄平仄仄，平平仄仄。平平平仄。平平仄、平仄平平仄仄。平平仄仄。仄仄仄、仄平平仄。仄仄平、平仄平平，仄仄平平仄。,0,50,50,100,"[4, 4, 5, 4, 3, 6, 4, 3, 4, 3, 4, 5, 6, 5, 4, 4, 3, 6, 4, 3, 4, 3, 4, 5]"
解语花 ,施岳,平平仄仄，仄仄平平，平平仄平仄。仄平平仄。平平仄，仄仄仄平平仄。平平仄仄。平平仄、平平仄仄。平仄仄，平仄平平，平仄平平仄。仄仄平平仄仄。仄平平仄仄，仄仄平仄。仄平平仄。平平仄，仄仄仄平平仄。平平仄仄。平平仄、平平平仄。仄仄平、仄仄平平，仄仄仄。,0,47,51,98,"[4, 4, 5, 4, 3, 6, 4, 3, 4, 3, 4, 5, 6, 5, 4, 4, 3, 6, 4, 3, 4, 3, 4, 3]"
解语花 ,周密,平平仄仄，仄仄平平，平平仄平仄仄。仄仄平平，仄平平、平仄仄平平仄。平平仄仄，平仄仄、平平仄仄。仄仄仄平平仄仄，平仄平平仄。平平平仄仄仄，平仄仄平，平仄仄平仄。仄仄平平，仄平平、平仄仄平平仄。平平仄仄。平仄平平平仄仄。仄仄仄平平仄仄，平仄平平仄。,0,49,52,101,"[4, 4, 6, 4, 3, 6, 4, 3, 4, 7, 5, 6, 4, 5, 4, 3, 6, 4, 7, 7, 5]"
绕佛阁 ,周邦彦,仄平仄仄。平仄仄仄，平仄平仄。平仄平仄。仄平仄仄、平平仄平仄。仄平仄仄。平仄仄仄，平仄平仄。平仄平仄。仄平平仄，平平仄平仄。仄仄仄平仄，仄仄平平平仄仄。平仄仄平、平平平仄仄。仄仄仄平平，平仄平仄。仄平平仄。仄仄仄平平，平仄平仄。仄平平、仄平平仄。,0,44,56,100,"[4, 4, 4, 4, 4, 5, 4, 4, 4, 4, 4, 5, 5, 7, 4, 5, 5, 4, 4, 5, 4, 3, 4]"
渡江云 ,周邦彦,平平平仄仄，仄平仄仄，仄仄仄平平。仄平平仄仄，仄仄平平，仄仄仄平平。平平仄仄，仄仄仄、平仄平平。平仄平、仄平平仄，仄仄仄平平。平平。平平平仄，仄仄平平，仄平平仄仄。平仄平、平平平仄，平仄平平。平平仄仄平平仄，仄仄仄、平仄平平。平仄仄、平平仄仄平平。,0,52,48,100,"[5, 4, 5, 5, 4, 5, 4, 3, 4, 3, 4, 5, 2, 4, 4, 5, 3, 4, 4, 7, 3, 4, 3, 6]"
渡江云 ,陈允平,平平平仄仄，平平仄仄，仄仄仄平平。仄平平平仄，平仄平平，仄仄仄平平。平平平仄，仄平平、仄仄平平。平仄平、仄平平仄，平仄仄平平。平平。平平平仄，仄仄平平，仄仄仄平平。仄平平、平平平仄，平仄平平。平平仄仄平平仄，平仄仄、平仄平平。平仄仄、平平仄仄平平。,0,59,41,100,"[5, 4, 5, 5, 4, 5, 4, 3, 4, 3, 4, 5, 2, 4, 4, 5, 3, 4, 4, 7, 3, 4, 3, 6]"
渡江云 ,陈允平,平平平仄仄，仄平仄仄，平仄仄平仄。仄平平仄仄，仄仄平平，平仄仄平仄。平平仄仄，仄仄仄平平平仄。平仄平、平平仄仄，仄平平平仄。平仄。平平仄仄，仄仄平平，仄平平平仄。平仄仄、仄平平仄，仄平平仄。平平仄仄平平仄，仄仄平、平平平仄。平仄仄、平平仄平平仄。,0,50,50,100,"[5, 4, 5, 5, 4, 5, 4, 7, 3, 4, 5, 2, 4, 4, 5, 3, 4, 4, 7, 3, 4, 3, 6]"
腊梅香 ,吴师益,仄仄平平，仄仄仄平平，仄平仄仄。平仄平平仄，仄仄平平仄，平平平仄。仄仄平平，平仄仄、仄平平仄。仄仄平平，平平仄仄，仄平平仄。平仄仄平平，仄平平仄仄，仄仄平仄。仄仄平平仄，平仄仄、平平仄平仄。仄仄平平，平仄仄、平平平仄。仄仄平平，平平仄仄，平仄平仄。,0,48,52,100,"[4, 5, 4, 5, 5, 4, 4, 3, 4, 4, 4, 4, 5, 5, 4, 5, 3, 5, 4, 3, 4, 4, 4, 4]"
腊梅香 ,无名氏,仄仄平平。仄平平，平仄仄仄平平。仄仄平平，仄仄仄平，仄仄仄仄平平。仄仄平平。仄平仄、平仄平平。仄仄平平，平平仄仄，仄仄平平。平仄仄平平。仄平平，仄平仄仄平平。仄仄平平，平仄仄仄，平仄平仄平平。仄仄平平。平平仄、仄仄平平。仄平平仄，平平仄仄，平仄平平。,0,52,49,101,"[4, 3, 6, 4, 4, 6, 4, 3, 4, 4, 4, 4, 5, 3, 6, 4, 4, 6, 4, 3, 4, 4, 4, 4]"
大椿 ,曹勛,平仄平平，平平仄平，平仄平平平仄。平仄仄平仄，仄仄平平仄。平仄平平平仄仄，仄仄仄、平仄平仄。平平仄仄仄平，仄仄平平平仄。平平仄仄平仄平，仄仄仄平，仄仄平仄。仄仄平平仄，仄平平仄仄。平平平仄平平仄，仄平平、平平平仄。仄仄平平，平平平、仄平平仄。,0,53,47,100,"[4, 4, 6, 5, 5, 7, 3, 4, 6, 6, 7, 4, 4, 5, 5, 7, 3, 4, 4, 3, 4]"
八音谐 ,曹勛,平仄仄平平，平仄平平仄，平平平仄。仄仄仄平仄，仄平平平仄。平仄仄仄平平，仄仄仄、平平平仄仄。仄仄仄、仄平平仄仄，平平平仄。仄仄平平仄仄平，仄仄仄平仄，仄平平仄。平仄仄平平，仄平平平仄。仄平平仄平平，仄仄仄、仄平平仄。仄仄仄平平，仄仄仄、平平仄。,0,46,54,100,"[5, 5, 4, 5, 5, 6, 3, 5, 3, 5, 4, 7, 5, 4, 5, 5, 6, 3, 4, 5, 3, 3]"
绛都春 ,吴文英,平平仄仄。仄仄仄仄平，平平平仄。仄仄仄平，平仄平平平平仄。平平平仄平平仄。仄平仄、平平平仄。仄平平仄，平平仄仄，仄平平仄。平仄。平平仄仄，仄平仄、仄仄仄平平仄。仄仄仄平，平仄平平平平仄。平平平仄平平仄。仄平仄、平平仄仄。仄平平仄平平，仄平仄仄。,0,52,48,100,"[4, 5, 4, 4, 7, 7, 3, 4, 4, 4, 4, 2, 4, 3, 6, 4, 7, 7, 3, 4, 6, 4]"
绛都春 ,赵彦端,平平平仄。仄仄仄、仄仄平平平仄。仄仄平平，平平平仄平平仄。仄平平仄平平仄。仄仄仄、仄平平仄。仄平平仄，仄仄平平，仄平平仄。仄仄平平仄仄，仄仄仄平平，仄平平仄。仄仄平平，仄仄平平平仄仄。仄平平仄平平仄。仄仄仄、平平平仄。仄平仄仄平平，仄平仄仄。,0,47,53,100,"[4, 3, 6, 4, 7, 7, 3, 4, 4, 4, 4, 6, 5, 4, 4, 7, 7, 3, 4, 6, 4]"
绛都春 ,蒋捷,平平仄仄。仄平仄仄仄，平平平仄。仄仄仄平，仄仄平平平平仄。平平仄仄平平仄。仄仄仄、平平平仄。仄平平仄，平平仄仄，仄平平仄。仄仄。平平仄仄，仄仄仄仄仄，平平平仄。仄仄仄平，仄仄平平平平仄。平平仄仄平平仄。仄仄仄、平平平仄。平平仄仄平平，仄平仄仄。,0,46,54,100,"[4, 5, 4, 4, 7, 7, 3, 4, 4, 4, 4, 2, 4, 5, 4, 4, 7, 7, 3, 4, 6, 4]"
绛都春 ,刘镇,平平仄仄，仄平仄仄平，平平平仄。仄仄仄仄，仄仄平平平平仄。平平仄仄平平仄。仄仄仄、平平平仄。仄平平仄，平平仄仄，仄平平仄。平仄平平仄仄，仄平平仄仄，平平平仄。仄仄平平，平仄平平平平仄。平平平仄平平仄。仄仄仄、平平平仄。仄平平仄。平仄仄平仄仄。,0,51,49,100,"[4, 5, 4, 4, 7, 7, 3, 4, 4, 4, 4, 6, 5, 4, 4, 7, 7, 3, 4, 4, 6]"
绛都春 ,无名氏,平平仄仄。仄平平仄仄，平平平仄。平仄仄平，平仄平平仄平仄。平平平仄平平仄。仄仄仄、平平平仄。仄平平仄，平平仄仄，仄平平仄。仄仄平平平仄。仄平仄仄平，平平平仄。仄仄仄平，仄平平平平平仄。平平仄仄平平仄。仄仄仄、平平平仄。仄仄平仄平平，仄平仄仄。,0,52,48,100,"[4, 5, 4, 4, 7, 7, 3, 4, 4, 4, 4, 6, 5, 4, 4, 7, 7, 3, 4, 6, 4]"
绛都春 ,张榘,平平仄仄。仄平仄仄平，平平平仄。仄仄仄平，仄仄平平平平仄。平平平仄平平仄。仄仄平平平仄。仄平平仄，平平仄仄，仄平平仄。平仄。平平仄仄，仄平仄、仄仄平平平仄。仄仄仄平，平仄平平平平仄。平平平仄平平仄。仄仄平平平仄。仄平平仄平平，仄平仄仄。,0,52,46,98,"[4, 5, 4, 4, 7, 7, 6, 4, 4, 4, 2, 4, 3, 6, 4, 7, 7, 6, 6, 4]"
绛都春 ,京镗,平平仄仄。仄仄仄平仄，平平平仄。仄仄平平，仄仄平平平平仄。仄平平仄平平仄。平仄仄平平仄。仄平平仄，平平仄仄，仄平平仄。平仄。平平仄仄，平仄仄仄，平平平仄。仄仄仄平，仄仄平平平平仄。平平仄仄平平仄。仄仄仄、平平平仄。平平仄仄平平，仄平仄仄。,0,49,49,98,"[4, 5, 4, 4, 7, 7, 6, 4, 4, 4, 2, 4, 4, 4, 4, 7, 7, 3, 4, 6, 4]"
绛都春 ,陈允平,平平仄仄，仄仄平仄仄，仄仄平平。仄仄仄平，平平平仄仄平平。平平仄仄平平仄。仄平平仄平平。仄平平仄，平平仄仄，仄仄平平。仄仄平平仄仄，仄平平仄仄，仄仄平平。仄仄仄平，平平平仄仄平平。平平仄仄平平仄。仄平平仄平平。仄平平仄，平平仄仄仄平。,0,50,48,98,"[4, 5, 4, 4, 7, 7, 6, 4, 4, 4, 6, 5, 4, 4, 7, 7, 6, 4, 6]"
琵琶仙 ,姜夔,平仄平平，仄平仄、仄仄平平平仄。平仄平仄平平，平平仄平仄。平仄仄、平平仄仄，仄平仄、仄平平仄。仄仄平平，平平仄仄，平仄平仄。仄平仄、平仄平平，仄平仄、平平仄平仄。平仄仄平平仄，仄平平平仄。平仄仄、平平仄仄，仄仄平、仄仄平仄。仄仄平仄平平，仄平平仄。,0,50,50,100,"[4, 3, 6, 6, 5, 3, 4, 3, 4, 4, 4, 4, 3, 4, 3, 5, 6, 5, 3, 4, 3, 4, 6, 4]"
换巢鸾凤 ,史达祖,平仄平平。仄平平仄仄，仄仄平平。仄平平仄仄，仄仄仄平平。平平平仄仄平平。仄平仄平平平仄平。平平仄，仄仄仄、仄平平仄。平仄。平仄仄。平仄仄平，平仄平平仄。仄仄平平，仄平平仄，平仄平平平仄。平仄平平仄平平，仄平平仄平平仄。平平平，仄平平、仄仄平仄。,0,55,45,100,"[4, 5, 4, 5, 5, 7, 8, 3, 3, 4, 2, 3, 4, 5, 4, 4, 6, 7, 7, 3, 3, 4]"
东风第一枝 ,史达祖,仄仄平平，平平仄仄，平平仄仄平仄。仄平平仄平平，仄仄仄平仄仄。平平仄仄，仄仄仄、平平平仄。仄仄仄、仄仄平平，仄仄仄平平仄。平仄仄、仄平仄仄。平仄仄、仄平平仄。仄平平仄平平，仄仄仄平仄仄。平平平仄，仄仄仄、平平平仄。仄仄仄、仄仄平平，仄仄仄平平仄。,0,41,59,100,"[4, 4, 6, 6, 6, 4, 3, 4, 3, 4, 6, 3, 4, 3, 4, 6, 6, 4, 3, 4, 3, 4, 6]"
东风第一枝 ,吴文英,平仄平平，平平平仄。平平仄仄仄仄。仄平平仄平平，仄仄仄平仄仄。平平仄仄。仄仄仄、平平仄仄。仄仄仄、平仄平平，仄仄仄平平仄。平仄平、平仄仄仄。平仄仄、仄平平仄。仄平平仄平平，仄仄仄平仄仄。仄平平仄。仄仄仄、仄平平仄。仄仄仄平平平平，仄仄仄仄平仄。,0,42,58,100,"[4, 4, 6, 6, 6, 4, 3, 4, 3, 4, 6, 3, 4, 3, 4, 6, 6, 4, 3, 4, 7, 6]"
东风第一枝 ,无名氏,仄仄平平，平平仄仄，平平平仄平仄。仄平平仄平平，仄仄仄平平仄。平平平仄，仄仄平、仄平平仄。仄仄仄、平仄平平，仄仄仄平平仄。仄仄仄、仄仄仄平，平仄仄、仄平仄仄。仄平平仄平平，仄仄仄平仄仄。平平平仄，仄仄仄、平平平仄。仄仄仄、平仄平平，仄仄仄平平仄。,0,44,56,100,"[4, 4, 6, 6, 6, 4, 3, 4, 3, 4, 6, 3, 4, 3, 4, 6, 6, 4, 3, 4, 3, 4, 6]"
东风第一枝 ,无名氏,平仄平平，平平仄仄。平平仄平平仄。仄仄平平，平平仄仄，仄平仄仄。平平仄仄，仄仄仄、平平平仄。仄仄平、仄仄平平，仄仄仄平平仄。平仄仄、仄平平仄，平仄仄、仄平平仄，仄平平仄平平，仄平仄平仄仄。平平仄仄，仄平平、平平平仄。仄仄仄、仄仄平平，仄平仄平平仄。,0,48,52,100,"[4, 4, 6, 4, 4, 4, 4, 3, 4, 3, 4, 6, 3, 4, 3, 4, 6, 6, 4, 3, 4, 3, 4, 6]"
高阳台 ,刘镇,平仄平平，平平仄仄，平平仄仄平平。仄仄平平，仄平仄仄平平。平平仄仄平平仄，仄仄平、仄仄平平。仄平平，仄仄平平，仄仄平平。平平仄仄平平仄，仄平平平仄，平仄平平。仄仄平平，仄平平仄平平。仄平仄仄平平仄，仄平平、仄仄平平。仄平平，平仄平平，平仄平平。,0,58,42,100,"[4, 4, 6, 4, 6, 7, 3, 4, 3, 4, 4, 7, 5, 4, 4, 6, 7, 3, 4, 3, 4, 4]"
高阳台 ,蒋捷,仄仄平平，平平仄仄，平平仄仄平平。平仄平平，平平仄仄平平。平平仄仄平平仄，仄仄平、平仄平平。仄平平，平仄平平，平仄平平。平平仄仄平平。仄仄平平仄仄，平仄平平。仄仄平平，平平平仄平平。平平仄仄平平仄，仄仄平、仄仄平平。仄平平，平仄平平，仄仄平平。,0,61,39,100,"[4, 4, 6, 4, 6, 7, 3, 4, 3, 4, 4, 6, 6, 4, 4, 6, 7, 3, 4, 3, 4, 4]"
高阳台 ,张炎,仄仄平平，平平仄仄，仄平平仄平平。平仄平平，仄平仄仄平平。平平仄仄平平仄，仄平平、平仄平平。仄平平。仄仄平平，仄仄平平。平平仄仄平平仄，仄平平平仄，仄仄平平。仄仄平平，平平仄仄平平。平平仄仄平平仄，仄平平、仄仄平平。仄平平。仄仄平平，仄仄平平。,0,58,42,100,"[4, 4, 6, 4, 6, 7, 3, 4, 3, 4, 4, 7, 5, 4, 4, 6, 7, 3, 4, 3, 4, 4]"
春夏两相期 ,蒋捷,仄平平、仄平平仄。平平仄仄平仄。仄仄平平，平仄仄平平仄。平平平仄仄平平，仄仄平平平平仄。仄仄平平，平平平仄，仄平平仄。平平仄仄平仄。仄仄平平仄，仄平平仄。仄仄平平，平仄仄平平仄。平平仄仄仄平平，仄仄平平平平仄。仄仄平平，仄仄平平，仄平平仄。,0,54,46,100,"[3, 4, 6, 4, 6, 7, 7, 4, 4, 4, 6, 5, 4, 4, 6, 7, 7, 4, 4, 4]"
垂杨 ,陈允平,平平仄仄。仄仄平仄仄，仄平平仄。仄仄平平，仄平平仄平平仄。平平平仄平平仄。仄平仄、仄平平仄。仄平平、平仄平平，仄仄平平仄。平仄平平仄仄。仄平仄仄平，仄平平仄。仄仄平平，仄平平仄平平仄。平平仄仄平仄仄。仄仄仄、平平仄仄。仄平平、仄仄平平，平仄仄。,0,49,51,100,"[4, 5, 4, 4, 7, 7, 3, 4, 3, 4, 5, 6, 5, 4, 4, 7, 7, 3, 4, 3, 4, 3]"
垂杨 ,白朴,平平仄仄。仄平平仄仄，平平平仄。仄仄平平仄仄，平仄平平仄。仄平平仄平平仄，仄平仄、平平平仄。仄平平、平仄仄平，平仄平平仄。仄仄平平仄仄。仄平平仄仄，平平平仄。仄仄平平仄仄，平仄平平仄。仄平平仄平平仄，仄平仄、平平平仄。仄平平、仄平平平仄。,0,52,46,98,"[4, 5, 4, 6, 5, 7, 3, 4, 3, 4, 5, 6, 5, 4, 6, 5, 7, 3, 4, 3, 5]"
采绿吟 ,周密,仄仄平平仄，仄仄仄、仄仄平平。平平仄仄，仄平平仄，平仄平平。仄平平仄仄，平平仄、仄平仄仄平平。仄平平，平平仄，平平平仄平仄。平仄仄平平，平平仄、平平平仄平仄。仄仄仄平平，仄仄仄平平。仄平平、平仄平平，平平仄、平平仄平平。平平仄，平仄仄平，平平仄平。,0,57,43,100,"[5, 3, 4, 4, 4, 4, 5, 3, 6, 3, 3, 6, 5, 3, 6, 5, 5, 3, 4, 3, 5, 3, 4, 4]"
长寿仙 ,赵孟頫,仄仄平平。仄仄仄平平，平仄平平。仄平平仄仄，仄仄仄平平。仄仄平平仄仄。仄平平仄平平仄。仄仄仄平，仄平平仄仄，仄仄平平。仄仄平平平平。仄仄仄平平，平平平仄。仄平仄仄平，仄仄仄平平。仄仄平平仄仄。仄平平仄平平仄。平仄仄平，仄平平、仄仄平仄平平。,0,48,52,100,"[4, 5, 4, 5, 5, 6, 7, 4, 5, 4, 6, 5, 4, 5, 5, 6, 7, 4, 3, 6]"
雪夜渔舟 ,虚靖真人,仄平仄。仄仄仄平平，仄平平仄。平仄平平，平平仄仄，平仄仄平平仄。平平平仄。仄仄仄、仄平平仄。仄平平仄，平平平仄，仄平平仄。仄平平仄仄。仄平平平仄，仄平平仄。仄仄平平，平平仄仄，仄仄仄平平仄。仄平仄仄。仄仄仄、仄平平仄。平平仄仄，平平平仄，仄平平仄。,0,48,52,100,"[3, 5, 4, 4, 4, 6, 4, 3, 4, 4, 4, 4, 5, 5, 4, 4, 4, 6, 4, 3, 4, 4, 4, 4]"
惜寒梅 ,无名氏,仄仄平平，仄平平、仄仄仄平平仄。仄仄平平，仄仄平平仄仄。仄平平仄仄平仄。平平仄、平平仄仄。平平平仄，仄仄平平，仄平平仄。平平仄仄仄仄。仄平平仄平，仄平仄仄。平仄平平，仄仄平平仄仄。平平平仄仄平仄。仄仄仄、仄平仄仄。仄平平仄，平平仄仄，仄仄平仄。,0,45,55,100,"[4, 3, 6, 4, 6, 7, 3, 4, 4, 4, 4, 6, 5, 4, 4, 6, 7, 3, 4, 4, 4, 4]"
惜花春起早慢 ,无名氏,仄平平，仄平平、仄仄仄仄平仄。平平仄平平仄仄仄，仄仄平仄平仄。平平仄仄，平仄平、平仄平仄。仄平平、仄仄仄平平，平仄平仄。平平仄仄平平，平仄仄平平，仄仄平仄。平平仄平仄仄，仄平仄、仄平平仄。平平仄仄，平仄平、平平平仄。仄平平、仄平平，仄仄平平平仄。,0,51,49,100,"[3, 3, 6, 8, 6, 4, 3, 4, 3, 5, 4, 6, 5, 4, 6, 3, 4, 4, 3, 4, 3, 3, 6]"
凤归云 ,柳永,仄平平，仄平仄仄仄平平。仄仄仄平，平仄仄平平。平仄平平，平仄仄仄，仄仄仄平平。仄仄仄平平仄，平平平仄，仄平平仄平平。平平平仄，仄仄平平，平平仄仄，平仄平平，仄仄平平仄、仄平平。平仄平平，仄仄平仄，仄仄仄平平。仄仄仄平平仄，仄平平仄，仄平平仄平平。,0,52,49,101,"[3, 7, 4, 5, 4, 4, 5, 6, 4, 6, 4, 4, 4, 4, 5, 3, 4, 4, 5, 6, 4, 6]"
凤归云 ,赵以夫,仄平平，仄平仄仄仄平平。仄仄仄平。平仄仄平平。平仄平平，平仄仄仄，仄仄仄平平。仄仄仄平平仄，平平平仄，仄平平仄平平。仄平平仄，仄仄平平，仄平平仄，平仄平平，仄仄平平仄、仄平平。平仄平平，仄仄仄仄，仄仄仄平平。仄仄仄平平仄，仄平平仄，仄平平仄平平。,0,50,51,101,"[3, 7, 4, 5, 4, 4, 5, 6, 4, 6, 4, 4, 4, 4, 5, 3, 4, 4, 5, 6, 4, 6]"
凤归云 ,柳永,仄仄仄、平仄平平，平平仄仄，仄仄平平，平仄平平，仄平平仄、仄平平仄。仄平平、仄平仄平平，仄仄平仄。仄仄平、仄仄平仄仄。平仄平仄平平，仄平平仄。仄仄仄、仄仄平平，仄平仄仄。平仄仄平，仄仄平平，仄仄平平，仄平平仄、仄平平仄。仄平平仄，仄仄平平，平平平仄。仄平仄、仄仄仄平平仄。仄仄仄仄平平，仄平平仄。,0,55,64,119,"[3, 4, 4, 4, 4, 4, 4, 3, 5, 4, 3, 5, 6, 4, 3, 4, 4, 4, 4, 4, 4, 4, 4, 4, 4, 3, 6, 6, 4]"
木兰花慢 ,柳永,仄平平仄仄，仄平仄、仄平平。仄仄仄平平，平平仄仄，平仄平平。平平。仄平仄仄，仄平平仄仄仄平平。平仄平平仄仄，仄平仄仄平平。平平。仄仄仄平。平仄仄、仄平平。仄仄平、仄仄平平仄仄，平仄平平。平平。仄平仄仄，仄平平仄仄仄平平。平仄平平仄仄，仄平仄仄平平。,0,50,51,101,"[5, 3, 3, 5, 4, 4, 2, 4, 8, 6, 6, 2, 4, 3, 3, 3, 6, 4, 2, 4, 8, 6, 6]"
木兰花慢 ,柳永,仄平平仄仄，仄平仄、仄平平。仄仄仄平平，平平仄仄，平仄平平。平平。仄平仄仄，仄平平仄仄仄平平。平仄平平仄仄，仄平仄仄平平。平平。仄仄平平，平仄仄、仄平平。仄仄仄平平，平平仄仄，平仄平平。平平。仄平仄仄，仄平平仄仄仄平平。平仄平平仄仄，平平仄仄平平。,0,53,48,101,"[5, 3, 3, 5, 4, 4, 2, 4, 8, 6, 6, 2, 4, 3, 3, 5, 4, 4, 2, 4, 8, 6, 6]"
木兰花慢 ,蒋捷,仄平平仄仄，仄平仄、仄平平。仄仄仄平平，平平仄仄，仄仄平平。平平。仄平仄仄，仄平平仄仄仄平平。平仄平平仄仄，仄平平仄平平。平平。仄仄仄平平。仄仄仄平平。仄仄平仄仄，平平仄仄，平仄平平。平平。仄平仄仄，仄平平仄仄仄平平。仄仄平平仄仄，仄平仄仄平平。,0,49,52,101,"[5, 3, 3, 5, 4, 4, 2, 4, 8, 6, 6, 2, 5, 5, 5, 4, 4, 2, 4, 8, 6, 6]"
木兰花慢 ,曹勛,仄平平仄仄，仄平仄、仄平平。仄仄仄平平，平平仄仄，仄仄平平。平平。仄平仄仄，仄平平仄仄仄平平。平仄平平，仄平仄仄，仄仄平平。平平。仄仄仄平平。仄平仄平平。仄仄仄平平，平平仄仄，仄仄平平。平平。仄平仄仄，仄平平仄仄仄平平。仄仄平平仄仄，仄平仄仄平平。,0,49,52,101,"[5, 3, 3, 5, 4, 4, 2, 4, 8, 4, 4, 4, 2, 5, 5, 5, 4, 4, 2, 4, 8, 6, 6]"
木兰花慢 ,程垓,仄平平仄仄，仄仄仄、仄平平。仄仄仄平平，平平仄仄，平仄平平。平平仄平仄仄，仄平平仄仄仄平平。平仄平平仄仄，仄平平仄平平。平平仄仄仄平平。仄平仄平平。仄仄仄平平，平平仄仄，平仄平平。平平仄平平仄，仄平平平仄仄平平。平仄平平仄仄，仄平平仄平平。,0,55,46,101,"[5, 3, 3, 5, 4, 4, 6, 8, 6, 6, 7, 5, 5, 4, 4, 6, 8, 6, 6]"
木兰花慢 ,李芸子,仄平平仄仄，仄平仄、仄平平。仄仄仄平平，仄平平仄，仄仄平平。平平仄平仄仄，仄平平、仄仄仄平平。平仄平平仄仄，平平仄仄平平。平平。仄仄仄平平。仄仄仄平平。仄平平仄仄，平平仄仄，平仄平平。平平仄平仄仄，仄平平、平仄仄平平。仄仄平平仄仄，仄平仄仄平平。,0,51,50,101,"[5, 3, 3, 5, 4, 4, 6, 3, 5, 6, 6, 2, 5, 5, 5, 4, 4, 6, 3, 5, 6, 6]"
木兰花慢 ,严仁,平平平仄仄，仄平仄、仄平平。仄仄仄平平，平平仄仄，仄仄平平。平平仄、平仄仄，仄平平平仄仄平平。平仄仄平平仄，仄平平仄平平。平平仄仄仄平平。仄平仄平平。仄仄仄平平，平平平仄，仄仄平平。仄平平、平仄仄，仄平平、平仄仄平平。平仄平平仄仄，仄平平仄平平。,0,56,45,101,"[5, 3, 3, 5, 4, 4, 3, 3, 8, 6, 6, 7, 5, 5, 4, 4, 3, 3, 3, 5, 6, 6]"
木兰花慢 ,吕渭老,仄平平仄仄，仄平仄、仄平平。仄仄仄平平，平平仄仄，平仄平平。平平仄平仄仄，仄平平仄仄、仄平平。平仄平平仄仄，仄平平仄平平。平平。仄仄仄平平仄仄，仄平平。仄仄仄平平，平平仄仄，平仄平平。平平仄平仄仄，仄平平仄仄仄平平。平仄平平仄仄，仄平仄仄平平。,0,52,49,101,"[5, 3, 3, 5, 4, 4, 6, 5, 3, 6, 6, 2, 7, 3, 5, 4, 4, 6, 8, 6, 6]"
木兰花慢 ,刘应雄,平平平仄仄，仄平仄、仄平平。仄平仄平平，仄平平仄，仄仄平平。平平仄平平仄，仄仄平平仄仄平平。仄仄平平仄仄，平平平仄平平。仄平仄仄仄平平。仄平仄、仄平平。仄平仄平平，仄平平仄，仄仄平平。平平仄平平仄，仄仄平、平仄仄平平。仄仄仄平平仄，平平仄仄平平。,0,55,47,102,"[5, 3, 3, 5, 4, 4, 6, 8, 6, 6, 7, 3, 3, 5, 4, 4, 6, 3, 5, 6, 6]"
木兰花慢 ,曾觌,仄平平仄仄，仄平仄、仄平平。仄仄仄平平，平平仄仄，仄仄平平。平平仄平仄仄，平平平仄，仄仄平平。平仄平平仄仄，仄平平仄平平。平平仄仄仄平平。仄仄仄平平。仄仄仄平平，平平仄仄，平仄平平。平平仄平平仄，仄平平仄仄仄平平。仄仄平平平仄，仄平仄仄平平。,0,53,48,101,"[5, 3, 3, 5, 4, 4, 6, 4, 4, 6, 6, 7, 5, 5, 4, 4, 6, 8, 6, 6]"
木兰花慢 ,卢祖皋,平平平仄仄，仄平仄、仄平平。仄平仄平平，平平平仄，平仄平平。平平仄平仄仄，仄仄平平仄仄平平。仄仄平平仄仄，仄平平仄平平。平平仄仄平平。平仄仄平平。仄平平、仄仄平平仄仄，仄仄平平。平平平平仄仄，仄平平平仄仄平平。仄仄平平仄仄，仄平平仄平平。,0,56,44,100,"[5, 3, 3, 5, 4, 4, 6, 8, 6, 6, 6, 5, 3, 6, 4, 6, 8, 6, 6]"
木兰花慢 ,无名氏,仄平平仄仄，仄平平、仄仄仄平平。仄仄仄平平，仄平仄仄，仄仄平平。平平仄平仄仄，仄平平仄仄仄平平。平仄平平仄仄，仄平平仄平平。平平仄仄平平，平仄仄、仄平平。仄仄仄平平。平平仄仄，仄仄平平。平平仄平仄仄，仄仄平平仄仄平平。仄仄仄平平仄，仄平仄仄平平。,0,50,53,103,"[5, 3, 5, 5, 4, 4, 6, 8, 6, 6, 6, 3, 3, 5, 4, 4, 6, 8, 6, 6]"
彩云归 ,柳永,平平仄仄仄平平。仄平平、仄仄平平。平仄平仄仄平平仄，平仄仄、仄仄平平。仄平仄、仄平平仄，仄平平仄平。仄仄仄、仄平平仄，仄仄平平。平平。平平仄仄，仄平平、仄仄平平。仄平仄仄，平仄平仄，仄仄平平。仄仄平、平平仄仄，仄仄平仄平平。平平仄，平仄平平仄仄平平。,0,51,50,101,"[7, 3, 4, 8, 3, 4, 3, 4, 5, 3, 4, 4, 2, 4, 3, 4, 4, 4, 4, 3, 4, 6, 3, 8]"
满朝欢 ,柳永,平仄平平，仄平平仄，平平仄仄平仄。仄仄平平仄仄，平仄平仄。平平仄仄，仄平仄仄平，平平平仄。仄仄仄平，平平仄仄，平平平仄。平仄平平仄仄，仄仄平平，仄仄平平平仄。仄平仄仄，仄仄平平平仄。平仄平平，仄平平仄，仄仄平平仄仄。仄仄仄仄平平，平仄平平平仄。,0,50,51,101,"[4, 4, 6, 6, 4, 4, 5, 4, 4, 4, 4, 6, 4, 6, 4, 6, 4, 4, 6, 6, 6]"
满朝欢 ,李刘,仄仄平平，仄平平，平仄平仄平仄。仄仄平平，仄仄仄平平仄。平仄仄平平仄。平仄仄、平平平仄。平平仄、仄仄平平，仄平平仄仄仄。平仄仄平仄仄。仄平平仄仄，仄平平仄。仄仄平平，平仄仄平平仄。仄仄仄平仄仄。仄仄仄、仄平平仄。平平仄、仄仄平平，仄平平平平仄。,0,46,54,100,"[4, 3, 6, 4, 6, 6, 3, 4, 3, 4, 6, 6, 5, 4, 4, 6, 6, 3, 4, 3, 4, 6]"
桂枝香 ,王安石,平平仄仄。仄仄仄仄平，平仄平仄。平仄平平仄仄，仄平平仄。平平仄仄平平仄，仄平平、仄平平仄。仄平平仄，平平仄仄，仄平平仄。仄仄仄、平平仄仄。仄平仄平平，平仄平仄。平仄平平，仄仄仄平平仄。仄平仄仄平平仄，仄平平平仄平仄。仄平平仄，平平平仄，仄平平仄。,0,50,51,101,"[4, 5, 4, 6, 4, 7, 3, 4, 4, 4, 4, 3, 4, 5, 4, 4, 6, 7, 7, 4, 4, 4]"
桂枝香 ,陈亮,平平仄仄。仄仄仄平平，平平平仄。仄仄平平，平仄仄平平仄。仄平仄仄平平仄，仄平平、仄平平仄。仄平平仄，仄平平仄，仄平平仄。仄平平、平平仄仄。仄仄仄平平，仄仄平仄。仄仄平平，仄仄仄平平仄。平平仄仄平平仄，仄平平、平平平仄。仄平仄仄，仄平仄仄，仄平平仄。,0,49,52,101,"[4, 5, 4, 4, 6, 7, 3, 4, 4, 4, 4, 3, 4, 5, 4, 4, 6, 7, 3, 4, 4, 4, 4]"
桂枝香 ,张辑,平平仄仄。仄仄仄平平，仄平平仄。仄仄平平，仄仄仄平平仄。平平仄仄平平仄。仄平平、仄平平仄。仄平平仄，仄平仄仄，仄平平仄。仄平仄、平平仄仄。仄仄平平仄，仄平平仄。仄仄平平，平仄仄平平仄。平平平仄平平仄。仄平平、仄平平仄。仄平仄仄，平平仄仄，仄平平仄。,0,49,52,101,"[4, 5, 4, 4, 6, 7, 3, 4, 4, 4, 4, 3, 4, 5, 4, 4, 6, 7, 3, 4, 4, 4, 4]"
桂枝香 ,张炎,平平仄仄。仄仄平、仄平仄仄平仄。仄仄平平，平仄仄平平仄。平平平仄平平仄，仄平平、平仄平仄。仄平平仄，平平仄仄，仄平平仄。仄平仄、平平仄仄。仄平仄平平，平仄平仄。仄仄平平，平仄仄平平仄。平平仄仄平平仄，仄平平、仄平平仄。仄平平仄，平平仄仄，仄平平仄。,0,52,49,101,"[4, 3, 6, 4, 6, 7, 3, 4, 4, 4, 4, 3, 4, 5, 4, 4, 6, 7, 3, 4, 4, 4, 4]"
桂枝香 ,周密,平平仄仄。仄平仄仄平，平仄平仄。平仄平平，仄仄仄平仄仄。平平仄仄平平仄，仄平平、平仄平仄。仄平平仄，平平仄仄，仄平平仄。仄仄平平仄仄。仄仄仄平平，平仄平仄。仄仄平平，平仄仄平平仄。仄平平仄平平仄，仄平平、平仄平仄。仄平平仄，平平仄仄，仄平平仄。,0,49,51,100,"[4, 5, 4, 4, 6, 7, 3, 4, 4, 4, 4, 6, 5, 4, 4, 6, 7, 3, 4, 4, 4, 4]"
桂枝香 ,黄裳,仄平仄仄。仄仄仄、仄平平，仄平仄。平仄平平仄仄，仄平平仄。仄平平仄平平仄，仄平平、平平平仄。仄平平仄，平平仄仄，仄平平仄。仄仄仄、平平仄仄。仄平仄平平，平仄平仄。平仄平平仄仄，仄平平仄。仄平仄仄平平仄，仄平平、平仄平仄。仄平平仄平平，平平仄平平仄。,0,51,50,101,"[4, 3, 3, 3, 6, 4, 7, 3, 4, 4, 4, 4, 3, 4, 5, 4, 6, 4, 7, 3, 4, 6, 6]"
锦堂春慢 ,司马光,平仄平平，平平仄仄，平平仄仄平平。仄仄平平平仄，仄仄平平。仄仄平平平仄，仄仄平仄平平。仄仄平仄仄，仄仄平平，平仄平平。仄平平平平仄，仄平平仄仄，仄仄平平。平仄平平平仄，仄仄平平。仄仄平平仄仄，仄仄仄、平仄平平。仄仄平平仄仄，平仄平平，仄仄平平。,0,52,49,101,"[4, 4, 6, 6, 4, 6, 6, 5, 4, 4, 6, 5, 4, 6, 4, 6, 3, 4, 6, 4, 4]"
锦堂春慢 ,黄裳,平仄平平，平平仄仄，平平仄仄平平。仄仄平平仄仄，仄仄平平。平仄仄平平仄，仄平平仄平平。仄仄平平仄仄，平仄平平，仄仄平平。仄平平仄平仄，仄平平仄仄，平仄平平。平仄平平仄仄，平仄平平。仄仄平平仄仄，仄平平仄平平。仄仄平平仄仄，仄仄平平，仄仄平平。,0,53,48,101,"[4, 4, 6, 6, 4, 6, 6, 6, 4, 4, 6, 5, 4, 6, 4, 6, 6, 6, 4, 4]"
锦堂春慢 ,无名氏,仄仄平平，平平仄仄，平平平仄平平。平仄平平平仄，仄仄平平。仄仄平平仄仄，仄平平、平仄平平。仄仄平平仄，仄仄平平，仄仄平平。仄平平仄平仄，仄平平仄仄，平仄平平。平仄平平平仄，平仄平平。仄仄平平平仄，仄仄平、仄仄平平。仄平仄平仄，仄仄平平，仄仄平平。,0,55,46,101,"[4, 4, 6, 6, 4, 6, 3, 4, 5, 4, 4, 6, 5, 4, 6, 4, 6, 3, 4, 5, 4, 4]"
锦堂春慢 ,葛立方,仄仄平平，平平仄仄，平平平仄平平。仄平平平仄，仄仄平平。平仄平平仄仄，平平仄仄平平。仄仄平平仄仄，平仄平平，平仄平平。平仄平平仄仄，仄平平仄仄，平仄平平。仄平平仄仄，仄仄平平。仄仄平平平仄，平平仄仄平平。仄仄平平平仄，仄仄平平，仄仄平平。,0,55,44,99,"[4, 4, 6, 5, 4, 6, 6, 6, 4, 4, 6, 5, 4, 5, 4, 6, 6, 6, 4, 4]"
锦堂春慢 ,王梦应,仄仄平平，平平仄仄，平平仄仄平平。仄平平仄仄，仄仄平平。仄仄平平仄仄，平平仄仄平平。仄平平仄仄，平仄平平，仄仄平平。仄平平仄平仄，仄平平仄仄，仄仄平平。仄仄仄平仄仄，仄仄平平。仄仄平平仄仄，平平仄仄平平。仄平平仄仄，仄仄平平，仄仄平平。,0,47,51,98,"[4, 4, 6, 5, 4, 6, 6, 5, 4, 4, 6, 5, 4, 6, 4, 6, 6, 5, 4, 4]"
喜朝天 ,张先,仄平平。仄平仄平平，仄仄平平。仄仄平仄，仄平平仄，平仄平平。平仄平平平仄，仄平平仄仄仄平平。平仄仄、平平仄仄，平仄平平。平平仄仄平仄，仄仄平平仄，平仄平平。仄仄平仄，仄仄仄仄，仄仄平平。平仄平平仄仄，仄平平、平仄仄平平。平仄仄、平平平仄，平仄平平。,0,53,48,101,"[3, 5, 4, 4, 4, 4, 6, 8, 3, 4, 4, 6, 5, 4, 4, 4, 4, 6, 3, 5, 3, 4, 4]"
喜朝天 ,晁补之,仄平平。仄平仄平平，仄仄平平。仄仄平仄，仄平平仄仄，平仄平平。平仄平平仄仄，仄平平、平平仄平平。平仄仄、仄平平仄，平仄平平。平平仄仄平仄，仄仄平平仄，平仄平平。仄仄平仄，仄平平仄仄，仄仄平平。仄仄平平仄仄，仄平仄、平平仄平平。平平仄、平平平仄，仄仄平平。,0,55,48,103,"[3, 5, 4, 4, 5, 4, 6, 3, 5, 3, 4, 4, 6, 5, 4, 4, 5, 4, 6, 3, 5, 3, 4, 4]"
剪牡丹 ,张先,仄仄平平，平平平仄，仄仄平仄平仄。平仄平平，仄平仄平仄。平平仄仄平平，平平仄仄，仄平仄仄平仄。平仄平平，仄平仄平仄。仄平平仄平仄。仄仄平、仄平平仄。平仄仄平平，平仄仄平平仄平仄。仄平仄仄仄平仄。仄仄平仄，平仄仄平仄。平仄。仄仄平仄仄，平平仄仄。,0,47,54,101,"[4, 4, 6, 4, 5, 6, 4, 6, 4, 5, 6, 3, 4, 5, 8, 7, 4, 5, 2, 5, 4]"
剪牡丹 ,李致远,仄仄平平，平平仄仄，平平仄仄平仄。仄仄平平，仄仄仄平仄。平平仄仄平平，平平平仄，平平平仄。仄仄平平，仄仄平平仄。平平仄仄平平，平仄平、平平仄仄。仄仄仄、平平仄仄，平仄仄平仄仄。仄平平仄，仄仄平平，仄仄平平仄平仄。平平仄仄仄平，仄平平仄仄。,0,48,50,98,"[4, 4, 6, 4, 5, 6, 4, 4, 4, 5, 6, 3, 4, 3, 4, 6, 4, 4, 7, 6, 5]"
马家春慢 ,贺铸,平仄平平，仄平仄仄，仄仄平平平仄。仄仄平平，仄平仄平平平仄。平仄平平仄仄，仄平仄平平平仄。仄仄平平仄平平，仄仄平平仄。平平仄平平仄。仄平平仄仄，平仄平仄。仄仄平平，仄平平仄，平平平仄。平仄平平仄仄，仄仄仄、仄平平仄。仄仄仄平平，仄仄平平平仄。,0,51,50,101,"[4, 4, 6, 4, 7, 6, 7, 7, 5, 6, 5, 4, 4, 4, 4, 6, 3, 4, 5, 6]"
梅香慢 ,贺铸,平仄平平，仄仄仄平平，仄平平仄。仄仄平平仄，仄仄平平仄，仄平平仄。仄仄平平，平仄仄、平平平仄。仄仄平平，平平仄仄，仄平平仄。平仄仄平平，仄平平平仄，仄仄平仄。仄仄平平仄。仄仄平平仄，仄平平仄。仄仄平平，仄仄仄、平平平仄。仄仄平平，平平仄仄，仄平平仄。,0,49,52,101,"[4, 5, 4, 5, 5, 4, 4, 3, 4, 4, 4, 4, 5, 5, 4, 5, 5, 4, 4, 3, 4, 4, 4, 4]"
玉烛新 ,周邦彦,平平平仄仄。仄仄仄平平，仄平平仄。仄平仄仄，平平仄、仄仄平平平仄。平平仄仄，仄仄仄平平平仄。平仄仄、平仄平平，平平仄平平仄。平平仄仄平平，仄仄仄平平，仄平平仄。仄平仄仄。平仄仄、仄仄仄平平仄。平平仄仄。仄仄仄平平平仄。平仄仄、平仄平平，平平仄仄。,0,49,52,101,"[5, 5, 4, 4, 3, 6, 4, 7, 3, 4, 6, 6, 5, 4, 4, 3, 6, 4, 7, 3, 4, 4]"
玉烛新 ,杨无咎,平平平仄仄。仄仄仄平平，仄平平仄。平平仄仄。平平仄、仄仄平平平仄。仄平平仄。平仄仄、平平仄仄。平仄仄、仄仄平平，平平仄平平仄。平平仄仄平平，仄仄仄平平，仄平平仄。仄平平仄。平平仄、仄仄平平平仄。平平仄仄。平仄仄、平平平仄。平仄仄、平仄平平，平平仄仄。,0,53,48,101,"[5, 5, 4, 4, 3, 6, 4, 3, 4, 3, 4, 6, 6, 5, 4, 4, 3, 6, 4, 3, 4, 3, 4, 4]"
六花飞 ,曹勛,平平仄仄，仄平平仄，仄仄平平仄。仄仄平平，仄平平平仄。仄平平、平平仄仄，仄仄仄，平仄平平平平仄。仄平平、平仄仄平，平仄仄平仄。平平仄平仄，仄平平仄，仄仄平平仄。仄平平仄，仄平平平仄。仄仄仄平仄仄仄，仄仄仄，仄仄平平平平仄。仄平平平仄，仄平平仄仄。,0,48,53,101,"[4, 4, 5, 4, 5, 3, 4, 3, 7, 3, 4, 5, 5, 4, 5, 4, 5, 7, 3, 7, 5, 5]"
清风满桂楼 ,曹勛,平平仄仄。仄仄平平，平平仄平平仄。平仄仄仄平，平仄仄、平平仄平平仄。平平仄仄仄，仄平仄、平平平仄。平平仄、平平仄仄，仄平平仄。平平仄平仄。仄仄平平，平平仄平平仄。平仄仄平平，平仄仄、平平仄平平仄。平平仄仄仄。仄平仄、平平仄仄。平平仄，平仄平平仄仄。,0,54,47,101,"[4, 4, 6, 5, 3, 6, 5, 3, 4, 3, 4, 4, 5, 4, 6, 5, 3, 6, 5, 3, 4, 3, 6]"
映山红慢 ,元载,仄仄平平，仄仄仄、平平仄仄。仄仄仄平平，仄平仄仄，平平平仄。平平仄仄平平仄。仄平平仄平平仄。平仄仄平仄，平平仄仄平仄。平仄仄、平仄平平，平仄仄、平平平仄。平仄仄、仄平仄仄，仄仄平平平仄。平平仄仄平平仄，仄平平仄平平仄。仄平平仄。仄平仄、平平仄仄。,0,49,52,101,"[4, 3, 4, 5, 4, 4, 7, 7, 5, 6, 3, 4, 3, 4, 3, 4, 6, 7, 7, 4, 3, 4]"
真珠帘 ,陆游,平平仄仄平平仄。仄平平、仄仄平平平仄。仄仄平平，平仄仄平平仄。仄仄平平平仄仄，仄仄平、平平平仄。平仄。仄平平平仄，平平仄仄。仄仄。平平平仄。仄平平、仄仄平平平仄。仄仄仄平平，仄仄平平仄。平仄平平平仄仄，仄仄仄、平平平仄。平仄。仄平平平仄，仄平平仄。,0,52,49,101,"[7, 3, 6, 4, 6, 7, 3, 4, 2, 5, 4, 2, 4, 3, 6, 5, 5, 7, 3, 4, 2, 5, 4]"
真珠帘 ,周密,仄平平仄平平仄。平平仄，平仄平平平仄。平仄仄平平，仄仄平平仄。仄仄平平平仄仄，仄仄仄、平平平仄。平仄。仄平平仄仄，平平平仄。平仄。仄仄平平，仄平平仄仄，平平仄仄。仄仄仄平平，仄仄平平仄。仄仄平平平仄仄，仄仄仄仄平平仄。平仄。仄平平、平仄平平仄仄。,0,49,52,101,"[7, 3, 6, 5, 5, 7, 3, 4, 2, 5, 4, 2, 4, 5, 4, 5, 5, 7, 7, 2, 3, 6]"
真珠帘 ,张炎,平平仄仄平平仄。仄平平、仄仄平平平仄。平仄仄平平，仄仄平平仄。仄仄平平平仄仄，仄仄仄、仄平平仄。平仄。仄仄仄平平，平平平仄。平仄仄仄平平，仄平平仄仄，仄平仄仄。仄仄仄平平，仄仄平平仄。仄仄仄平平仄仄，仄仄仄、平平平仄。仄仄。仄平仄平平，仄平平仄。,0,45,56,101,"[7, 3, 6, 5, 5, 7, 3, 4, 2, 5, 4, 6, 5, 4, 5, 5, 7, 3, 4, 2, 5, 4]"
真珠帘 ,张炎,仄平仄仄平平仄，平平仄、仄仄平平平仄。平仄仄平平，仄平平平仄。仄仄平平平仄仄，仄仄仄、平平平仄。仄仄。仄平仄平平，平平平仄。平仄仄仄平平，仄平平、仄仄平平平仄。仄仄仄平平，仄平平平仄。仄仄平平平仄仄，仄仄仄平平平仄。平仄。仄平平仄仄，平平仄仄。,0,50,51,101,"[7, 3, 6, 5, 5, 7, 3, 4, 2, 5, 4, 6, 3, 6, 5, 5, 7, 7, 2, 5, 4]"
曲江秋 ,杨无咎,平平仄仄。仄平仄平平，平平平仄。平仄仄平，平平仄仄，仄平平平仄。平仄仄仄仄。仄平仄，平平仄。仄仄仄平，平平仄平，仄平平仄。平仄。平平仄仄。仄平仄、平平仄仄。平平平仄仄，平平仄仄，平仄平平仄。仄仄仄平平，平平仄仄平平仄。仄仄仄，平平仄平，仄仄仄平平仄。,0,50,51,101,"[4, 5, 4, 4, 4, 5, 5, 3, 3, 4, 4, 4, 2, 4, 3, 4, 5, 4, 5, 5, 7, 3, 4, 6]"
曲江秋 ,韩玉,平平仄仄。仄仄仄平平，平平仄仄。平仄仄平，平平仄仄，仄平平平仄。平仄仄仄仄。仄平仄，平平仄。平仄平平仄，平平仄平，仄平平仄。仄仄。平平仄仄。仄平仄、平平仄仄。平平平仄仄，平平平仄，平仄平仄仄。仄平仄仄平平，平平平仄平平仄。仄仄仄、平平平平仄仄，仄平平仄。,0,52,51,103,"[4, 5, 4, 4, 4, 5, 5, 3, 3, 5, 4, 4, 2, 4, 3, 4, 5, 4, 5, 6, 7, 3, 6, 4]"
翠楼吟 ,姜夔,仄仄平平，平平仄仄，平平仄平平仄。平平平仄仄，仄平仄平平平仄。平平平仄。仄仄仄平平，平平平仄。平平仄。仄平平仄，仄平平仄。仄仄。平仄平平，仄仄平平仄，仄平平仄。仄平平仄仄，仄平仄平平平仄。平平平仄。仄仄仄平平，平平平仄。平平仄。仄平平仄，仄平平仄。,0,56,45,101,"[4, 4, 6, 5, 7, 4, 5, 4, 3, 4, 4, 2, 4, 5, 4, 5, 7, 4, 5, 4, 3, 4, 4]"
霓裳中序第一 ,姜夔,平平仄仄仄。仄仄平平平仄仄。平仄仄平仄仄。仄平仄仄平，平平平仄。平平仄仄。仄仄平平仄平仄。平平仄，仄平仄仄，仄仄仄平仄。平仄。仄平平仄。仄仄仄平平仄仄。平平平仄仄仄。仄仄平平，仄仄平仄。仄平平仄仄。仄仄仄平平仄仄。平平仄，平平平仄，仄仄仄平仄。,0,42,59,101,"[5, 7, 6, 5, 4, 4, 7, 3, 4, 5, 2, 4, 7, 6, 4, 4, 5, 7, 3, 4, 5]"
霓裳中序第一 ,周密,平平仄仄仄。仄仄平平平仄仄。平仄平平仄仄。仄仄仄仄平，平平平仄。平平仄仄。仄仄平平仄平仄。平平仄，仄平仄仄，仄仄仄平仄。平仄。仄平平仄。仄仄仄平平仄仄。平平平仄仄仄。仄仄仄平平，仄平平仄。仄平平仄仄。仄仄仄、平平仄仄。平平仄，仄平平仄，仄仄仄平仄。,0,42,60,102,"[5, 7, 6, 5, 4, 4, 7, 3, 4, 5, 2, 4, 7, 6, 5, 4, 5, 3, 4, 3, 4, 5]"
霓裳中序第一 ,尹焕,平平仄仄仄。仄仄平平平仄仄。仄平仄、平平仄仄。仄仄仄平平，仄平平仄。平平仄仄。仄仄平、平仄平仄。平平仄，仄平平仄，仄仄仄平仄。平仄。仄平平仄。仄平仄、仄平平仄。平平平仄仄仄。仄仄仄平平，平仄平仄。仄平平仄仄。仄仄仄平平仄仄。平平仄，平平平仄，仄仄仄平仄。,0,45,58,103,"[5, 7, 3, 4, 5, 4, 4, 3, 4, 3, 4, 5, 2, 4, 3, 4, 6, 5, 4, 5, 7, 3, 4, 5]"
月当厅 ,史达祖,仄仄仄仄平平仄，平平仄仄，平仄平平。仄仄仄平，平仄仄仄平平。平仄仄平仄仄，仄平平、仄仄仄平平。仄平仄，平平平仄，仄仄平平。平平仄仄平平仄，仄平平、仄平平仄平平。仄仄仄平，平仄仄仄平平。平仄仄平仄平仄，仄平平仄仄平平。平仄仄，平平仄，仄仄仄平平。,0,49,52,101,"[7, 4, 4, 4, 6, 6, 3, 5, 3, 4, 4, 7, 3, 6, 4, 6, 7, 7, 3, 3, 5]"
寿楼春 ,史达祖,平平平平平。仄平平仄仄，平仄平平。仄仄平平平仄，仄平平平。平仄仄、平平平。仄仄平、平平平平。仄仄仄平平，平平仄仄，平仄仄平平。平平仄，平平平。仄平平仄仄，平仄平平。仄仄平平平仄，仄平平平。平仄仄，平平平。仄仄平、平平平平。仄平仄平平，平平仄平平仄平。,0,65,36,101,"[5, 5, 4, 6, 4, 3, 3, 3, 4, 5, 4, 5, 3, 3, 5, 4, 6, 4, 3, 3, 3, 4, 5, 7]"
秋色横空 ,白朴,平仄平平。仄平平仄仄，仄仄平平。平平仄仄平平仄，平平仄仄平平。平平仄，仄仄平。仄仄仄、平平平仄平。仄仄平平仄仄，仄仄平平。平仄仄平仄平。仄平平平仄，仄仄平平。仄平仄仄平平仄，平仄仄仄平平。平平仄，仄仄平。仄仄仄、平平平仄平。仄仄仄平平，平仄仄平。,0,51,50,101,"[4, 5, 4, 7, 6, 3, 3, 3, 5, 6, 4, 6, 5, 4, 7, 6, 3, 3, 3, 5, 5, 4]"
舜韶新 ,郭子正,平仄平平，平仄仄平平，平平平仄。仄平仄仄，平仄平平仄，平平平仄。平仄平平仄，仄仄仄、平平平仄。仄平平平仄，仄平仄平平仄。仄仄平平，平仄平平，平仄平平，仄平平仄。仄平平仄，仄仄平平仄，平平平仄。平仄平平仄，仄仄仄、平平平仄。平平平仄仄，平平仄平平仄。,0,58,43,101,"[4, 5, 4, 4, 5, 4, 5, 3, 4, 5, 6, 4, 4, 4, 4, 4, 5, 4, 5, 3, 4, 5, 6]"
西平乐 ,柳永,仄仄平平仄仄，仄仄平平仄。平仄平平仄仄，平仄平平仄仄，平仄平平仄仄。平平仄仄，平仄平平仄仄。仄平仄。平仄仄，平仄仄。仄仄平平仄仄，仄仄平平仄仄，仄仄平平仄。仄仄仄、平平仄仄。平平仄仄，仄平平仄，平仄仄，仄平仄。仄仄平平仄仄。仄平仄仄，平仄平平仄仄。,0,41,61,102,"[6, 5, 6, 6, 6, 4, 6, 3, 3, 3, 6, 6, 5, 3, 4, 4, 4, 3, 3, 6, 4, 6]"
西平乐 ,朱雍,仄仄平平仄仄，平仄平平仄。仄仄平平仄仄，平仄平平仄仄。平仄平平平仄。平平仄仄，仄仄平平仄仄。仄平仄。平平仄。平仄仄。仄仄平平仄仄，平仄平平仄仄，仄仄平平仄。仄平仄平平仄仄。平平仄仄，仄仄平仄，平仄仄，仄平仄。仄仄平平仄仄。平平仄仄，平仄平平仄仄。,0,44,58,102,"[6, 5, 6, 6, 6, 4, 6, 3, 3, 3, 6, 6, 5, 7, 4, 4, 3, 3, 6, 4, 6]"
西平乐 ,晁补之,仄仄平平仄仄，平仄平平仄。平仄平平仄仄，平仄平平仄仄，平仄平平仄仄。平平仄仄，平仄平平平仄。仄平仄。平仄仄，平仄仄。平仄平平平仄，平仄平平仄仄。仄仄平平平仄。仄仄仄、平平仄仄。平平仄仄，平平平仄，平仄仄，仄平仄。平仄平平仄仄。平平仄仄，平仄平平仄仄。,0,50,53,103,"[6, 5, 6, 6, 6, 4, 6, 3, 3, 3, 6, 6, 6, 3, 4, 4, 4, 3, 3, 6, 4, 6]"
西平乐 ,周邦彦,仄仄平平，仄平仄仄，平仄仄仄平平。平仄平平，仄平平仄，平平仄仄平平。仄仄仄平平仄仄，平仄平平仄仄，平平仄仄平平，平平仄仄平平。平仄平平仄仄，平仄仄、仄仄仄平平。仄平平仄，平平仄仄，平仄平平，平仄平平。平仄仄、平平仄仄，平仄平平，仄仄平平仄仄，平仄平平，平仄平平仄仄平。平仄仄平，平平仄仄，平仄平平，仄仄平平，仄仄平平，平平仄仄平平。,0,74,63,137,"[4, 4, 6, 4, 4, 6, 7, 6, 6, 6, 6, 3, 5, 4, 4, 4, 4, 3, 4, 4, 6, 4, 7, 4, 4, 4, 4, 4, 6]"
西平乐 ,杨泽民,仄仄平平，仄平仄仄，平仄仄仄平平。平仄平平，仄平平仄，平平仄仄平平。平仄仄、平平仄仄，平仄平平，仄仄平平，仄仄平平，仄仄平平。平仄平平仄仄，平平仄、仄仄仄平平。平平平仄，平平仄仄，平仄平平，平仄平平。平仄仄、平平仄仄，平仄平平，仄仄平平仄仄，平仄平平，平仄平平仄仄平。平仄仄平，平平仄仄，平仄平平，仄仄平平，仄仄平平，平平仄仄平平。,0,75,60,135,"[4, 4, 6, 4, 4, 6, 3, 4, 4, 4, 4, 4, 6, 3, 5, 4, 4, 4, 4, 3, 4, 4, 6, 4, 7, 4, 4, 4, 4, 4, 6]"
西平乐 ,方千里,仄仄平平，仄平仄仄，平仄仄仄平平。平仄平平，仄平平仄，平平仄仄平平。仄仄仄平平仄仄，平仄平平仄仄，平平仄仄，平平仄仄平平。平仄平平仄仄，平仄仄、仄仄仄平平。仄平平仄，平平仄仄，平仄平平，平仄平平。平仄仄、平平仄仄，平仄平平，仄仄平平仄仄，平仄平平，平仄平平仄仄平。仄仄仄平，平平仄仄，平仄平平，仄仄平平，仄仄平平，平平仄仄平平。,0,71,64,135,"[4, 4, 6, 4, 4, 6, 7, 6, 4, 6, 6, 3, 5, 4, 4, 4, 4, 3, 4, 4, 6, 4, 7, 4, 4, 4, 4, 4, 6]"
西平乐 ,陈允平,仄仄平平，仄平平仄，平仄仄仄平平。仄仄平平，平平平仄，平平仄仄平平。仄仄仄平平仄仄，仄仄平平仄仄，平平仄仄，平平仄仄，仄仄平平。平仄平平仄仄，平仄仄、仄仄仄平平。仄平平仄，平平仄仄，平仄平平，仄仄平平。仄仄平平仄仄，平仄平平，仄仄平平仄仄，仄仄平平，平仄平平仄仄平。平仄仄平，平平仄仄，平仄平平，仄仄平平，仄仄平平，平平仄仄平平。,0,69,67,136,"[4, 4, 6, 4, 4, 6, 7, 6, 4, 4, 4, 6, 3, 5, 4, 4, 4, 4, 6, 4, 6, 4, 7, 4, 4, 4, 4, 4, 6]"
山亭宴 ,张先,仄平仄仄平平仄。仄平平、仄平平仄。仄仄仄平平，仄平仄、平平仄仄。仄平平仄仄平平，仄平仄、平平平仄。平仄仄平平，仄仄仄、平平仄。仄平仄仄平平仄。仄平仄、仄平仄仄。平仄仄平平，仄仄仄、平平仄仄。平平平仄仄平平，仄仄仄、仄平平仄。仄仄仄平平，仄仄仄、平平仄。,0,46,56,102,"[7, 3, 4, 5, 3, 4, 7, 3, 4, 5, 3, 3, 7, 3, 4, 5, 3, 4, 7, 3, 4, 5, 3, 3]"
望春回 ,李甲,仄平仄仄，仄仄平仄平，平仄平仄。平仄仄平平，仄仄仄平仄。平平平平平仄仄，仄平仄、仄仄平平仄。仄平平仄，仄平仄仄，仄平平仄。平平仄平仄仄。仄仄仄平平，平仄平仄。平仄仄平平，仄平仄平仄。平平仄仄平仄仄，仄平平仄仄平平仄。仄平平仄，平平仄仄，仄仄平仄。,0,46,56,102,"[4, 5, 4, 5, 5, 7, 3, 5, 4, 4, 4, 6, 5, 4, 5, 5, 7, 8, 4, 4, 4]"
水龙吟 ,苏轼,平平平仄平平仄，平仄平平平仄。平平平仄，平平平仄，仄平平仄。平仄平平，仄平平仄，仄平平仄。仄仄仄平平，平平仄仄，平平仄、平平仄。平仄平平仄仄。仄平平、仄平平仄。仄平平仄，平平平仄，平平仄仄。平仄仄平，仄平平仄，仄平平仄。仄平平仄仄，平平仄仄，仄平平仄。,0,58,44,102,"[7, 6, 4, 4, 4, 4, 4, 4, 5, 4, 3, 3, 6, 3, 4, 4, 4, 4, 4, 4, 4, 5, 4, 4]"
水龙吟 ,赵长卿,仄平平仄平平仄。平仄仄平平仄。平平仄仄，平平仄仄，仄平平仄。平仄平平，平平仄仄，平平平仄。仄平平仄仄，仄平平仄，仄平平、平平仄。仄仄平平平仄，仄平平、仄平平仄。平平仄仄，平平仄仄，仄平平仄。平仄平平，平平平仄，仄平平仄。平平平、仄仄平平仄仄，平平平仄。,0,58,44,102,"[7, 6, 4, 4, 4, 4, 4, 4, 5, 4, 3, 3, 6, 3, 4, 4, 4, 4, 4, 4, 4, 3, 6, 4]"
水龙吟 ,杨无咎,平平平仄平平仄。平仄仄、平平仄。平平平仄，仄平平仄，平平平仄。仄仄平平，仄平平仄，仄平平仄。仄平平仄仄，平平仄仄，平平仄、平平仄。仄仄平平仄仄。仄平平、平平平仄。平平仄仄，仄平平仄，仄平平仄。平仄平平，仄平平仄，仄平平仄。仄平平仄仄，平平仄仄，平平平仄。,0,57,45,102,"[7, 3, 3, 4, 4, 4, 4, 4, 4, 5, 4, 3, 3, 6, 3, 4, 4, 4, 4, 4, 4, 4, 5, 4, 4]"
水龙吟 ,赵长卿,平平仄仄平平仄，平仄仄、平平仄。平平仄仄，平平平仄，平平仄仄。平仄平平，仄平平仄，平平平仄。仄平平仄仄，平平仄仄，仄平仄、平平仄。仄仄平平仄仄。仄平平、仄平仄仄。平平仄仄，平平平仄，平平平仄。平仄平平，仄平平仄，仄平平仄。仄平平仄仄，平平仄仄平平仄。,0,55,46,101,"[7, 3, 3, 4, 4, 4, 4, 4, 4, 5, 4, 3, 3, 6, 3, 4, 4, 4, 4, 4, 4, 4, 5, 7]"
水龙吟 ,姜夔,仄平仄仄平平仄，仄仄平平平仄。平平仄仄，平平平仄，平平仄仄。仄仄平平，仄平平仄，仄平仄仄。仄仄平平仄，平平仄仄，平平仄、平平仄。仄仄。平平仄仄。仄平平、仄平平仄。仄平仄仄，平平仄仄，平平仄仄。仄仄平平，仄平平仄，仄平平仄。仄仄平、仄仄平平，仄仄仄平平仄。,0,48,54,102,"[7, 6, 4, 4, 4, 4, 4, 4, 5, 4, 3, 3, 2, 4, 3, 4, 4, 4, 4, 4, 4, 4, 3, 4, 6]"
水龙吟 ,晁端礼,仄平平仄平平仄，平仄仄平平仄。仄平仄仄，平平平仄，平平仄仄。平仄平平，仄平平仄，仄平平仄。仄平平仄仄，平平仄仄，平平仄、平平仄。仄仄仄平平仄。仄平平、平平平仄。平平仄仄，仄平平仄，平平仄仄。仄仄平平仄，平平仄、仄平平仄。仄平平仄仄，平平平仄，仄平平仄。,0,54,48,102,"[7, 6, 4, 4, 4, 4, 4, 4, 5, 4, 3, 3, 6, 3, 4, 4, 4, 4, 5, 3, 4, 5, 4, 4]"
水龙吟 ,赵长卿,平平仄仄平平仄，仄仄仄、平平仄。平平仄仄平平，平仄平平平仄。仄仄平平，仄平平仄，仄平平仄。仄平平、仄仄平平仄仄。平平仄、平平仄。平仄平平仄仄。仄平平、仄平平仄。平平仄仄平平，平仄平平平仄。平仄平平仄，平平仄、仄平平仄。仄平平、平仄平平，仄仄仄、平平仄。,0,57,45,102,"[7, 3, 3, 6, 6, 4, 4, 4, 3, 6, 3, 3, 6, 3, 4, 6, 6, 5, 3, 4, 3, 4, 3, 3]"
水龙吟 ,赵长卿,平平仄仄平平仄。平仄平平平仄。平平仄仄，仄平平仄，平平平仄。仄仄平平，平平平仄，平平平仄。仄平平、仄仄平平仄仄，平平仄平平仄。仄仄平平仄仄，仄仄平、平仄仄平平仄。平平仄仄平平，平仄平平仄仄。仄仄仄平，仄平平仄，仄平平仄。仄平平、仄仄平平，仄仄仄平平仄。,0,55,49,104,"[7, 6, 4, 4, 4, 4, 4, 4, 3, 6, 6, 6, 3, 6, 6, 6, 4, 4, 4, 3, 4, 6]"
水龙吟 ,秦观,仄平平仄平平仄，平仄仄、平平仄。仄平平、平仄平平仄仄，仄平平平仄。仄仄平平仄，平平仄、仄平平仄。仄平平仄仄，平平仄仄，平平仄、平平仄。仄仄平平仄仄，仄仄平、仄平平仄。平平仄仄，仄平平仄，仄平平平仄。仄仄平平仄，平平仄、仄平平仄。仄平平、仄仄平平仄平，仄平平仄仄。,0,54,52,106,"[7, 3, 3, 3, 6, 5, 5, 3, 4, 5, 4, 3, 3, 6, 3, 4, 4, 4, 5, 5, 3, 4, 3, 6, 5]"
水龙吟 ,秦观,仄平平仄平平，仄平仄仄平平仄。平平仄仄，平平平仄，平平平仄。仄仄平平，仄平平仄，仄平平仄。仄平平仄仄，平平仄仄，平平仄、平平仄。仄仄平平仄仄。仄平平、平平平仄。平平仄仄，平平平仄，平平仄仄。平仄平平，仄平平仄，仄平平仄。仄平平、仄仄平平仄仄，仄平平仄。,0,56,46,102,"[6, 7, 4, 4, 4, 4, 4, 4, 5, 4, 3, 3, 6, 3, 4, 4, 4, 4, 4, 4, 4, 3, 6, 4]"
水龙吟 ,黄机,平平仄仄平平，仄平平仄平平仄。平平平仄，平平仄仄，平平平仄。平仄平平，仄平平仄，仄平平仄。仄平平平仄，平平仄仄，仄仄仄、平平仄。平仄平平仄仄，仄平平、平平平仄。平平仄仄，仄平平仄，平平仄仄。平仄平平，平平仄仄，仄平平仄。仄平平、平仄平平，平仄仄平平仄。,0,59,43,102,"[6, 7, 4, 4, 4, 4, 4, 4, 5, 4, 3, 3, 6, 3, 4, 4, 4, 4, 4, 4, 4, 3, 4, 6]"
水龙吟 ,吴文英,仄平仄仄平平，仄平仄仄平平仄。平平仄仄，平平仄仄，平平平仄。仄仄平平，仄平平仄，平平平仄。仄平平仄仄，平平仄仄，平平仄、平平仄。平仄。平平仄仄。仄平平、平平仄仄。仄平仄仄，平平平仄，平平仄仄。仄仄平平，仄平平仄，仄平平仄。仄平平仄仄，平平仄仄，仄平平仄。,0,53,49,102,"[6, 7, 4, 4, 4, 4, 4, 4, 5, 4, 3, 3, 2, 4, 3, 4, 4, 4, 4, 4, 4, 4, 5, 4, 4]"
水龙吟 ,程垓,仄平平仄平平，仄平仄仄平平仄。平平仄仄，仄平平仄，仄平平仄。仄仄平平，仄平平仄，仄平平仄。仄仄平平仄，仄平平仄，平仄仄、平平仄。平仄平平仄仄。仄平平、仄平平仄。平平仄仄，平平仄仄，平平平仄。仄仄平平仄，仄平仄、仄平平仄。仄平平仄仄，平平仄仄，仄平平仄。,0,51,51,102,"[6, 7, 4, 4, 4, 4, 4, 4, 5, 4, 3, 3, 6, 3, 4, 4, 4, 4, 5, 3, 4, 5, 4, 4]"
水龙吟 ,吴文英,仄平平仄平平，仄平仄仄平平仄。仄平仄仄，平平平仄，平平平仄。仄仄平平仄，平平仄、平平平仄。仄平平仄仄，平平仄仄，仄平仄、平平仄。平仄。平平仄仄。仄平平、平平仄仄。平平仄仄，平平平仄，平平仄仄。仄仄平平仄，平平仄、仄平平仄。仄平平仄仄，平平仄仄，仄平平仄。,0,54,48,102,"[6, 7, 4, 4, 4, 5, 3, 4, 5, 4, 3, 3, 2, 4, 3, 4, 4, 4, 4, 5, 3, 4, 5, 4, 4]"
水龙吟 ,刘过,仄平平仄平平，平平仄仄平平仄。仄平平仄，平平仄仄，平平仄仄。仄仄平平，仄平平仄，仄平平仄。仄仄平平仄，平平仄仄，平平仄、平平仄。仄仄仄平平仄。仄平平、仄平平仄。平平仄仄，平平平仄，仄平平仄。仄仄平平，平平仄仄，仄平平仄。仄平平、仄仄平平，仄仄仄、平平仄。,0,53,49,102,"[6, 7, 4, 4, 4, 4, 4, 4, 5, 4, 3, 3, 6, 3, 4, 4, 4, 4, 4, 4, 4, 3, 4, 3, 3]"
水龙吟 ,吴文英,仄平平仄平平，仄平仄仄平平仄。平平仄仄，仄平平仄，平平仄仄。仄仄平平，仄平平仄，仄平平仄。仄平平仄仄，平平仄仄，平平仄、平平仄。平仄仄平平仄。仄平平、平平仄仄。平平仄仄，平平平仄，平平仄仄。平仄平平仄，仄平仄、仄平平仄。仄平平、仄仄平平，仄仄仄平平仄。,0,53,49,102,"[6, 7, 4, 4, 4, 4, 4, 4, 5, 4, 3, 3, 6, 3, 4, 4, 4, 4, 5, 3, 4, 3, 4, 6]"
水龙吟 ,葛立方,仄平平仄平平，仄平仄仄平平仄。平平仄仄，平平仄仄，平平平仄。平仄平平，平平平仄，仄平平仄。仄平平平仄，平平平仄，平平仄、平平仄。仄仄平平平仄。仄平平、仄平平仄。平平仄仄，平平平仄，仄平平仄。仄仄平平，平平平仄，仄平平仄。仄平平仄仄，平平仄仄，平仄仄、平平仄。,0,60,44,104,"[6, 7, 4, 4, 4, 4, 4, 4, 5, 4, 3, 3, 6, 3, 4, 4, 4, 4, 4, 4, 4, 5, 4, 3, 3]"
水龙吟 ,张雨,仄平仄仄平平，仄平仄仄平平仄。平平平仄，平平仄仄，平平仄仄。平仄平平，平平仄仄，仄平平仄。仄平平平仄，平平仄仄，平平仄，平平仄。仄仄平平仄仄，仄平平、平平平仄。仄平平仄平平，仄仄平平平仄。仄平仄仄平平，仄仄平平，仄仄平平仄仄。仄仄平、仄仄平平，仄仄仄平平仄。,0,55,51,106,"[6, 7, 4, 4, 4, 4, 4, 4, 5, 4, 3, 3, 6, 3, 4, 6, 6, 6, 4, 6, 3, 4, 6]"
水龙吟 ,曹组,仄平仄仄平平，仄平仄仄平平仄。平平仄仄，仄平平仄，平平平仄。平仄平平，仄平平仄，平平平仄。仄平平仄仄，平平仄仄，平平仄、平平仄。平仄平平仄仄，仄平平、仄平平仄。平平仄仄平平，仄仄平平仄仄。平仄平平，仄平平仄，平平平仄。仄平平仄仄，平平仄仄，仄平平仄。,0,56,46,102,"[6, 7, 4, 4, 4, 4, 4, 4, 5, 4, 3, 3, 6, 3, 4, 6, 6, 4, 4, 4, 5, 4, 4]"
水龙吟 ,赵长卿,平平平仄平平，仄平仄仄平平仄。平平仄仄，平平仄仄，平平仄仄。仄仄平平，仄平平仄，仄平平仄。仄平平、仄仄平平仄仄，平平仄、平平仄。平仄平平仄仄，仄平仄、平平平仄。仄平仄仄平平，平仄平平仄仄。仄仄平平仄，平仄仄、仄平平仄。仄平平仄仄，平平仄仄，仄平平仄。,0,52,50,102,"[6, 7, 4, 4, 4, 4, 4, 4, 3, 6, 3, 3, 6, 3, 4, 6, 6, 5, 3, 4, 5, 4, 4]"
水龙吟 ,赵长卿,仄平平仄平平，仄平仄仄平平仄。平平仄仄平平，平仄平平仄仄。平仄平平，仄平平仄，平平平仄。仄仄平仄仄，平平仄仄，平平仄、平平仄。平仄平平仄仄，仄平平、仄平平仄。平平仄仄，平平平仄，平平仄仄。平仄平平仄，平平仄、仄平平仄。仄平平仄仄，平平仄仄平平仄。,0,56,45,101,"[6, 7, 6, 6, 4, 4, 4, 5, 4, 3, 3, 6, 3, 4, 4, 4, 4, 5, 3, 4, 5, 7]"
水龙吟 ,无名氏,仄平仄仄平平，仄平仄仄平平仄。平平仄仄，平平平仄，平平仄仄。仄仄平平，仄平平仄，平平平仄。仄平仄仄，平平仄平，仄仄仄、平平仄。仄仄平平仄仄，仄平平、仄平平仄。平平仄仄，平平仄仄，平平平仄。仄仄平平，仄平平仄，平平平仄。平平仄仄，仄平平仄，平平仄、平平仄。,0,54,48,102,"[6, 7, 4, 4, 4, 4, 4, 4, 4, 4, 3, 3, 6, 3, 4, 4, 4, 4, 4, 4, 4, 4, 4, 3, 3]"
水龙吟 ,李之仪,仄平平仄，平平仄仄，仄仄平平仄。平平仄仄，平平仄仄，平平仄仄。仄仄平平，仄平平仄，仄平平仄。仄平平、仄仄平平仄仄，平平仄、平平仄。平仄仄平平仄，仄平平、平平平仄。平平仄仄，平平仄仄，平平仄仄。仄仄平平，仄平平仄，平平仄仄。仄平平仄仄，平平仄仄，仄平平仄。,0,52,50,102,"[4, 4, 5, 4, 4, 4, 4, 4, 4, 3, 6, 3, 3, 6, 3, 4, 4, 4, 4, 4, 4, 4, 5, 4, 4]"
水龙吟 ,辛弃疾,仄平平仄平平。仄，平平仄平平。仄。平平仄仄，平平仄仄、平平平。仄。仄仄平平，仄平仄仄，平平平。仄。仄平平平仄，仄平平仄，平平仄、平平。仄。仄仄平平平。仄，平仄仄仄平平。仄。平平平仄，平平仄仄、仄平平。仄。平仄平平，平平仄仄，仄平平。仄。仄平平仄仄，平平平仄、仄平平。仄。,0,57,45,102,"[6, 1, 5, 1, 4, 4, 3, 1, 4, 4, 3, 1, 5, 4, 3, 2, 1, 5, 1, 6, 1, 4, 4, 3, 1, 4, 4, 3, 1, 5, 4, 3, 1]"
水龙吟 ,无名氏,仄平平仄平平，平仄平平平仄。平平仄仄仄平平，平平平仄仄。仄平仄平仄。平仄平平仄平仄。仄仄平平平平仄，仄仄仄、平平仄仄。仄仄平平，仄仄平平，平平仄、平平仄。平平仄仄仄平平，仄平平平仄。仄仄平平仄平仄，平平平仄仄。仄平仄仄仄平仄，仄平平、仄平平仄。,0,54,48,102,"[6, 6, 7, 5, 5, 7, 7, 3, 4, 4, 4, 3, 3, 7, 5, 7, 5, 7, 3, 4]"
斗百草 ,晁补之,仄仄平平，仄平平仄平平仄。仄仄平平，仄平平仄，平仄仄平仄仄。仄平平、仄仄仄平平，平平仄仄。仄仄仄平平，平平仄仄，仄平平仄。平仄平平平仄，平仄平平，平仄仄平平仄仄。仄仄平平，仄平平仄，仄平仄、平平仄仄。平平仄，仄仄平平平平仄。仄平仄。仄平平、仄平仄仄。,0,51,51,102,"[4, 7, 4, 4, 6, 3, 5, 4, 5, 4, 4, 6, 4, 7, 4, 4, 3, 4, 3, 7, 3, 3, 4]"
斗百草 ,晁补之,仄仄平平，仄平仄仄平平仄。仄仄平平，仄平平仄，平仄仄平仄仄。仄平平、仄仄仄平平，平平平仄仄仄仄平平，平平仄仄，仄平仄仄。平仄平平仄仄。平仄平平，平仄仄平平仄仄。平仄平平，仄平平仄，仄平平、平平仄仄。平平仄，平仄平平仄平仄。仄平仄。仄平平、仄平仄仄。,0,51,51,102,"[4, 7, 4, 4, 6, 3, 5, 9, 4, 4, 6, 4, 7, 4, 4, 3, 4, 3, 7, 3, 3, 4]"
石州慢 ,贺铸,仄仄平平，平仄仄平，平仄平仄。平平仄仄平平，仄仄仄平平仄。平平仄仄，仄仄仄仄平平，平平平仄平平仄。平仄仄平平，仄平平平仄。平仄。仄平平仄，平仄平平，仄平平仄。仄仄平平，仄仄平平平仄。仄平平仄，仄仄仄仄平平，平平仄仄平平仄。仄仄仄平平，仄平平平仄。,0,53,49,102,"[4, 4, 4, 6, 6, 4, 6, 7, 5, 5, 2, 4, 4, 4, 4, 6, 4, 6, 7, 5, 5]"
石州慢 ,蔡松年,平仄平平，平仄仄平，仄仄平仄。平平仄仄平平，平仄平平平仄。平平仄仄，仄平平仄平平，仄平仄仄平平仄。平仄仄平平，仄平平平仄。平仄。仄平仄仄平平，仄仄仄平平仄。仄仄平平，平仄平平平仄。仄平平仄，仄平平仄平平，仄平平仄平平仄。平仄仄平平，仄平平平仄。,0,57,45,102,"[4, 4, 4, 6, 6, 4, 6, 7, 5, 5, 2, 6, 6, 4, 6, 4, 6, 7, 5, 5]"
石州慢 ,张元干,平仄平平，平仄仄平，平仄平仄。平平平仄平平，仄仄仄平平仄。平平仄仄，仄平仄仄平平，平平平仄平平仄。仄仄仄平平，仄平平平仄。平仄。仄平平仄，仄仄平平，仄平平仄。平仄仄平平仄，平平平仄。平平仄仄，仄仄平仄平平，平平平仄平平仄。仄仄仄平平，仄平平平仄。,0,57,45,102,"[4, 4, 4, 6, 6, 4, 6, 7, 5, 5, 2, 4, 4, 4, 6, 4, 4, 6, 7, 5, 5]"
石州慢 ,张炎,仄仄平平，平仄仄平，仄仄平仄。平平平仄，平平仄仄，仄平平仄。平平仄仄，仄平仄仄平平，仄平平仄平平仄。平仄仄平平，仄平平平仄。平仄。仄平平仄，仄仄平平，平平平仄。仄仄平平，平仄平平平仄。仄平仄仄，仄平仄仄平平，仄平仄仄平平仄。平仄仄平平，仄仄平平仄。,0,53,49,102,"[4, 4, 4, 4, 4, 4, 4, 6, 7, 5, 5, 2, 4, 4, 4, 4, 6, 4, 6, 7, 5, 5]"
石州慢 ,张雨,仄仄平平平仄，仄平平仄平仄。仄平平仄平平，平仄仄平平仄。平平平仄，仄平仄仄平平，仄平仄仄平平仄。仄仄仄平平，仄平平平仄。平仄。仄平仄仄，平平仄仄，平平仄仄。仄仄平平，平仄仄平平仄。平平仄仄，仄平仄仄平平，平平平仄平平仄。平仄仄平平，仄仄平平仄。,0,53,49,102,"[6, 6, 6, 6, 4, 6, 7, 5, 5, 2, 4, 4, 4, 4, 6, 4, 6, 7, 5, 5]"
石州慢 ,王之道,平仄平平，仄平仄仄，平平平仄。仄仄平平，平平平仄，仄平平仄。仄平平仄，仄平仄仄，平平平仄，仄仄平平仄。仄仄平平，仄仄平平平仄。平仄。平平仄仄，仄平平仄，仄平平仄。仄仄平平，仄仄仄仄平仄。平仄平平，平平仄仄，仄平平仄，平仄平平仄。仄仄平平，平平仄仄平仄。,0,52,50,102,"[4, 4, 4, 4, 4, 4, 4, 4, 4, 5, 4, 6, 2, 4, 4, 4, 4, 6, 4, 4, 4, 5, 4, 6]"
上林春慢 ,晁补之,仄仄平平，平仄仄平，仄仄仄平平仄。仄仄仄平，平平仄仄，平平仄平平仄。仄平平仄，仄平仄、仄平平仄。仄平平，仄仄仄仄平，仄平平仄。仄平平、仄平仄仄。平平仄、仄仄平平仄仄。仄平仄平，平平仄仄，平平仄平平仄。仄平仄仄，仄平仄、仄平平仄。仄平平，仄平仄、仄平平仄。,0,47,55,102,"[4, 4, 6, 4, 4, 6, 4, 3, 4, 3, 5, 4, 3, 4, 3, 6, 4, 4, 6, 4, 3, 4, 3, 3, 4]"
上林春慢 ,晁补之,平仄平平，平仄仄平，仄仄平平平仄。仄平仄仄，平平仄仄，平平仄平平仄。仄平仄仄，仄平仄、仄平仄仄。仄平平，仄仄仄，仄仄仄平平仄。仄平平、仄平仄仄。平平仄、仄仄平平平仄。仄仄仄平，平平仄仄，平仄仄平平仄。仄平仄仄，仄平仄、仄平平仄。仄平平，仄仄仄，仄平平仄。,0,44,58,102,"[4, 4, 6, 4, 4, 6, 4, 3, 4, 3, 3, 6, 3, 4, 3, 6, 4, 4, 6, 4, 3, 4, 3, 3, 4]"
宴清都 ,周邦彦,仄仄平平仄。平平仄，仄平平仄平仄。平平仄仄，平平仄仄，仄平平仄。平平仄仄平平，仄仄仄、平平仄仄。仄仄仄、仄仄平平，平平仄仄平仄。平平仄仄平平，平平仄仄，平仄平仄。平平仄仄，平平仄仄，仄平平仄。平平仄仄平仄，仄仄仄、平平仄仄。仄仄平、仄仄平平，平平仄仄。,0,48,54,102,"[5, 3, 6, 4, 4, 4, 6, 3, 4, 3, 4, 6, 6, 4, 4, 4, 4, 4, 6, 3, 4, 3, 4, 4]"
宴清都 ,卢祖皋,平仄平平仄。平仄仄，仄平平仄平仄。平平仄仄，平平仄仄，仄平平仄。平平仄仄平仄。仄仄仄、平平仄仄。仄仄平平仄平平，平平平仄平仄。平平仄仄平平，平平仄仄，平仄平仄。平平仄仄，平平仄仄，仄平平仄。平平仄仄平仄。仄平仄、平平仄仄。仄平平、平仄平平，平平仄仄。,0,53,49,102,"[5, 3, 6, 4, 4, 4, 6, 3, 4, 7, 6, 6, 4, 4, 4, 4, 4, 6, 3, 4, 3, 4, 4]"
宴清都 ,曹勛,仄仄平平仄。平平仄，仄平平仄平仄。平平仄仄，平仄仄平，仄平平仄。平平仄仄平仄。仄仄仄、仄平仄仄。仄仄仄、仄仄平平，平仄仄仄平仄。平仄。仄仄平平，平平仄仄，平平平仄。平平仄仄，平平仄仄，仄平平仄。平平仄平平仄。仄仄仄、平平仄仄。仄仄仄、仄仄平平，平仄仄仄。,0,44,58,102,"[5, 3, 6, 4, 4, 4, 6, 3, 4, 3, 4, 6, 2, 4, 4, 4, 4, 4, 4, 6, 3, 4, 3, 4, 4]"
宴清都 ,吴文英,仄仄平平仄。平平仄，仄仄平仄平仄。平平仄仄，平平仄仄，仄平平仄。平平仄仄平仄。仄仄仄平平仄仄。仄仄仄、平仄平平，仄仄仄平平仄。平平仄仄。仄平平平仄仄，平仄平仄。平平仄仄，平平仄仄，仄平平仄。平平仄平平仄。仄仄仄、平平仄仄。仄平平、平仄平平，平平仄仄。,0,48,54,102,"[5, 3, 6, 4, 4, 4, 6, 7, 3, 4, 6, 4, 6, 4, 4, 4, 4, 6, 3, 4, 3, 4, 4]"
宴清都 ,陈允平,仄仄平平仄。仄平平仄平仄。平平仄仄，平仄平平，仄平平仄。平平仄仄平平，仄仄仄、平平仄仄。仄仄仄、仄仄平平，仄平仄仄平仄。平平仄仄平平，平平仄仄，平仄平仄。平平仄仄，平平平仄，仄平平仄。平平仄仄平仄，仄仄仄平平仄仄。仄仄平、仄仄平平，平平仄仄。,0,47,52,99,"[5, 6, 4, 4, 4, 6, 3, 4, 3, 4, 6, 6, 4, 4, 4, 4, 4, 6, 7, 3, 4, 4]"
宴清都 ,袁去华,仄仄平平仄。平平仄仄，平仄平仄。平平平仄，平平仄仄，仄平平仄。平平仄仄平平，仄仄仄、平平仄仄。仄仄平、平仄平平，平平仄仄平仄。平平仄仄平平，平平仄仄，平仄平仄。平平仄仄，平平仄仄，仄平平仄。平平仄仄平平，仄仄仄、平平仄仄。仄仄平、仄仄平平，平平仄仄。,0,51,50,101,"[5, 4, 4, 4, 4, 4, 6, 3, 4, 3, 4, 6, 6, 4, 4, 4, 4, 4, 6, 3, 4, 3, 4, 4]"
宴清都 ,何籀,仄仄平平仄。平仄仄，仄平平仄平仄。平平仄仄，平平仄平，仄平平仄。平平仄仄平仄。仄仄仄、平平仄仄。平仄平、仄仄平仄。平仄。仄仄。平仄。平仄。仄仄平平，仄平仄仄，平仄平仄。平平仄仄，平平仄仄，仄仄平仄。平平仄平平仄。仄仄仄、平平仄仄。仄仄仄、仄仄平平，平平仄仄。,0,44,58,102,"[5, 3, 6, 4, 4, 4, 6, 3, 4, 3, 4, 2, 2, 2, 2, 4, 4, 4, 4, 4, 4, 6, 3, 4, 3, 4, 4]"
宴清都 ,程垓,仄仄平平仄。平平仄，仄仄平平平仄。仄平平仄，平平仄仄，仄平平仄。平平仄平平仄。仄仄仄、平平平仄。平仄平、仄仄平仄。平仄。仄仄。平仄。平仄。仄仄平平，平仄。仄仄平平平仄。仄平仄仄。仄仄。仄仄仄平平仄。平平仄平仄仄。仄平仄、平平仄仄。仄仄平、平仄平平，平平平仄。,0,48,54,102,"[5, 3, 6, 4, 4, 4, 6, 3, 4, 3, 4, 2, 2, 2, 2, 4, 2, 6, 4, 2, 6, 6, 3, 4, 3, 4, 4]"
宴清都 ,曹勛,仄仄平平，仄平平仄，仄平平仄平仄。平平仄仄，平平仄仄，仄平平仄。平仄仄平平仄。仄仄仄、平平仄仄。平仄平、平仄仄仄。平仄。仄仄。平仄。平仄。仄仄平平，平平仄仄，仄平平仄。平仄仄平，平平仄仄，仄平平仄。平平仄平平仄。仄仄仄、平平仄仄。仄仄平平仄，平平平平仄仄。,0,48,54,102,"[4, 4, 6, 4, 4, 4, 6, 3, 4, 3, 4, 2, 2, 2, 2, 4, 4, 4, 4, 4, 4, 6, 3, 4, 5, 6]"
庆春宫 ,周邦彦,平仄平平，平平平仄，仄平仄仄平平。平仄平平，平平平仄，仄平仄平平平。仄平平仄，仄平仄、平平仄平。平平平仄，平仄平平，平仄平平。平平仄仄平平。平仄平平，平仄平平。平仄平平，平平平仄，仄平平仄平平。仄平平仄，仄仄仄、平平仄平。仄平平仄，仄仄平平，仄仄平平。,0,65,37,102,"[4, 4, 6, 4, 4, 6, 4, 3, 4, 4, 4, 4, 6, 4, 4, 4, 4, 6, 4, 3, 4, 4, 4, 4]"
庆春宫 ,王沂孙,平仄平平，平平平仄，仄平仄仄平仄。平仄平平，平平平仄，仄平平仄仄仄。仄平平仄，仄平仄、平平仄仄。平平平仄，平仄平平，仄平平仄。仄平仄仄平平，平仄平平，仄平平仄。平仄平平，仄平仄仄，平仄平平仄仄。仄平平仄，仄平仄、平平仄仄。平平仄仄，平仄平平，仄平仄仄。,0,55,47,102,"[4, 4, 6, 4, 4, 6, 4, 3, 4, 4, 4, 4, 6, 4, 4, 4, 4, 6, 4, 3, 4, 4, 4, 4]"
忆旧游 ,周邦彦,仄平平仄仄，仄仄平平，平仄平平。仄仄平平仄，仄平平仄仄，仄仄平平。仄平仄仄平仄，平仄仄平平。仄仄仄平平，平平仄仄，仄仄平平。平平。仄平仄，仄仄仄平平，平仄平平。仄仄平平仄，仄平平平仄，平仄平平。仄平仄仄平仄，平仄仄平平。仄仄仄平平，平平仄仄平仄平。,0,51,51,102,"[5, 4, 4, 5, 5, 4, 6, 5, 5, 4, 4, 2, 3, 5, 4, 5, 5, 4, 6, 5, 5, 7]"
忆旧游 ,张炎,仄平平仄仄，平仄平平，平仄平平。仄仄平平仄，仄平平仄仄，平仄平平。仄平仄仄平仄，平仄仄平平。仄平仄平平，平平仄仄，平仄平平。平平仄平仄，仄平平仄仄，仄仄平平。仄仄平平仄，仄仄平仄仄，仄仄平平。仄仄仄平平仄，平仄仄平平。仄仄仄平平，平平仄仄平仄平。,0,51,51,102,"[5, 4, 4, 5, 5, 4, 6, 5, 5, 4, 4, 5, 5, 4, 5, 5, 4, 6, 5, 5, 7]"
忆旧游 ,吴文英,仄平平仄仄，仄仄平、平平仄平平。仄平平平仄，仄平平仄仄，仄仄平平。仄平仄仄平仄，平仄仄平平。仄仄仄平平，平平仄仄，仄仄平平。平平仄平仄，仄仄仄平平，平仄平平。平仄平平仄，仄平平平仄，平仄平平。仄平仄仄平仄，平仄仄平平。仄仄仄平平，平平仄仄平仄平。,0,53,49,102,"[5, 3, 5, 5, 5, 4, 6, 5, 5, 4, 4, 5, 5, 4, 5, 5, 4, 6, 5, 5, 7]"
忆旧游 ,周密,仄平平仄仄，仄仄平平，仄仄平平。仄仄平平仄，仄平平平仄，仄仄平平。平平仄平平仄，平仄仄平平。仄仄仄平平，平平平仄，仄仄平平。平平仄平仄，仄仄仄平平，仄仄平平。仄仄平平仄，仄仄平平仄，仄仄平平。平平仄仄平仄，平仄仄平平。仄仄仄平平，平平仄仄，平仄平平。,0,53,50,103,"[5, 4, 4, 5, 5, 4, 6, 5, 5, 4, 4, 5, 5, 4, 5, 5, 4, 6, 5, 5, 4, 4]"
忆旧游 ,周密,仄平平仄仄，仄仄平平，平仄平平。仄仄平平仄，仄平平仄仄，仄仄平平。仄平仄仄平仄，平仄仄平平。仄仄仄平平，平平仄仄，仄仄仄平平。平平。仄平仄，仄仄仄平平，仄仄平平。仄仄平平仄，仄仄平平仄，仄仄平平。仄平仄仄平仄，平仄仄平平。仄仄仄平平，平平仄仄，平仄平平。,0,49,55,104,"[5, 4, 4, 5, 5, 4, 6, 5, 5, 4, 5, 2, 3, 5, 4, 5, 5, 4, 6, 5, 5, 4, 4]"
忆旧游 ,刘将孙,仄仄平平仄，平仄平平，仄仄平平。仄仄仄、平平仄仄，仄平仄仄，平仄平平。平平仄仄平仄，仄仄仄平平。仄仄仄平平，平平平仄，仄仄平平。仄平平仄仄，仄仄仄平平，仄仄平平。平平平仄仄，仄平平平仄，仄仄平平。平平仄平平仄，平仄仄平平。仄仄仄平平。平平仄仄平仄平。,0,52,51,103,"[5, 4, 4, 3, 4, 4, 4, 6, 5, 5, 4, 4, 5, 5, 4, 5, 5, 4, 6, 5, 5, 7]"
花犯 ,周邦彦,仄平平，平平仄仄，平平仄平仄。仄平平仄。平仄仄平平，平仄平仄。仄平仄仄平平仄。平平平仄仄。仄仄仄、仄平平仄，平平平仄仄。平平仄平仄平平，平平仄仄仄，平平平仄。平仄仄，平平仄、仄平平仄。平平仄、仄平仄仄，平仄仄、平平平仄仄。仄仄仄、仄平平仄，平平平仄仄。,0,52,50,102,"[3, 4, 5, 4, 5, 4, 7, 5, 3, 4, 5, 7, 5, 4, 3, 3, 4, 3, 4, 3, 5, 3, 4, 5]"
花犯 ,吴文英,仄平平，平平平仄，平平仄平仄。仄平平仄。平仄仄平平，平仄平仄。仄平仄仄平平仄，平平平仄仄。仄仄仄、平平仄仄，平平平仄仄。平平仄平仄平平，平平仄，仄仄平平平仄。平仄仄，平平仄、仄平平仄。平平仄、仄平仄仄，平仄仄、平平平仄仄。仄仄仄、仄平平仄，仄平平仄仄。,0,52,50,102,"[3, 4, 5, 4, 5, 4, 7, 5, 3, 4, 5, 7, 3, 6, 3, 3, 4, 3, 4, 3, 5, 3, 4, 5]"
花犯 ,吴文英,仄平平，平平仄仄，平平仄平仄。仄平平仄。仄仄仄平平，仄仄平仄。仄平仄仄平平仄。平平平仄仄。仄仄仄、仄平平仄，平平平仄仄。平平仄仄仄平平，平平仄，仄仄平平平仄。平仄仄，平平仄、仄平平仄。平平仄、仄平仄仄。平仄仄、仄平平仄仄。仄仄仄、平平平仄，平平平仄仄。,0,49,53,102,"[3, 4, 5, 4, 5, 4, 7, 5, 3, 4, 5, 7, 3, 6, 3, 3, 4, 3, 4, 3, 5, 3, 4, 5]"
花犯 ,周密,仄平平，平平仄仄，平平仄平仄。仄平平仄。平仄仄平平，平仄平仄。平平仄仄平平仄。平平平仄仄。仄仄仄、仄平平仄，平平平仄仄。平平仄仄仄平平，平平仄，仄仄平平平仄。平仄仄，平仄仄平平仄。平平仄、仄平仄仄，仄平仄、平平平仄仄。平仄仄、平平平仄，仄平平仄仄。,0,52,49,101,"[3, 4, 5, 4, 5, 4, 7, 5, 3, 4, 5, 7, 3, 6, 3, 6, 3, 4, 3, 5, 3, 4, 5]"
倒犯 ,周邦彦,仄仄、仄平平仄平，仄平平仄。平平仄仄。平平仄、仄平平仄。平平仄仄、平仄平平平平仄。仄仄仄平平，仄仄平平仄。仄平平、仄平仄。平仄仄平，仄仄平平，平平平仄仄。仄仄仄仄仄，仄平仄，平平仄。仄仄仄、平平仄。仄平平、平平平仄仄。仄仄仄平平，仄仄平平仄。仄平平仄仄。,0,48,54,102,"[2, 5, 4, 4, 3, 4, 4, 7, 5, 5, 3, 3, 4, 4, 5, 5, 3, 3, 3, 3, 3, 5, 5, 5, 5]"
倒犯 ,吴文英,仄仄、仄平平仄平，仄平平仄。平平仄仄。平平仄、仄平平仄。平平仄，仄平仄平平、平平仄。仄仄仄平平，仄仄平平仄。仄平平，仄平仄。平仄平平，仄仄平平，平平平仄仄。仄仄仄仄仄，仄平仄，平仄仄。仄仄仄、平平仄。仄平平、平平平仄仄。平仄仄平平，平仄平平仄。仄平平仄仄。,0,50,52,102,"[2, 5, 4, 4, 3, 4, 3, 5, 3, 5, 5, 3, 3, 4, 4, 5, 5, 3, 3, 3, 3, 3, 5, 5, 5, 5]"
倒犯 ,陈允平,仄仄仄平平，仄平仄平平仄。平平仄仄。平平仄、仄平平仄。平平仄仄，平仄平平平平仄。仄仄仄平平，平仄平平仄。仄平平，仄平仄。平仄仄平，仄仄平平，平平平仄仄。仄仄仄平仄，仄平仄，平平仄。仄仄仄、平平仄。仄平平、平仄平平仄。仄仄仄平平，平仄平平仄。仄平平仄仄。,0,51,51,102,"[5, 6, 4, 3, 4, 4, 7, 5, 5, 3, 3, 4, 4, 5, 5, 3, 3, 3, 3, 3, 5, 5, 5, 5]"
瑞鹤仙 ,周邦彦,仄平平仄仄。平仄仄，仄仄平平仄仄。平平仄平仄。仄平平，平仄平平平仄。平平仄仄。仄仄平、平仄仄仄。仄平平仄仄，平仄平平，仄仄平仄。仄仄平平仄仄，仄仄平平，仄平平仄。平平仄仄。平平仄，仄平仄。仄平平，仄仄平平平仄，平平平仄仄仄。仄平平仄仄。平仄仄平仄仄。,0,47,55,102,"[5, 3, 6, 5, 3, 6, 4, 3, 4, 5, 4, 4, 6, 4, 4, 4, 3, 3, 3, 6, 6, 5, 6]"
瑞鹤仙 ,曾觌,仄平平仄仄。仄平平，平平平仄平仄。平平仄平仄。仄平平，平仄仄平平仄。平平仄仄。仄平平、平仄仄仄。仄平平仄仄，平平仄仄，仄平平仄。平仄。平平平仄，仄仄平平，仄平平仄。平平仄仄。平平仄，仄平仄。仄平平，仄仄平平平仄，平平平仄仄仄。仄平平仄仄。平平仄平仄仄。,0,53,49,102,"[5, 3, 6, 5, 3, 6, 4, 3, 4, 5, 4, 4, 2, 4, 4, 4, 4, 3, 3, 3, 6, 6, 5, 6]"
瑞鹤仙 ,杨无咎,仄平平仄仄。平仄仄，平仄平平平仄。平平平仄仄。仄平仄、仄仄平平平仄。仄平仄仄。仄仄平、平平仄仄。仄平平仄仄，平仄仄平，仄平平仄。平仄。平平平仄，仄仄平平，仄平平仄。平平仄平，仄平仄，平平仄。仄平平，平仄平平平仄，平仄仄平仄仄。仄平平仄仄，平仄仄平仄仄。,0,50,52,102,"[5, 3, 6, 5, 3, 6, 4, 3, 4, 5, 4, 4, 2, 4, 4, 4, 4, 3, 3, 3, 6, 6, 5, 6]"
瑞鹤仙 ,毛幵,仄平平仄仄。平平仄，仄仄平平平仄。平平仄平仄。仄平平，平仄平平平仄。平平仄仄。仄平平、平仄仄仄。仄平平仄，仄平仄仄平，仄仄平仄。平仄平平平仄，仄仄平平，仄平平仄。仄平仄仄。平平仄，仄平仄。仄平平平仄，平平平仄，平平仄仄平仄。仄平平、仄仄平平，仄平仄仄。,0,52,50,102,"[5, 3, 6, 5, 3, 6, 4, 3, 4, 4, 5, 4, 6, 4, 4, 4, 3, 3, 5, 4, 6, 3, 4, 4]"
瑞鹤仙 ,赵文,仄平平仄仄。平平仄，仄仄平平仄仄。平平仄平仄。仄平平，平仄平平平仄。平平仄仄。仄仄平、平仄仄仄。仄平平，仄仄平仄平平，仄仄平仄。仄仄平平仄仄，平仄平平，仄平平仄。平平仄仄。平平平仄。仄平平仄仄，仄平平仄，平平平仄仄仄。仄平平仄仄，平仄仄平仄仄。,0,48,52,100,"[5, 3, 6, 5, 3, 6, 4, 3, 4, 3, 6, 4, 6, 4, 4, 4, 4, 5, 4, 6, 5, 6]"
瑞鹤仙 ,周邦彦,仄平平仄仄，仄仄仄平平，平平平仄。平平仄平仄，平平仄，平仄平平平仄。平平仄仄，仄平平、平仄仄仄。仄平平仄仄，平平仄仄，仄仄平仄。平仄。平平平仄，仄平平仄，仄仄平仄。平平仄仄，平仄仄，平平仄。仄平平、平仄平平平仄仄。平平平仄仄仄。仄平平、平仄平仄，仄平仄仄。,0,52,51,103,"[5, 5, 4, 5, 3, 6, 4, 3, 4, 5, 4, 4, 2, 4, 4, 4, 4, 3, 3, 3, 7, 6, 3, 4, 4]"
瑞鹤仙 ,史达祖,仄平平仄仄。仄仄仄平平，仄平平仄。平平仄平仄。仄平平平仄，仄平平仄。平平仄仄。仄仄仄、平平仄仄。仄平平、平仄平平，仄仄仄平平仄。平仄。平平平仄，仄仄平平，仄平平仄。平平仄仄。平平仄，仄平仄。仄平平平仄，平平平仄，仄仄平平仄仄。仄平平、平仄平平，仄平仄仄。,0,52,50,102,"[5, 5, 4, 5, 5, 4, 4, 3, 4, 3, 4, 6, 2, 4, 4, 4, 4, 3, 3, 5, 4, 6, 3, 4, 4]"
瑞鹤仙 ,袁去华,平平平仄仄。仄仄仄平仄，平仄平仄。平平仄平仄。仄平平仄仄，平平平仄。平平仄仄。仄平平、平平仄仄。仄平平、平仄平平平仄，仄平平仄。平仄。平平平仄，仄仄平平，仄平平仄。平平仄仄。平平仄，仄平仄。仄平平平仄，平平平仄，平仄平平仄仄。仄平平、仄仄平平，仄平仄仄。,0,55,47,102,"[5, 5, 4, 5, 5, 4, 4, 3, 4, 3, 6, 4, 2, 4, 4, 4, 4, 3, 3, 5, 4, 6, 3, 4, 4]"
瑞鹤仙 ,刘一止,平平仄平仄。仄仄仄平平，平平平仄。平平仄平仄。仄平平仄仄，平平平仄。平平仄仄。仄平平、平平仄仄。仄仄平，仄仄平平，仄仄仄平平仄。平仄。平平仄仄，仄仄平平，平平仄仄。平平仄仄。平平仄仄平仄。仄平平仄仄，平平平仄，仄仄平平仄仄。仄平平、平仄平平，仄平仄仄。,0,52,50,102,"[5, 5, 4, 5, 5, 4, 4, 3, 4, 3, 4, 6, 2, 4, 4, 4, 4, 6, 5, 4, 6, 3, 4, 4]"
瑞鹤仙 ,赵长卿,仄平平仄仄，仄仄仄平平，平平平仄。仄平仄平仄，平平仄平仄，仄平平仄。平平仄仄，仄平平、平平仄仄。仄平平仄仄，平平仄，仄仄平平仄。平仄。仄仄平仄，仄平平仄，仄仄平仄。平平仄仄，平仄平，平平仄。仄平平平仄，平平仄仄，仄平平仄仄仄。仄平平、仄平平仄，仄平仄仄。,0,49,53,102,"[5, 5, 4, 5, 5, 4, 4, 3, 4, 5, 3, 5, 2, 4, 4, 4, 4, 3, 3, 5, 4, 6, 3, 4, 4]"
瑞鹤仙 ,张枢,仄平平仄仄。仄仄仄平平，平平平仄。平平仄平仄。仄平平，平仄仄平平仄。平平仄仄。平仄仄、平平仄仄。仄仄平、仄仄平平，仄仄仄平平仄。平仄。平平仄仄，仄仄平平，仄平平仄。平平仄仄。平平仄，平仄平仄。仄仄平、仄仄仄平仄仄，仄仄平平仄仄。仄平平、仄仄平平，仄平仄仄。,0,47,56,103,"[5, 5, 4, 5, 3, 6, 4, 3, 4, 3, 4, 6, 2, 4, 4, 4, 4, 3, 4, 3, 6, 6, 3, 4, 4]"
瑞鹤仙 ,洪瑹,仄平平平仄，仄平平平，平平仄仄。平平仄平仄。仄平平仄仄，平平仄仄。平平仄仄。仄仄仄、平平仄仄。仄平平、仄平仄仄，仄平平仄平仄。平仄。平平仄仄，平仄平平，平平仄仄。平平仄仄。平平仄，平平仄。仄平平仄仄，平平平仄，仄仄平平仄仄。仄平平、平仄平平，仄平仄仄。,0,52,49,101,"[5, 4, 4, 5, 5, 4, 4, 3, 4, 3, 4, 6, 2, 4, 4, 4, 4, 3, 3, 5, 4, 6, 3, 4, 4]"
瑞鹤仙 ,白朴,仄平平仄仄。仄仄仄平平，平平平仄。平平仄平仄。仄平平仄仄，仄平平仄。平平仄仄，仄平平平仄仄。仄平平、仄仄平平，平仄仄平平仄。平仄。平平仄仄，仄仄平平，仄平平仄。平平仄仄。仄平仄，仄平仄。平平仄仄，平平平仄，仄仄平平仄仄。仄平平、仄仄平平，仄平仄仄。,0,49,51,100,"[5, 5, 4, 5, 5, 4, 4, 6, 3, 4, 6, 2, 4, 4, 4, 4, 3, 3, 4, 4, 6, 3, 4, 4]"
瑞鹤仙 ,张肎,平平平仄。平平仄平平，仄仄平仄。平平仄仄，仄平平仄，仄平平仄，平平仄仄。仄仄平平仄仄。仄平平，平仄仄，平仄仄平仄。仄仄平平，平平平仄，仄平平仄。平平仄仄，仄平仄、平平平仄。平平仄仄，平平仄、仄仄平仄。仄平平仄仄，平仄仄仄仄。,0,44,46,90,"[4, 5, 4, 4, 4, 4, 4, 6, 3, 3, 5, 4, 4, 4, 4, 3, 4, 4, 3, 4, 5, 5]"
瑞鹤仙 ,蒋捷,仄平平仄。仄。仄平平仄平，仄平平。仄。平平仄平。仄。仄平平，仄仄平平平。仄。平平仄。仄。仄平平、平平仄。仄。仄仄平、仄仄平平，仄仄仄平平。仄。平。仄。平平仄仄，仄仄平平，仄平平。仄。平平仄。仄。平平仄仄平。仄。仄平平仄仄，平平仄仄，仄仄平平仄。仄。仄平平、仄仄平平，仄平仄。仄。,0,49,53,102,"[4, 1, 5, 3, 1, 4, 1, 3, 5, 1, 3, 1, 3, 3, 1, 3, 4, 5, 1, 1, 1, 4, 4, 3, 1, 3, 1, 5, 1, 5, 4, 5, 1, 3, 4, 3, 1]"
瑞鹤仙 ,方岳,仄平平仄仄。仄平平、平仄仄仄。平平仄平仄。仄平平平仄，仄平平仄。平平仄仄。仄平平、平平仄仄。仄平平，仄仄平平，平仄平平平仄。平仄。平平仄仄，平仄平平，仄平平仄。仄平平仄。仄仄平平平仄。仄平平、平仄仄平仄仄，平仄平平仄仄。仄平平、平仄平平，平平仄仄。,0,54,46,100,"[5, 3, 4, 5, 5, 4, 4, 3, 4, 3, 4, 6, 2, 4, 4, 4, 4, 6, 3, 6, 6, 3, 4, 4]"
齐天乐 ,周邦彦,仄平平仄平平仄，平平仄平平仄。仄仄平平，平平仄仄，平仄平平平仄。平平仄仄。仄平仄平平，仄平平仄。仄仄平平，仄平平仄仄平仄。平平平仄仄仄，仄平平仄仄，平仄平仄。仄仄平平，平平仄仄，平仄平平仄仄。平平仄仄。仄仄平平平，仄平平仄。仄仄平平，仄平平仄仄。,0,53,49,102,"[7, 6, 4, 4, 6, 4, 5, 4, 4, 7, 6, 5, 4, 4, 4, 6, 4, 5, 4, 4, 5]"
齐天乐 ,周邦彦,平平仄仄平平仄。平仄仄平平仄。仄仄平平，平平仄仄，平仄平平平仄。平平仄仄。仄平仄平平，仄平平仄。仄仄平平，仄平平仄仄平仄。平平平仄仄仄，仄平平仄仄，仄平平仄。仄仄平平，平平仄仄，仄仄平平平仄。平平仄仄。仄仄仄平平，仄平平仄。仄仄平平，仄平平仄仄。,0,51,51,102,"[7, 6, 4, 4, 6, 4, 5, 4, 4, 7, 6, 5, 4, 4, 4, 6, 4, 5, 4, 4, 5]"
齐天乐 ,吴文英,仄平平仄平平仄，平平仄平平仄。仄仄平平，平平仄仄，平仄平平平仄。平平仄仄。仄平仄平平，仄平平仄。仄仄平平，仄平平仄仄平仄。平平平仄仄仄。仄平平仄仄，平仄平仄。仄仄平平，平平仄仄，平仄平平平仄。平平仄仄。仄仄仄平平，仄平平仄。仄仄平平，仄平平仄仄。,0,53,49,102,"[7, 6, 4, 4, 6, 4, 5, 4, 4, 7, 6, 5, 4, 4, 4, 6, 4, 5, 4, 4, 5]"
齐天乐 ,陆游,仄平平仄平平仄，平平仄平平仄。仄仄平平，平平仄仄，平仄平平平仄。平平仄仄。仄平仄平平，仄平平仄。仄仄平平，仄平平仄仄平仄。平平平仄仄仄。仄平平仄，仄仄仄平平仄。仄仄平平，平平仄仄，仄仄平平平仄。平平仄仄。仄平仄平平，仄平平仄。仄仄平平，仄平平仄仄。,0,53,50,103,"[7, 6, 4, 4, 6, 4, 5, 4, 4, 7, 6, 4, 6, 4, 4, 6, 4, 5, 4, 4, 5]"
齐天乐 ,姜夔,仄平平仄平平仄。平平仄平平仄。仄仄平平，平平仄仄，平仄平平平仄。平平仄仄。仄平仄平平，仄平平仄。仄仄平平，仄平仄仄仄平仄。平平仄平仄仄。仄平平仄仄，平仄平仄。仄仄平平，平平仄仄，仄仄平平平仄。平平仄仄。仄平仄平平，仄平平仄。仄仄平平，仄平平仄仄。,0,52,50,102,"[7, 6, 4, 4, 6, 4, 5, 4, 4, 7, 6, 5, 4, 4, 4, 6, 4, 5, 4, 4, 5]"
齐天乐 ,吕渭老,平平平仄平平仄，平仄仄平平仄。仄仄平平，平平仄仄，平仄平平平仄。平平仄仄。仄仄仄平平，仄平平仄。仄仄平平，仄平平仄仄平仄。平平平平仄，仄仄平、平平平仄，仄平平仄。仄仄平平，平平仄仄，平仄平平仄仄。平平仄仄。仄仄仄平平，仄平平仄。平仄平平，仄平平仄仄。,0,55,48,103,"[7, 6, 4, 4, 6, 4, 5, 4, 4, 7, 5, 3, 4, 4, 4, 4, 6, 4, 5, 4, 4, 5]"
齐天乐 ,吴文英,平平平仄平平仄，平平仄平仄仄。仄仄平平，平平仄仄，仄仄平平平仄。平平仄仄。仄仄仄平平，仄平平仄。仄仄平平，仄平平仄仄平仄。平平平仄仄仄，仄平平仄，仄仄仄平仄。仄仄平平，平平仄仄，平仄平平平仄。平平仄仄。仄平仄平平，仄平平仄。仄仄平平，仄平平仄仄。,0,51,51,102,"[7, 6, 4, 4, 6, 4, 5, 4, 4, 7, 6, 4, 5, 4, 4, 6, 4, 5, 4, 4, 5]"
齐天乐 ,方千里,仄平平仄平平仄，平平仄平平仄。仄仄平平，平平仄仄，平仄平平平仄。平平仄仄。仄平仄平平，仄平平仄。仄仄平平，仄平平仄仄平仄。平平平仄仄仄，仄平平仄仄，平平仄仄平仄。仄仄平平，平平仄仄，仄仄平平仄仄。平平仄仄。仄仄仄平平，仄平平仄。仄仄平平，仄平平仄仄。,0,52,52,104,"[7, 6, 4, 4, 6, 4, 5, 4, 4, 7, 6, 5, 6, 4, 4, 6, 4, 5, 4, 4, 5]"
昼锦堂 ,周邦彦,仄仄平平，平平仄仄，仄仄平仄平平。仄仄仄平平仄，仄仄平平。平平平平平仄仄，仄平平仄仄平平。平平仄，仄仄仄平，平平仄仄平平。平平。仄仄仄，平仄仄，平平平仄平平。仄仄平平仄仄，仄仄平平。仄平平仄平平仄，仄平平仄仄平平。平平仄，平仄仄平平仄，仄仄平平。,0,54,48,102,"[4, 4, 6, 6, 4, 7, 7, 3, 4, 6, 2, 3, 3, 6, 6, 4, 7, 7, 3, 6, 4]"
昼锦堂 ,蒋捷,仄仄平平，平平仄仄，仄仄平仄平平。仄仄仄平平仄，仄仄平平。仄平平平平仄仄，仄平仄仄仄平平。平平仄，仄仄仄平，平平仄仄平平。平仄。平仄仄，平仄仄。平平平仄平平。仄仄平平平仄，仄仄平平。仄平平仄平平仄，仄平平仄仄平平。平平仄，平仄仄平平仄，仄仄平平。,0,53,49,102,"[4, 4, 6, 6, 4, 7, 7, 3, 4, 6, 2, 3, 3, 6, 6, 4, 7, 7, 3, 6, 4]"
昼锦堂 ,宋自逊,平仄平平，平平仄仄，平仄平仄平平。仄仄仄平平仄，仄仄平平。平平仄仄平平仄，平平仄仄仄平平。平平仄，仄仄平平，平平仄仄平平。平平。平仄仄，仄仄仄平平，仄仄平平。仄仄平平仄仄，仄仄平平。平平仄仄平平仄，平平平仄仄平平。平平仄，平仄平平仄仄，平仄平平。,0,57,45,102,"[4, 4, 6, 6, 4, 7, 7, 3, 4, 6, 2, 3, 5, 4, 6, 4, 7, 7, 3, 6, 4]"
昼锦堂 ,孙惟信,仄仄平平，平平仄仄，仄平平仄平平。仄仄平平，平仄仄、仄平平。仄平平仄平平仄，仄平平仄仄平平。平平仄，平仄仄平，平平仄仄平平。平平。平仄仄，平仄仄，平平仄仄平平。仄仄平平，平仄仄仄平平。仄平平仄平平仄，仄平平仄仄平平。平平仄，平仄仄平，平仄仄仄平平。,0,57,45,102,"[4, 4, 6, 4, 3, 3, 7, 7, 3, 4, 6, 2, 3, 3, 6, 4, 6, 7, 7, 3, 4, 6]"
昼锦堂 ,陈允平,仄仄平平，平平仄仄，平平仄仄平仄。仄仄平平，平仄仄平平仄。仄平平仄平仄仄，仄平平仄平平仄。平平仄。平仄仄平，平仄仄平平仄。平仄。平仄仄。平仄仄平平，平仄平仄。仄仄平平，平仄仄平平仄。仄仄平平平仄仄，仄平平仄平平仄。平平仄。仄仄仄平平仄，仄平平仄。,0,51,51,102,"[4, 4, 6, 4, 6, 7, 7, 3, 4, 6, 2, 3, 5, 4, 4, 6, 7, 7, 3, 6, 4]"
氐州第一 ,周邦彦,平仄平平，平仄仄仄，平平仄仄平仄。仄仄平平，平平仄仄，平仄平平仄仄。平仄平平，仄仄仄、平平平仄。仄仄平平，平平仄仄，仄平平仄。仄仄平平平仄仄。仄平仄、仄平平仄。仄仄平平，平平仄仄，仄仄平平仄。仄平平、平仄仄，平平仄、平平仄仄。仄仄平平，仄平平、平平仄仄。,0,51,51,102,"[4, 4, 6, 4, 4, 6, 4, 3, 4, 4, 4, 4, 7, 3, 4, 4, 4, 5, 3, 3, 3, 4, 4, 3, 4]"
氐州第一 ,陈允平,平仄平平，平平仄仄，平平仄仄平仄。仄仄平平，平平平仄，平仄平平仄仄。平仄平平仄，仄仄仄平平仄。仄仄平平，仄平平仄，仄平平仄。仄仄平平平仄仄。平平仄、仄平平仄。仄仄平平，平平仄仄，仄仄平平仄。仄平平、平仄仄。平平仄、平平仄仄。仄仄平平，仄平平、平平仄仄。,0,53,49,102,"[4, 4, 6, 4, 4, 6, 5, 6, 4, 4, 4, 7, 3, 4, 4, 4, 5, 3, 3, 3, 4, 4, 3, 4]"
花发状元红慢 ,刘几,平平仄仄，仄仄平平，仄平仄平仄。平平仄仄。仄平仄，仄仄平平平仄。仄仄平仄平，平仄仄平平平仄。仄平平，仄仄平平仄，仄仄平仄。仄仄平平平仄，仄仄平平，仄平平仄。仄仄平平，仄仄仄。仄平仄、仄仄平仄。仄平平仄仄，平仄仄平平平仄。仄平平，仄仄仄仄平，平仄平仄。,0,45,57,102,"[4, 4, 5, 4, 3, 6, 5, 7, 3, 5, 4, 6, 4, 4, 4, 3, 3, 4, 5, 7, 3, 5, 4]"
恋芳春慢 ,万俟咏,平仄平平，仄平仄仄，仄平平仄平平。仄仄平平，仄仄仄仄平平。仄仄平平仄仄，仄仄仄、仄仄平平。平仄仄、仄仄平平，仄仄平仄平平。平平仄仄，仄平仄仄，平平仄仄，平仄平平。仄仄平平，仄仄仄仄平平。仄仄平平仄仄，仄平仄、平仄平平。平平仄、平仄平平仄平，平仄平平。,0,49,53,102,"[4, 4, 6, 4, 6, 6, 3, 4, 3, 4, 6, 4, 4, 4, 4, 4, 6, 6, 3, 4, 3, 6, 4]"
瑶华 ,周密,平平仄仄。平仄平平，仄平平平仄。平平平仄，平仄仄、仄仄平平平仄。平平平仄，仄平仄、平平平仄。平仄平、平仄平平，仄仄仄平平仄。平平仄仄平平，仄仄仄平平，平仄平仄。平平仄仄，平仄仄、平仄平平平仄。仄平仄仄，仄仄仄、平平平仄。仄仄平、仄仄平平，仄仄仄平平仄。,0,53,49,102,"[4, 4, 5, 4, 3, 6, 4, 3, 4, 3, 4, 6, 6, 5, 4, 4, 3, 6, 4, 3, 4, 3, 4, 6]"
瑶华 ,张雨,平平平仄，仄仄平平，仄仄平平仄。平平仄仄，仄仄仄、仄仄平平平仄。平平仄仄，仄仄仄、平平平仄。仄平平、平仄平平，仄仄仄平平仄。仄平平仄平平，仄仄仄平平，仄仄平仄。平平仄仄，平仄仄、平仄仄平平仄。仄平仄仄，仄仄仄、平平平仄。仄仄仄、平仄平平，仄仄仄平平仄。,0,46,56,102,"[4, 4, 5, 4, 3, 6, 4, 3, 4, 3, 4, 6, 6, 5, 4, 4, 3, 6, 4, 3, 4, 3, 4, 6]"
湘春夜月 ,黄孝迈,仄平平，仄平平仄平平。仄仄仄仄平平，平仄仄平平。仄仄仄平平仄，仄仄平平仄，仄仄平平。仄仄平仄仄，平平仄仄，平仄平平。平平仄仄，平平仄仄，平仄平平。仄仄平平，平仄仄、仄平平仄，平仄平平。平平仄仄，仄仄平、平仄平平。仄仄仄，仄平平仄仄、平平仄仄，平仄平平。,0,51,51,102,"[3, 6, 6, 5, 6, 5, 4, 5, 4, 4, 4, 4, 4, 4, 3, 4, 4, 4, 3, 4, 3, 5, 4, 4]"
曲游春 ,周密,仄仄平平仄，仄仄平平仄，平仄平仄。仄仄平平，仄平平平仄，仄平平仄。仄仄平平仄。仄仄仄、仄平平仄。仄仄平、仄仄平平，平仄仄平平仄。仄仄。平平平仄。仄平仄平平，平仄平仄。平仄平平，仄平平仄仄，仄平平仄。平仄平平仄。仄仄仄、平平平仄。仄仄平、仄仄平平，仄平仄仄。,0,48,55,103,"[5, 5, 4, 4, 5, 4, 5, 3, 4, 3, 4, 6, 2, 4, 5, 4, 4, 5, 4, 5, 3, 4, 3, 4, 4]"
曲游春 ,施岳,仄仄平平仄，仄仄平平仄，平仄平仄。仄仄平平，仄仄平仄仄，仄平平仄。仄仄平平仄。仄仄仄、仄平平仄。仄仄平、仄仄平平，平仄仄平平仄。仄仄。平平仄仄。仄平仄平平，平仄平仄。平仄平平，仄平平仄仄，仄平平仄。仄仄平平仄。仄仄仄、仄平平仄。仄仄平、仄仄平平，仄平仄仄。,0,43,60,103,"[5, 5, 4, 4, 5, 4, 5, 3, 4, 3, 4, 6, 2, 4, 5, 4, 4, 5, 4, 5, 3, 4, 3, 4, 4]"
曲游春 ,赵文,平仄平平仄，仄平平平仄，平仄平仄。仄仄平平，仄平平仄仄，平平平仄。仄仄平平仄。平仄仄、仄平平仄。仄平仄仄平平，平平仄仄平仄。仄仄平平平仄。仄仄仄平平，平仄平仄。仄仄平平，平平平仄仄，平平平仄。仄仄平平仄。仄仄仄、平平仄仄。平仄平仄平平，平平仄仄。,0,51,50,101,"[5, 5, 4, 4, 5, 4, 5, 3, 4, 6, 6, 6, 5, 4, 4, 5, 4, 5, 3, 4, 6, 4]"
竹马儿 ,柳永,平平仄平平，平平仄仄，仄平平仄。仄平仄仄仄，平平仄仄，平平平仄。仄仄仄仄平平，平平仄仄，仄平平仄。仄仄仄平平，仄平平，平仄平平平仄。仄仄平平仄，平平仄仄，仄平平仄。平平仄仄平仄。平仄平平平仄。仄仄仄仄平平，仄平平仄，平仄平平仄。平平仄仄，仄仄平平仄。,0,52,51,103,"[5, 4, 4, 5, 4, 4, 6, 4, 4, 5, 3, 6, 5, 4, 4, 6, 6, 6, 4, 5, 4, 5]"
竹马儿 ,叶梦得,仄平仄、平平平平仄仄，仄平平仄。仄平平仄仄，平仄平仄，平平平仄。仄仄平仄平平，平平仄仄，仄平平仄。平仄仄平平，仄平平平仄，平平平仄。仄仄平平仄，平平仄仄，仄平平仄。平平仄平平仄。仄仄平平平仄。仄仄仄仄平平，仄平平仄，平仄平平仄。平平仄仄，仄平平平仄。,0,55,48,103,"[3, 6, 4, 5, 4, 4, 6, 4, 4, 5, 5, 4, 5, 4, 4, 6, 6, 6, 4, 5, 4, 5]"
长相思慢 ,柳永,仄仄平平，平平仄仄，仄仄平仄平平。平平仄仄仄仄，平平平仄，仄仄平平。仄仄平平。仄平平仄仄，仄仄平平。仄仄平平。仄平平、仄仄平平。仄平仄平平，仄仄平平仄仄，仄仄平平。平平仄仄，仄仄平平，仄仄平平。平平仄仄，仄平平、平仄平平。仄平平、平仄平仄，平平仄仄平平。,0,54,49,103,"[4, 4, 6, 6, 4, 4, 4, 5, 4, 4, 3, 4, 5, 6, 4, 4, 4, 4, 4, 3, 4, 3, 4, 6]"
长相思慢 ,周邦彦,仄仄平平，平平平仄，平仄平仄平平。平平仄仄，仄仄平平，平仄仄仄平平。仄仄平平。仄平平平仄，仄仄平平。仄仄平平。仄平平、仄仄平平。仄平仄平平，仄仄平平仄仄，仄仄平平。平平仄仄，平仄平平，仄仄平平。平平仄仄，仄平平、平仄平平。仄平平仄仄，平仄平平，平仄平平。,0,58,45,103,"[4, 4, 6, 4, 4, 6, 4, 5, 4, 4, 3, 4, 5, 6, 4, 4, 4, 4, 4, 3, 4, 5, 4, 4]"
长相思慢 ,秦观,仄仄平平，仄平仄仄，平平仄仄平平。平平仄仄，仄仄平平，平平平仄平平。仄仄平平。仄平平仄仄，平仄平平。仄仄仄平平。仄平平、平仄平平。仄平仄平平，仄平平仄，平仄仄仄平平。平平平仄仄，仄平平、平仄平平。仄仄平平。平仄仄、平平仄平。仄平平、平平仄仄，仄平平仄平平。,0,60,44,104,"[4, 4, 6, 4, 4, 6, 4, 5, 4, 5, 3, 4, 5, 4, 6, 5, 3, 4, 4, 3, 4, 3, 4, 6]"
长相思慢 ,袁去华,仄仄平平，仄平仄仄，仄仄平仄平平。平平仄仄，仄仄平平，平平平仄平平。仄仄平平。仄平平仄仄，仄仄平平。平仄仄平平。仄平平、仄仄平平。仄仄仄、平平仄仄，平平仄仄，平仄平平。平平平平仄，仄平平、平仄平平。平仄平平，平仄仄、平平仄平。仄平平、平平仄仄，平平平仄平平。,0,60,44,104,"[4, 4, 6, 4, 4, 6, 4, 5, 4, 5, 3, 4, 3, 4, 4, 4, 5, 3, 4, 4, 3, 4, 3, 4, 6]"
雨霖铃 ,柳永,平平平仄。仄平平仄，仄仄平仄。平平仄仄平仄，平平仄仄，平平平仄。仄仄平平仄仄，仄平仄平仄。仄仄仄、平仄平平，仄仄平平仄平仄。平平仄仄平平仄。仄平平、仄仄平平仄。平平仄仄平仄，平仄仄、仄平平仄。仄仄平平，平仄平平，仄仄平仄。仄仄仄、平仄平平，仄仄平平仄。,0,49,54,103,"[4, 4, 4, 6, 4, 4, 6, 5, 3, 4, 7, 7, 3, 5, 6, 3, 4, 4, 4, 4, 3, 4, 5]"
雨霖铃 ,王庭珪,平平仄仄。仄平平、仄仄平平仄。平平仄平仄仄，平平仄仄，平平平仄。仄仄平平平仄，仄平平平仄。仄仄平、平仄平平，仄仄平平仄平仄。仄平仄仄平平仄。仄平平、仄仄平平仄。平平仄平仄仄，仄仄仄、仄平平仄。仄仄平平，平仄平平，仄平平仄。仄仄仄、平仄平平，仄仄平平仄。,0,51,52,103,"[4, 3, 5, 6, 4, 4, 6, 5, 3, 4, 7, 7, 3, 5, 6, 3, 4, 4, 4, 4, 3, 4, 5]"
雨霖铃 ,黄裳,平平平仄。仄平平、仄仄平平仄。平平仄仄平仄，平平仄仄，平平平仄。仄仄平平，仄仄仄、平仄平仄。仄仄仄、平仄平平，仄仄平、平仄平仄。平平仄仄平平仄。仄平平、仄仄平平仄。仄平仄仄平仄，平仄仄、仄平平仄。仄仄平平，平仄平平，仄仄平仄。仄仄仄、仄仄平平，仄仄平平仄。,0,48,55,103,"[4, 3, 5, 6, 4, 4, 4, 3, 4, 3, 4, 3, 4, 7, 3, 5, 6, 3, 4, 4, 4, 4, 3, 4, 5]"
还京乐 ,周邦彦,仄平仄，仄仄平平仄仄平仄仄。仄仄平平仄，仄平仄仄，平平平仄。仄仄平平仄。平平仄仄平平仄。仄仄仄，平仄仄仄，平平平仄。仄平平仄。仄平平平仄，平平仄仄，平平平仄仄仄。平平仄仄平平，仄平平、仄平平仄。仄平平、平仄仄平平，平平仄仄。仄仄平平仄，平平平仄平仄。,0,51,52,103,"[3, 9, 5, 4, 4, 5, 7, 3, 4, 4, 4, 5, 4, 6, 6, 3, 4, 3, 5, 4, 5, 6]"
还京乐 ,陈允平,仄平仄，仄仄平平、仄仄平仄仄。仄平平仄仄，仄平平仄，平平平仄。仄仄平平仄。仄平仄仄平平仄。仄仄仄，平仄平平，平平平仄。仄平平仄。仄平平，平仄平平仄仄。平平仄平仄仄。平平仄仄平平，仄平平、仄平平仄。仄平平、仄仄仄平平，平平仄仄。仄仄平平仄，平平平仄平仄。,0,52,51,103,"[3, 4, 5, 5, 4, 4, 5, 7, 3, 4, 4, 4, 3, 6, 6, 6, 3, 4, 3, 5, 4, 5, 6]"
还京乐 ,方千里,仄平仄，仄仄平平仄仄平仄仄。仄仄平平仄，仄平仄仄，平平平仄。仄仄平平仄。平平仄仄平平仄。仄仄仄平仄，仄仄平平平仄。仄平平仄。仄平平、平仄平平，仄仄平平，平仄仄仄。平平仄仄平平，仄平平、仄平平仄。仄平平、平仄仄平平，平平仄仄。仄仄平平仄，平平平仄平仄。,0,51,52,103,"[3, 9, 5, 4, 4, 5, 7, 5, 6, 4, 3, 4, 4, 4, 6, 3, 4, 3, 5, 4, 5, 6]"
还京乐 ,杨泽民,平平仄。仄仄平平仄仄平仄仄。仄仄平平仄仄平，仄仄平平平仄。仄仄平平仄。平平仄仄平平仄。仄仄仄，平仄仄仄，平平平仄。仄平平仄。仄平平、平仄平平，仄仄平平，平仄仄仄。平平仄仄平平，仄平平、仄平平仄。仄平平、仄仄仄平平，平平仄仄。仄仄平平仄，平平平仄平仄。,0,51,52,103,"[3, 9, 7, 6, 5, 7, 3, 4, 4, 4, 3, 4, 4, 4, 6, 3, 4, 3, 5, 4, 5, 6]"
还京乐 ,吴文英,仄平仄，仄仄平平仄仄平平仄。仄仄平平仄，仄平仄仄，平平平仄。仄仄平平仄，平平仄仄平平仄。仄仄仄，平仄仄平，平平平仄。仄平平仄。仄平平平仄，平平仄仄平平，平仄仄仄。平平仄仄平平，仄平平、仄平平仄。仄平平、平仄仄平平，平平仄仄。仄仄平平仄，平平平仄平仄。,0,53,50,103,"[3, 9, 5, 4, 4, 5, 7, 3, 4, 4, 4, 5, 6, 4, 6, 3, 4, 3, 5, 4, 5, 6]"
还京乐 ,张炎,仄平仄。平仄平平仄仄平仄仄。仄仄平平仄，仄平平仄，平平平仄。仄仄平平仄。平平仄仄平平仄。仄仄仄平，平平仄、平平平仄。仄平平仄，仄仄平平仄，平平仄仄，平仄平平仄仄。平平仄仄平平，仄平平、仄平平仄。仄平平、仄仄仄平平，平平仄仄。仄仄平平仄，仄平平仄平仄。,0,52,51,103,"[3, 9, 5, 4, 4, 5, 7, 4, 3, 4, 4, 5, 4, 6, 6, 3, 4, 3, 5, 4, 5, 6]"
双头莲 ,周邦彦,仄仄平平，仄平平仄，平仄仄平，平平仄仄，仄仄仄平，仄仄仄平平仄。仄平仄。平仄平平，平平平仄，平仄仄平，平平仄仄，仄仄仄平，仄仄平平仄。仄平仄。平仄平仄仄，平平平仄。仄仄平平，仄平平仄，仄仄仄平平仄。平平平仄，仄仄平平，仄平仄仄。仄平仄，仄平平，仄仄仄平仄。,0,47,56,103,"[4, 4, 4, 4, 4, 6, 3, 4, 4, 4, 4, 4, 5, 3, 5, 4, 4, 4, 6, 4, 4, 4, 3, 3, 5]"
双头莲 ,陆游,平仄平平，平仄仄平平，仄平平仄。平平仄仄。仄仄仄、平仄平平平仄。仄仄仄仄平平，仄平平平仄。平仄仄。仄仄平平，平平仄平平仄。仄仄仄仄平平，仄平平仄仄，平平平仄。平平仄仄。仄仄仄、仄仄平平平仄。仄仄仄仄平平，平平平平仄。平仄仄，仄仄平平，平平仄仄。,0,49,51,100,"[4, 5, 4, 4, 3, 6, 6, 5, 3, 4, 6, 6, 5, 4, 4, 3, 6, 6, 5, 3, 4, 4]"
双头莲 ,陆游,平仄平平，平仄仄，平平仄平平仄。仄平仄仄。仄仄仄平仄，平平平仄。仄仄仄仄平平，仄平平平仄。平仄仄。仄仄平平，平平仄平平仄。仄仄仄仄平平，仄平平仄仄，平平平仄。平平仄仄。仄仄仄、仄仄平平平仄。仄仄仄仄平平，平平平平仄。平仄仄。仄仄平平，平平仄仄。,0,48,52,100,"[4, 3, 6, 4, 5, 4, 6, 5, 3, 4, 6, 6, 5, 4, 4, 3, 6, 6, 5, 3, 4, 4]"
双头莲 ,无名氏,仄仄平平，平仄仄平平，仄平平仄。平平仄仄，仄仄仄仄仄，平平平仄。仄仄平仄仄平，仄平平平仄。平平仄、仄仄平平，平平仄平平仄。平仄仄仄平平，仄平平仄仄，平平平仄。平平仄仄，仄仄仄、仄仄平平平仄。仄仄仄仄平平，仄平平平仄。平仄仄，仄仄平平，平平平仄。,0,49,51,100,"[4, 5, 4, 4, 5, 4, 6, 5, 3, 4, 6, 6, 5, 4, 4, 3, 6, 6, 5, 3, 4, 4]"
忆瑶姬 ,曹组,仄仄平平，平平仄仄，平平仄仄平仄。平仄平平平仄，仄仄平仄。平平仄仄平平仄。仄仄仄仄平平仄。仄平平、仄仄平平，仄平仄平仄仄。仄仄平平仄仄。仄平平平仄，平仄平仄。平仄仄平平仄，仄平平仄。仄平仄仄平平仄。仄平平、仄平平仄。仄平仄、仄仄仄平平仄，平平仄仄。,0,48,55,103,"[4, 4, 6, 6, 4, 7, 7, 3, 4, 6, 6, 5, 4, 6, 4, 7, 3, 4, 3, 6, 4]"
忆瑶姬 ,万俟咏,仄仄平平。仄仄平仄仄，仄仄平平。仄平平仄仄，仄仄平平仄，平仄平平。平平仄仄，仄仄平平，仄平仄仄平。仄仄平、平仄平平仄，仄仄平平。仄平仄、仄仄平平，仄平平仄仄，仄仄平平。平平平仄仄，仄仄平平仄，仄仄平平。仄平仄仄，平仄平平，仄平仄仄平。仄仄平、平仄平平仄仄平。,0,49,56,105,"[4, 5, 4, 5, 5, 4, 4, 4, 5, 3, 5, 4, 3, 4, 5, 4, 5, 5, 4, 4, 4, 5, 3, 7]"
忆瑶姬 ,蔡伸,平仄平平。仄平平仄仄，仄仄平平。仄平平仄仄，仄仄平仄仄，平仄平平。平平仄仄，仄仄平平，仄仄平仄平。仄仄平、平仄平平仄，平仄平平。仄仄仄、仄仄平平。仄平平仄仄，仄仄平平。平平平仄仄，仄仄平平仄，平仄平平。平平仄仄，仄仄平平，仄平平仄平。仄仄仄，平仄平平仄仄平。,0,51,54,105,"[4, 5, 4, 5, 5, 4, 4, 4, 5, 3, 5, 4, 3, 4, 5, 4, 5, 5, 4, 4, 4, 5, 3, 7]"
忆瑶姬 ,史达祖,平仄平平，仄仄仄，平平仄仄平平。平平平仄仄，仄仄平平仄，平仄平平。平平仄仄平平，仄仄平平仄仄平。仄仄平、平仄平平，仄平平仄仄平平。仄平仄仄平平。仄仄平平，仄平平仄平平。平平平仄仄，仄仄平平仄，仄仄平平。平平仄仄平平，仄仄平平仄仄平。仄仄平、平仄平平，仄仄平仄平。,0,59,50,109,"[4, 3, 6, 5, 5, 4, 6, 7, 3, 4, 7, 6, 4, 6, 5, 5, 4, 6, 7, 3, 4, 5]"
安平乐慢 ,万俟咏,仄仄平平，仄平仄仄，平平仄仄平平。平平仄仄，仄仄平平，平仄仄仄平平。仄仄平平，仄平平平仄，仄仄平平。仄仄仄平平。平平仄仄平平。仄仄仄平平，仄平平仄，平仄平仄平平。平仄平平仄，仄平仄仄仄平平。仄仄平平，平仄仄、平平仄平。仄平平、平平仄仄，仄平平仄平平。,0,55,48,103,"[4, 4, 6, 4, 4, 6, 4, 5, 4, 5, 6, 5, 4, 6, 5, 7, 4, 3, 4, 3, 4, 6]"
安平乐慢 ,曹勛,仄仄平平，仄平仄仄，平平仄仄平平。平平仄仄，仄仄平平，平平平仄平平。仄仄平平，仄平平平仄，仄仄平平。仄仄仄平平。仄平平、平仄平平。仄平仄平平，仄平平仄，平仄平仄平平。平平平平仄，仄平平、平仄平平。仄仄平平，仄仄仄、平平仄平。仄平平，仄平仄仄，平平平仄平平。,0,61,43,104,"[4, 4, 6, 4, 4, 6, 4, 5, 4, 5, 3, 4, 5, 4, 6, 5, 3, 4, 4, 3, 4, 3, 4, 6]"
望南云慢 ,沈公述,仄仄平平，仄仄仄平平，平仄平平。平平仄仄，仄仄平仄仄，平仄平平。平仄平平仄，仄仄仄、平平仄平。仄平平仄，仄仄平平，仄仄平平。平平。仄仄平平，平平仄仄，平平仄仄平平。平平仄仄，仄平仄平平，仄仄平平。仄仄平平仄，仄仄平、平平仄平。仄平平仄，仄仄平平，仄仄平平。,0,54,49,103,"[4, 5, 4, 4, 5, 4, 5, 3, 4, 4, 4, 4, 2, 4, 4, 6, 4, 5, 4, 5, 3, 4, 4, 4, 4]"
情久长 ,吕渭老,仄平仄仄，平平仄仄平平仄。仄仄仄、仄平平仄，平仄平仄。平平平仄仄，仄仄仄、平仄平平仄仄。仄平仄、平平仄仄，仄仄平平，平仄仄、平平仄。仄仄平平，仄仄平平仄。仄仄仄、仄平平仄，仄仄平仄。平平仄仄，仄平仄、平仄平平仄仄。仄平仄、平平仄仄，仄仄平平，平仄仄、平平仄。,0,44,59,103,"[4, 7, 3, 4, 4, 5, 3, 6, 3, 4, 4, 3, 3, 4, 5, 3, 4, 4, 4, 3, 6, 3, 4, 4, 3, 3]"
西江月慢 ,吕渭老,平平仄仄，平仄仄、仄平平仄。平仄仄平平，平平平仄，仄平平仄。仄仄平、仄仄平平，仄平平仄，仄平平仄。仄仄平、仄仄平平，平仄仄平仄。仄仄仄、平平平仄仄。仄仄仄、平平仄仄。平仄平平平仄仄，仄仄平平仄。仄仄仄、仄仄平平，平平平仄，仄平平仄。仄仄仄、平仄仄平平仄仄。,0,46,57,103,"[4, 3, 4, 5, 4, 4, 3, 4, 4, 4, 3, 4, 5, 3, 5, 3, 4, 7, 5, 3, 4, 4, 4, 3, 7]"
西江月慢 ,无名氏,平平仄仄，仄仄平、平平平仄。仄仄仄、仄仄平平，平仄仄仄平仄。仄仄平平仄平平仄，仄平仄、平平平仄。仄仄平、平仄平平，平仄仄，仄平仄。仄仄仄、平平平仄仄。仄仄仄、平平仄仄。仄仄平、平仄平平，仄仄仄平平仄。仄仄仄，平仄平平仄，仄平平、平平平仄。仄仄仄、仄仄平平，平平平仄。,0,48,58,106,"[4, 3, 4, 3, 4, 6, 8, 3, 4, 3, 4, 3, 3, 3, 5, 3, 4, 3, 4, 6, 3, 5, 3, 4, 3, 4, 4]"
杏花天慢 ,曹勛,平仄平仄，平仄平仄，平仄仄平平仄。仄仄平仄仄，仄仄仄、平仄平平平仄。平平仄仄。仄仄仄、平平平仄。仄仄仄、平仄平平，仄仄仄平平仄。平平平仄仄平，仄平仄平平，仄平平仄。仄仄平仄仄，仄仄平、平仄平平平仄。平仄仄仄。仄仄仄、平仄平仄。仄仄仄、平仄平平，仄平仄仄。,0,44,59,103,"[4, 4, 6, 5, 3, 6, 4, 3, 4, 3, 4, 6, 6, 5, 4, 5, 3, 6, 4, 3, 4, 3, 4, 4]"
探春慢 ,姜夔,平仄平平，仄平仄仄，平平平仄平仄。仄仄平平，平平平仄，平仄平平仄仄。平仄平平仄，仄平仄、平平平仄。仄平平仄平平，仄平平仄平仄。平仄平平仄仄，平仄仄仄平，平仄平仄。仄仄平平，平平平仄，仄仄仄平平仄。平仄平平仄，仄仄仄、平平平仄。仄仄平平，平平平仄平仄。,0,56,47,103,"[4, 4, 6, 4, 4, 6, 5, 3, 4, 6, 6, 6, 5, 4, 4, 4, 6, 5, 3, 4, 4, 6]"
探春慢 ,张炎,平仄平平，仄平平仄，仄仄平平仄仄。仄仄平平，平平仄仄，仄仄平平平仄。平仄平平仄，仄仄仄、平平仄仄。仄平仄仄平平，平平平仄平仄。平仄仄平平仄。仄仄仄平平，仄平平仄。仄仄平平，平平平仄，平仄仄平平仄。仄仄平平仄，仄平仄、仄平平仄。平仄平平，仄平平仄平仄。,0,52,51,103,"[4, 4, 6, 4, 4, 6, 5, 3, 4, 6, 6, 6, 5, 4, 4, 4, 6, 5, 3, 4, 4, 6]"
探春慢 ,周密,仄仄平平，仄平平仄，仄仄仄平平仄。仄仄平平，平平平仄，仄仄仄平平仄。平仄仄平平，仄仄仄、仄平平仄。仄平平仄平平，仄仄仄平平仄。平仄仄平平仄。仄仄仄平平，仄平平仄。仄仄平平，平平仄仄，平仄仄平平仄。平仄仄平平，仄仄仄、仄平平仄。平仄平平，平平仄平平仄。,0,50,53,103,"[4, 4, 6, 4, 4, 6, 5, 3, 4, 6, 6, 6, 5, 4, 4, 4, 6, 5, 3, 4, 4, 6]"
探春慢 ,陈允平,仄仄平平，平平仄仄，平平平仄平仄。仄仄平平，平平平仄，平仄平平平仄。平仄仄平平，仄平仄、仄平平仄。仄平平仄平平，仄仄仄平平仄。仄仄平平平仄。平仄仄平平，平平平仄。仄仄平平，仄平仄仄，仄仄仄平平仄。平仄仄平平，仄仄仄、仄平平仄。仄平平仄平平，仄平平仄。,0,54,49,103,"[4, 4, 6, 4, 4, 6, 5, 3, 4, 6, 6, 6, 5, 4, 4, 4, 6, 5, 3, 4, 6, 4]"
探春慢 ,吴文英,平仄仄平平，仄仄仄平，平平平仄。仄仄平平，仄仄平平仄仄。平平仄，平仄仄，仄平平，平仄仄。仄平平，平平仄仄，仄平平仄。平仄平平仄仄。仄仄仄仄平，平平平仄。仄仄平平，仄仄平平仄仄。平平平平仄仄，仄平仄，平仄仄。仄平平，平平仄仄，仄平平仄。,0,46,48,94,"[5, 4, 4, 4, 6, 3, 3, 3, 3, 3, 4, 4, 6, 5, 4, 4, 6, 6, 3, 3, 3, 4, 4]"
眉妩 ,姜夔,仄平平平仄，仄仄平平，平仄仄平仄。仄仄平平仄，平平仄，平平平仄平仄。仄平仄仄。仄仄平、平仄平仄。仄平仄，仄仄平平仄，仄平仄平仄。平仄。平平平仄。仄仄平平仄，平仄平仄。平仄平平仄，平平仄，平平平仄平仄。仄平仄仄。仄仄平、平仄平仄。仄平仄平平，平仄仄、仄平仄。,0,50,53,103,"[5, 4, 5, 5, 3, 6, 4, 3, 4, 3, 5, 5, 2, 4, 5, 4, 5, 3, 6, 4, 3, 4, 5, 3, 3]"
眉妩 ,王沂孙,仄平平平仄，仄仄平平，平仄仄平仄。仄仄平平仄，平平仄，平平平仄平仄。仄平仄仄。仄仄平、平仄平仄。仄平仄，仄仄平平仄，仄平仄平仄。平仄平平平仄。仄仄平仄仄，平仄平仄。仄仄平平仄，平平仄、平平平仄平仄。仄平仄仄。仄仄平、平仄平仄。仄平仄平平，平仄仄、仄平仄。,0,48,55,103,"[5, 4, 5, 5, 3, 6, 4, 3, 4, 3, 5, 5, 6, 5, 4, 5, 3, 6, 4, 3, 4, 5, 3, 3]"
眉妩 ,张翥,仄平平平仄，仄仄平平，平仄仄平仄。仄仄平平仄，平平仄，平平平仄平仄。仄平仄仄。仄仄平、平仄平仄。仄平仄。仄仄平平仄，仄平仄平仄。平仄。平平平仄。仄仄平平仄，平仄平仄。仄仄平平仄。平平仄，平平平仄平仄。仄平仄仄。仄仄平、平仄平仄。仄平仄平平，平仄仄、仄平仄。,0,49,54,103,"[5, 4, 5, 5, 3, 6, 4, 3, 4, 3, 5, 5, 2, 4, 5, 4, 5, 3, 6, 4, 3, 4, 5, 3, 3]"
湘江静 ,史达祖,平仄平平平仄仄。仄平平、仄平平仄。平平仄仄，平平仄仄，仄平平平仄。仄仄仄平平，仄平仄、平平平仄。平平仄仄，平平仄平，平平仄、仄平仄。仄仄平，平仄仄。仄平平、仄平平仄。平平仄仄，平平仄仄，仄平平平仄。仄仄仄平平，平平仄、仄平平仄。平平仄仄，平平仄仄，平平仄仄。,0,54,49,103,"[7, 3, 4, 4, 4, 5, 5, 3, 4, 4, 4, 3, 3, 3, 3, 3, 4, 4, 4, 5, 5, 3, 4, 4, 4, 4]"
湘江静 ,无名氏,仄平平仄平平仄。仄平仄、仄平平仄。平平仄仄，仄平仄仄，仄平平平仄。平仄仄平平，平平仄、平平平仄。平平仄仄，平平仄仄，平仄仄、仄平仄。平仄平平仄仄，仄平平、仄平平仄。平平仄仄，平平仄仄，仄平平仄仄。平仄仄平平，平仄仄、仄平平仄。平平仄仄，平平仄仄，平平仄仄。,0,52,51,103,"[7, 3, 4, 4, 4, 5, 5, 3, 4, 4, 4, 3, 3, 6, 3, 4, 4, 4, 5, 5, 3, 4, 4, 4, 4]"
金盏子 ,吴文英,仄仄平平，仄仄平平仄，仄平平仄。平仄仄平平，平平仄，平平仄平平仄。仄平仄仄平平，仄平平平仄。平仄仄，平平仄平平仄，仄平平仄。平仄。仄平仄。平仄仄，平平仄仄仄。平平仄平仄仄，平平仄，平平仄仄仄仄。仄仄仄仄平平，仄平平平仄。平平仄、平仄仄仄平平，仄仄平仄。,0,51,52,103,"[4, 5, 4, 5, 3, 6, 6, 5, 3, 6, 4, 2, 3, 3, 5, 6, 3, 6, 6, 5, 3, 6, 4]"
金盏子 ,蒋捷,仄仄平平，仄仄仄，平平仄仄平仄。平仄仄平平，平平仄，平平仄平平仄。仄仄仄仄平平，仄平平仄仄。平平仄，仄仄仄平平平，仄平平仄。平仄仄平仄。平仄仄，平仄仄仄仄。平平仄平仄仄，平平仄，平平仄仄平仄。仄平仄仄平平，仄平平平仄。平平仄，仄仄仄平平平，仄仄平仄。,0,49,54,103,"[4, 3, 6, 5, 3, 6, 6, 5, 3, 6, 4, 5, 3, 5, 6, 3, 6, 6, 5, 3, 6, 4]"
金盏子 ,史达祖,仄仄平平，仄仄平平仄，仄平平仄。仄仄仄平平，平平仄，平仄仄平平仄。平平仄仄平平，仄平平平仄。平平仄，平仄仄平平仄，仄平平仄。平平仄平仄。平平仄，平平仄平仄。平平仄平仄仄，平平仄，平平仄仄平仄。仄仄仄仄平平，仄平平平仄。平平仄，平平仄仄，平平仄仄。,0,54,47,101,"[4, 5, 4, 5, 3, 6, 6, 5, 3, 6, 4, 5, 3, 5, 6, 3, 6, 6, 5, 3, 4, 4]"
金盏子 ,赵以夫,仄仄平平，仄仄平平仄，仄平平仄。平仄仄平平，仄仄仄平平，仄平平仄。平平仄仄平平，仄平平平仄。平平仄，平平仄仄平平，仄平平仄。仄仄仄平平，仄仄仄平平平仄仄。平平平仄平平，仄平仄平平，仄平平仄。平平仄仄平平，仄仄平平仄。平平仄，仄平平仄，平平仄仄。,0,55,46,101,"[4, 5, 4, 5, 5, 4, 6, 5, 3, 6, 4, 5, 8, 6, 5, 4, 6, 5, 3, 4, 4]"
金盏子 ,无名氏,仄仄平平，仄平平仄仄，仄仄平平。仄平平仄，仄平平仄，平平仄仄平平。仄仄平平，仄仄仄仄平平。仄仄平平仄，平平仄仄，仄仄平平。仄平平仄平平。仄仄仄平平，仄平平。平平平仄平平仄，仄仄平平，仄仄平平。平平仄仄，平仄仄仄平平。仄平平、仄仄平平，平平仄仄平平。,0,54,48,102,"[4, 5, 4, 4, 4, 6, 4, 6, 5, 4, 4, 6, 5, 3, 7, 4, 4, 4, 6, 3, 4, 6]"
龙山会 ,赵以夫,仄仄平平仄。仄仄平平，仄仄平平仄。平平平仄仄。平平仄、仄仄平平平仄。平仄仄平平，仄平仄、平平平仄。仄平平，平平仄仄，仄平平仄。平平平仄平平，平仄平平，仄仄平平仄。平平平仄仄。仄平仄、仄仄仄平平仄。仄仄仄平平，平仄仄、平平平仄。仄平平、仄平仄仄，仄平平仄。,0,54,49,103,"[5, 4, 5, 5, 3, 6, 5, 3, 4, 3, 4, 4, 6, 4, 5, 5, 3, 6, 5, 3, 4, 3, 4, 4]"
龙山会 ,吴文英,仄仄平平仄。仄仄平平，仄仄平平仄。仄平平仄仄，平仄仄、平仄平平平仄。平仄仄平平，仄平仄、平平仄仄。仄平平，平平仄仄，平平仄仄。平仄仄仄平平，仄仄平平，仄仄平平仄。仄平平仄仄，平仄仄、平仄平平平仄。平仄仄平平，仄平仄、平平仄仄。仄平平、仄平仄仄，仄平平仄。,0,50,53,103,"[5, 4, 5, 5, 3, 6, 5, 3, 4, 3, 4, 4, 6, 4, 5, 5, 3, 6, 5, 3, 4, 3, 4, 4]"
春云怨 ,冯艾子,平平仄仄。仄仄平平仄，平平平仄。仄仄仄平平仄，仄仄仄平平仄仄。仄仄平平，平平平仄，仄仄平平仄平仄。平仄平平，平平平仄，仄仄仄平仄。平平仄仄平平仄。仄平平仄仄，平平平仄。平仄平平仄平仄。平仄平平，仄仄平平，仄平平仄。仄仄平平，仄平平仄，仄仄仄平仄仄。,0,51,52,103,"[4, 5, 4, 6, 7, 4, 4, 7, 4, 4, 5, 7, 5, 4, 7, 4, 4, 4, 4, 4, 6]"
升平乐 ,吴奕,仄仄平平，仄平平仄，平平仄仄平平。平仄平平，平平仄仄，仄平仄仄平平。平平仄仄，仄平平、仄仄平平。平仄仄，仄平平仄仄，平仄平平。平仄仄平平仄，仄平平仄仄，平仄平平。平仄平平，平平仄仄，平平仄仄平平。平平仄仄，仄平平、平仄平平。平平仄，仄平平平仄，仄仄平平。,0,59,44,103,"[4, 4, 6, 4, 4, 6, 4, 3, 4, 3, 5, 4, 6, 5, 4, 4, 4, 6, 4, 3, 4, 3, 5, 4]"
迎新春 ,柳永,仄仄仄平仄，仄仄平平平仄。平仄平平仄。仄平仄、平平仄。仄平平、平平仄仄。仄仄仄、平仄平平平仄。仄仄平仄仄。平平仄、平平平仄。仄平平仄，仄仄平仄。平仄仄，仄平仄仄平仄。平平仄仄平平仄，仄平平、仄仄平仄。仄平平，平仄平平平平仄。平平仄平仄。仄仄平仄，仄平平仄。,0,50,54,104,"[5, 6, 5, 3, 3, 3, 4, 3, 6, 5, 3, 4, 4, 4, 3, 6, 7, 3, 4, 3, 7, 5, 4, 4]"
归朝欢 ,柳永,仄仄平平平仄仄。平仄平平平仄仄。平平仄仄仄平平，平平平仄平平仄。仄仄平仄仄。仄平平仄平平仄。仄平平，仄平平仄，仄仄仄平仄。仄仄平平平仄仄。仄仄平平平仄仄。平平仄仄仄平平，平平平仄平平仄。仄平平仄仄。仄平平仄平平仄。仄平平，仄平平仄，仄仄平平仄。,0,53,51,104,"[7, 7, 7, 7, 5, 7, 3, 4, 5, 7, 7, 7, 7, 5, 7, 3, 4, 5]"
归朝欢 ,王之道,仄仄平平平仄仄。仄仄仄平平仄仄。平平仄仄仄平平，仄平平仄平平仄。仄仄平平仄。平平平仄平平仄。仄平平，平平仄仄，仄仄平平仄。仄仄平平平仄仄。仄仄平平仄平仄。平平仄仄仄平平，平平平仄平平仄。平平平仄仄。平平平仄平平仄。仄平平，平平仄仄。仄仄平平仄。,0,55,49,104,"[7, 7, 7, 7, 5, 7, 3, 4, 5, 7, 7, 7, 7, 5, 7, 3, 4, 5]"
双声子 ,柳永,仄平平仄，仄平平仄，平仄平仄平平。平平平仄，平平平仄，平仄仄仄平平。仄平平仄仄，平仄仄、平仄平平。平平仄，仄平仄，平平平仄平平。仄平平，平仄平仄仄，平平仄仄平平。平平平仄，平平平仄，平平仄仄平平。仄平平仄仄，平仄仄、平仄平平。平平仄仄平平，仄平仄仄平平。,0,62,42,104,"[4, 4, 6, 4, 4, 6, 5, 3, 4, 3, 3, 6, 3, 5, 6, 4, 4, 6, 5, 3, 4, 6, 6]"
永遇乐 ,苏轼,平仄平平，仄平平仄，平仄平仄。仄仄平平，平平仄仄，仄仄平平仄。仄平仄仄，平平仄仄，仄仄仄平平仄。仄平平、平平平仄，仄平仄平平仄。平平仄仄，平平平仄，仄仄仄平平仄。仄仄平平，平平平仄，平仄平平仄。仄平平仄，平平仄仄，仄仄仄平平仄。仄平仄、平平仄仄，仄平仄仄。,0,51,53,104,"[4, 4, 4, 4, 4, 5, 4, 4, 6, 3, 4, 6, 4, 4, 6, 4, 4, 5, 4, 4, 6, 3, 4, 4]"
永遇乐 ,晁补之,平仄平平，仄平平仄，仄平平仄。平仄平平，平平仄仄，平仄平平仄。仄平平仄，平平平仄。平仄仄平仄仄。仄平平、仄仄平平，平平仄、仄平仄。平平仄仄。平平仄仄，仄仄平平平仄。仄仄平平，平平仄仄，平仄平平仄。平平仄仄，平平平仄，平仄仄平平仄。仄平平、仄仄平平，平平仄仄。,0,57,47,104,"[4, 4, 4, 4, 4, 5, 4, 4, 6, 3, 4, 3, 3, 4, 4, 6, 4, 4, 5, 4, 4, 6, 3, 4, 4]"
永遇乐 ,柳永,平平仄仄，仄仄平平，平仄平仄。仄仄平平，平平仄仄，仄仄平平仄。平平仄仄，平仄平平，仄仄仄平平仄。仄平平平仄，平仄仄平，仄平平仄。平平仄仄，平仄平仄，仄仄平平平仄。平仄平平，仄平仄仄，平仄平平仄。平平平仄平平，平平平仄，仄平平仄。仄平平、仄仄平平，平平仄仄。,0,56,48,104,"[4, 4, 4, 4, 4, 5, 4, 4, 6, 5, 4, 4, 4, 4, 6, 4, 4, 5, 6, 4, 4, 3, 4, 4]"
永遇乐 ,柳永,平仄平平，仄平仄仄，平仄平仄。仄仄平平，平平仄仄，平仄平平仄。平平平仄，平仄平平，仄仄仄平平仄。仄平平、仄仄平平，仄仄仄平平仄。平平仄仄，平仄平平仄仄，平平平仄。平仄平平，平平仄仄，仄仄平平仄。平平平仄，平仄平平，平仄仄平平仄。仄平平、平仄平平，平平仄仄。,0,58,46,104,"[4, 4, 4, 4, 4, 5, 4, 4, 6, 3, 4, 6, 4, 6, 4, 4, 4, 5, 4, 4, 6, 3, 4, 4]"
永遇乐 ,张元干,仄仄平平，平平平仄，平平平仄。平仄平平，平平平仄，仄仄平平仄。仄平平仄，平平仄仄，平仄仄平平仄。仄平平、平平仄仄，仄平仄平仄仄。仄平仄仄，平平仄仄。平仄仄平平仄。仄仄平平，平平仄仄，仄仄平仄仄。平平仄仄，仄平仄仄，仄仄仄、平平仄。仄平平、平平仄仄，仄平仄仄。,0,50,54,104,"[4, 4, 4, 4, 4, 5, 4, 4, 6, 3, 4, 6, 4, 4, 6, 4, 4, 5, 4, 4, 3, 3, 3, 4, 4]"
永遇乐 ,无名氏,平平仄仄，仄平平仄，平仄平仄。仄仄平平，平平平仄，仄仄平平仄。平平平仄平平，平平仄仄，仄仄平平仄。平平仄仄平平，仄平仄平平仄。平平仄平平仄，平仄仄仄，平平平仄。平仄平平，平平仄仄，仄仄平平仄。仄平平仄，平平平仄，仄仄仄仄平仄。仄仄平、仄仄平仄，仄平仄仄。,0,53,51,104,"[4, 4, 4, 4, 4, 5, 6, 4, 5, 6, 6, 6, 4, 4, 4, 4, 5, 4, 4, 6, 3, 4, 4]"
永遇乐 ,陈允平,仄仄平平，仄平平仄，平平平平。仄仄平平，平平仄仄，平仄平仄平。平平平仄，平平平仄，仄平仄仄平平。平平仄、平平仄仄，仄平仄仄平平。平平仄仄，平平仄仄，仄平平仄平平。仄仄平平，平平仄仄，平仄平仄平。平平平仄，仄平平仄，仄平仄仄平平。平平仄、平平仄仄，仄平仄平。,0,60,44,104,"[4, 4, 4, 4, 4, 5, 4, 4, 6, 3, 4, 6, 4, 4, 6, 4, 4, 5, 4, 4, 6, 3, 4, 4]"
二郎神 ,柳永,平平仄。仄仄仄、平平平仄。仄仄仄平平平仄仄，平平仄、仄平平仄。平仄平平平仄仄，仄仄仄、平平仄仄。仄仄仄、平平仄仄，仄仄平平平仄。平仄。平平仄仄，仄平平仄。仄仄仄、平平平仄仄，平仄仄、平平平仄。仄仄平平平仄仄，仄平仄、平平仄仄。仄平仄平平，仄仄平平，平平平仄。,0,49,55,104,"[3, 3, 4, 8, 3, 4, 7, 3, 4, 3, 4, 6, 2, 4, 4, 3, 5, 3, 4, 7, 3, 4, 5, 4, 4]"
二郎神 ,王十朋,平平仄。仄仄仄、平平平仄。仄仄仄仄平平仄仄。平仄仄、平平平仄。平仄平平平仄仄。平仄仄、平平仄仄。仄平仄、平平仄仄，仄仄平平平仄。仄仄。平平仄仄，平平平仄。仄平仄平平平仄仄。仄平仄、仄平平仄。仄仄平平平仄仄。仄仄仄、平平仄仄。平仄仄、平平仄仄，平仄平平平仄。,0,48,56,104,"[3, 3, 4, 8, 3, 4, 7, 3, 4, 3, 4, 6, 2, 4, 4, 8, 3, 4, 7, 3, 4, 3, 4, 6]"
二郎神 ,张安国,仄平仄。仄平仄、平平平仄。仄仄仄平平平仄仄，仄仄仄、平平平仄。平仄仄平平仄仄，仄仄仄、仄平平仄。平平仄、平平平仄，平仄平平平仄。平仄。平仄平仄，平平仄仄。仄仄仄平平平仄仄，平仄仄、平平平仄。仄仄仄、平平平仄仄，平仄仄、平平仄仄。仄平平平仄，仄仄平平，平平平仄。,0,51,54,105,"[3, 3, 4, 8, 3, 4, 7, 3, 4, 3, 4, 6, 2, 4, 4, 8, 3, 4, 3, 5, 3, 4, 5, 4, 4]"
二郎神 ,徐伸,仄平仄仄，仄仄仄、仄平平仄。仄仄仄平平，平平平仄，平仄平平仄仄。仄仄平平平平仄，仄仄仄、平平平仄。仄仄仄仄平，平平平仄，仄平平仄。平仄。仄平仄仄，平平平仄。仄仄仄平平，仄平平仄，平仄平平仄仄。仄仄仄平，仄平平仄，平仄仄平平仄。平仄仄、仄仄平平仄仄，仄平平仄。,0,47,58,105,"[4, 3, 4, 5, 4, 6, 7, 3, 4, 5, 4, 4, 2, 4, 4, 5, 4, 6, 4, 4, 6, 3, 6, 4]"
二郎神 ,赵以夫,仄平仄仄，仄仄仄、仄平平仄。仄仄仄平平，平平平仄，平仄平平仄仄。仄仄平平平仄仄，仄仄仄、平平平仄。平仄仄平平，平平平仄，仄平平仄。平仄仄平仄仄，平平仄仄。仄仄仄平平，平平平仄，平仄平平仄仄。仄仄平平，仄平仄仄，平仄平平平仄。平仄仄，仄仄平平，仄仄仄平平仄。,0,49,56,105,"[4, 3, 4, 5, 4, 6, 7, 3, 4, 5, 4, 4, 6, 4, 5, 4, 6, 4, 4, 6, 3, 4, 6]"
二郎神 ,曹勛,仄平仄仄。仄仄平、平平仄仄。仄仄仄平平，平平平仄，仄仄平平仄仄。仄仄平平，仄平平仄，仄仄平平平仄。平仄仄、仄仄平平，平仄仄平平仄。平仄。平平仄仄，平平平仄。仄仄仄平平，平平仄仄，仄仄平平仄仄。仄仄平平，平平平仄，仄仄仄平平仄。仄仄仄、仄仄平平，平平仄仄。,0,47,56,103,"[4, 3, 4, 5, 4, 6, 4, 4, 6, 3, 4, 6, 2, 4, 4, 5, 4, 6, 4, 4, 6, 3, 4, 4]"
二郎神 ,马庄父,仄平仄仄，仄仄仄、仄平平仄。仄仄仄、平平平仄，仄仄平平平仄。平仄平平平平仄，仄仄仄、平平平仄。仄仄仄平平，平平平仄，仄平平仄。平仄。仄平仄仄，仄平平仄。仄仄仄平平，平平仄仄，平仄仄平仄仄。仄仄平平，仄平平仄，仄仄仄平平仄。平仄仄，仄仄平平仄仄，仄平平仄。,0,45,58,103,"[4, 3, 4, 3, 4, 6, 7, 3, 4, 5, 4, 4, 2, 4, 4, 5, 4, 6, 4, 4, 6, 3, 6, 4]"
二郎神 ,汤恢,仄平仄仄，平仄仄、仄平平仄。仄仄仄平平，平平平仄，平仄平平仄。仄仄平平平平仄，仄仄仄、仄平平仄。平仄仄仄平，平平平仄，仄平平仄。平仄。平平仄仄，平平平仄。仄仄仄平平，仄平仄仄，平仄平平仄仄。平仄平平，平平仄仄，平仄仄平平仄。仄仄仄，平仄平平仄仄，仄平平仄。,0,50,54,104,"[4, 3, 4, 5, 4, 5, 7, 3, 4, 5, 4, 4, 2, 4, 4, 5, 4, 6, 4, 4, 6, 3, 6, 4]"
二郎神 ,吕渭老,平平仄仄。仄仄仄平平仄。仄仄仄、平平仄仄，平仄平平仄仄。仄仄平平平仄仄，平仄仄、仄平平仄。平平仄，仄仄平平，仄仄仄平平仄。平仄。平平仄仄，仄平平仄。仄仄仄、平平仄仄，仄仄平平仄仄。仄仄平平平仄仄，仄仄仄、仄平平仄。仄平仄、平仄平平，平仄仄平平仄。,0,42,58,100,"[4, 6, 3, 4, 6, 7, 3, 4, 3, 4, 6, 2, 4, 4, 3, 4, 6, 7, 3, 4, 3, 4, 6]"
倾杯乐 ,柳永,平仄平平，仄平平仄，平平仄仄平仄。仄平仄仄，平仄仄仄，仄仄平平仄。仄平仄仄仄平仄，仄平平平仄。平平仄仄，平仄仄、平仄平平平仄。仄平仄平平仄，仄平平仄，平仄平平仄。仄仄仄平平，仄平平仄，仄平平平仄。仄仄平平，仄平平仄，平仄平平仄。仄平仄。平仄仄、平平仄仄。,0,50,54,104,"[4, 4, 6, 4, 4, 5, 7, 5, 4, 3, 6, 6, 4, 5, 5, 4, 5, 4, 4, 5, 3, 3, 4]"
倾杯乐 ,柳永,仄仄平平，仄平平仄，平平仄仄平仄。仄仄仄仄，仄仄仄仄，仄仄平平仄。平平仄仄平平仄，仄仄平平仄。平平仄仄，平仄仄、仄仄平平平仄。仄仄。平平仄仄，仄平平仄，平仄平平仄。仄仄仄平平，平平平仄仄，平平平仄。仄仄平平，平平平仄，仄仄平平仄。仄平仄。平仄仄、仄平平仄。,0,47,57,104,"[4, 4, 6, 4, 4, 5, 7, 5, 4, 3, 6, 2, 4, 4, 5, 5, 5, 4, 4, 4, 5, 3, 3, 4]"
倾杯乐 ,柳永,仄仄平平，仄平仄仄，仄平仄仄。仄平仄、平平仄仄，平平平仄，平平平仄。平平仄仄平平仄。仄平平仄，平仄仄平平仄。仄平平仄，仄仄平平仄仄。平仄仄、平平平仄。仄仄仄平平、平仄仄。仄仄仄、仄仄平平，平平仄仄平仄。仄仄仄、平平仄仄。平仄仄、平平平仄。仄仄仄平仄仄，平平仄仄。,0,47,59,106,"[4, 4, 4, 3, 4, 4, 4, 7, 4, 6, 4, 6, 3, 4, 5, 3, 3, 4, 6, 3, 4, 3, 4, 6, 4]"
倾杯乐 ,程珌,平仄平平，仄平平仄，平平平仄。仄平仄、平平仄仄，平平平仄，仄平平仄。仄平平仄平平仄。平仄平平仄仄，平平仄仄。仄平仄仄。仄仄平平平仄。仄仄仄、仄平平仄。仄仄仄平平、平仄仄。仄平平、仄仄平平，仄仄平平仄仄。仄仄仄、平平仄仄。仄平仄、仄平仄仄。平仄仄仄平平，仄平平仄。,0,49,57,106,"[4, 4, 4, 3, 4, 4, 4, 7, 6, 4, 4, 6, 3, 4, 5, 3, 3, 4, 6, 3, 4, 3, 4, 6, 4]"
倾杯乐 ,张先,平平仄仄，平平仄，平平仄。仄仄平平，平平平仄，平平仄仄，平平仄仄。仄仄仄平平，仄平平、仄仄平平仄。仄仄平平，仄平平仄，平平仄仄，平平仄仄。仄仄仄平平仄，平平仄仄。平平仄仄。仄平平、仄仄平平，仄平仄平平、平仄仄。平平仄仄。平平仄、仄仄平平，仄仄平平仄。平平仄仄平平仄。,0,55,52,107,"[4, 3, 3, 4, 4, 4, 4, 5, 3, 5, 4, 4, 4, 4, 6, 4, 4, 3, 4, 5, 3, 4, 3, 4, 5, 7]"
倾杯乐 ,柳永,平仄平平，平平平仄，平平仄平平仄。平平仄仄仄，平仄仄仄平平，仄平仄仄。仄平平、平仄平平平仄，仄仄仄平平，仄平平仄。仄平平仄，平平仄平平仄仄。仄仄平、平平平仄。仄仄平平平，平平平仄，仄仄平平，仄平仄仄平平仄。平仄仄平仄。平平仄、平仄平平，平平平仄。平平仄仄平平仄。,0,61,47,108,"[4, 4, 6, 5, 6, 4, 3, 6, 5, 4, 4, 7, 3, 4, 5, 4, 4, 7, 5, 3, 4, 4, 7]"
倾杯乐 ,柳永,仄仄平平，仄平平仄，平仄平平仄。平平仄仄，平平仄仄，仄仄平平平仄。仄平仄仄平平，平平仄仄。平平仄仄，平平仄仄。仄仄平仄，平仄平平仄仄。仄仄仄、平平平仄。仄平仄、平平平仄。仄仄仄平平，平平平仄，仄仄平平仄。平平仄仄平仄。仄仄仄、仄仄平平，平平仄仄。仄仄仄仄，平平平仄。,0,51,57,108,"[4, 4, 5, 4, 4, 6, 6, 4, 4, 4, 4, 6, 3, 4, 3, 4, 5, 4, 5, 6, 3, 4, 4, 4, 4]"
倾杯乐 ,柳永,仄平平仄，仄平平、仄仄平平仄。仄仄仄平平仄。平平仄、仄仄平平，仄仄平平，平平仄仄。仄平仄、平仄仄平平，平仄平平，平仄平平平仄，平平平仄。平仄平平，仄平平仄，仄仄平平平仄。仄仄平平，平平仄仄，仄仄平平仄仄。仄仄平平平仄。平仄平仄平仄仄。仄仄平平，仄仄平平，仄平平仄。,0,56,52,108,"[4, 3, 5, 6, 3, 4, 4, 4, 3, 5, 4, 6, 4, 4, 4, 6, 4, 4, 6, 6, 7, 4, 4, 4]"
倾杯乐 ,柳永,平平仄仄，仄平平仄、平平仄。仄仄平平平仄，平平仄仄，仄仄平平仄仄。仄平仄平平，仄平平仄，平平仄。仄仄平平平仄。仄平仄仄，仄仄平平平仄。仄仄仄平仄仄，平平仄仄，平平平仄。仄平平、仄仄平平，仄仄仄、平平平仄仄。仄平仄仄。平平仄、仄仄平平，平仄平平仄。仄仄仄仄平平平仄。,0,51,57,108,"[4, 4, 3, 6, 4, 6, 5, 4, 3, 6, 4, 6, 6, 4, 4, 3, 4, 3, 5, 4, 3, 4, 5, 8]"
倾杯乐 ,柳永,仄仄平平，仄平平仄，平平仄仄平平仄。仄平仄、平平平仄。平平仄、平平平仄。平仄仄、仄仄平平仄。平平仄平仄仄，仄仄平平仄。平平仄仄，仄平平仄平平仄。仄仄平、平仄平仄。仄仄仄仄平，仄平平仄，仄仄平平，平仄仄、仄仄仄仄平仄。仄仄仄、仄仄平平，仄平仄仄平平仄平仄。仄仄平仄仄，平平仄仄平平仄。,0,52,64,116,"[4, 4, 7, 3, 4, 3, 4, 3, 5, 6, 5, 4, 7, 3, 4, 5, 4, 4, 3, 6, 3, 4, 9, 5, 7]"
百宜娇 ,吕渭老,仄仄平平，仄平平仄，平仄仄平平仄。仄仄平平，仄平平仄，仄仄平平平仄。平平仄仄，仄仄仄、平平平仄。仄平平、平仄仄平，仄平平仄平仄。平仄仄、平平仄仄。平仄仄平平，仄平平仄。仄仄平平，仄仄仄仄，平仄平平平仄。平平仄仄，仄仄仄、平平平仄。仄平平、仄仄仄平，仄平平仄。,0,50,54,104,"[4, 4, 6, 4, 4, 6, 4, 3, 4, 3, 4, 6, 3, 4, 5, 4, 4, 4, 6, 4, 3, 4, 3, 4, 4]"
月中桂 ,赵彦端,仄仄平平，仄平平仄平，仄仄平仄。平平仄仄，仄仄平平仄，平平平仄。仄平平仄仄。仄仄仄、平平仄仄。平仄平平仄，平平仄仄，平仄仄平仄。平平仄仄平平仄。仄平平仄仄，仄仄平仄。平平仄仄，仄仄平平仄，平平平仄。仄平平仄仄，仄仄仄、平平仄仄。仄仄平平仄，平平仄平平仄仄。,0,48,57,105,"[4, 5, 4, 4, 5, 4, 5, 3, 4, 5, 4, 5, 7, 5, 4, 4, 5, 4, 5, 3, 4, 5, 7]"
月中桂 ,无名氏,仄仄平平，仄平平，仄平平仄平仄。平平仄仄，仄仄平平仄，平平平仄。仄平平仄仄，仄仄仄、平平仄仄。仄仄平平仄，平平仄平，平仄仄平仄。平平仄仄平平，仄平平仄平，平仄平仄。平平仄仄，仄仄平平仄，平平平仄。仄平平仄仄，仄仄仄、平平仄仄。仄仄平平仄，平平仄平平仄仄。,0,51,53,104,"[4, 3, 6, 4, 5, 4, 5, 3, 4, 5, 4, 5, 6, 5, 4, 4, 5, 4, 5, 3, 4, 5, 7]"
月中桂 ,赵孟頫,平仄平平。仄平平仄仄，平仄平平。平平仄仄，仄平仄平平，平仄平平。仄平平仄仄，仄平仄、平平仄仄。仄仄平仄平。平平仄平，平仄平仄。平仄仄仄平平。仄平平仄仄，平平平仄。仄仄仄平，仄平仄平平，平仄平平。平平平仄仄，仄平仄、平平平仄。仄平仄仄平，平仄仄平平仄。,0,55,47,102,"[4, 5, 4, 4, 5, 4, 5, 3, 4, 5, 4, 4, 6, 5, 4, 4, 5, 4, 5, 3, 4, 5, 6]"
澡兰香 ,吴文英,平平仄仄，仄仄平平，仄仄仄平仄仄。平平仄仄，仄仄平平，仄仄仄平平仄。仄平平、平仄平平，平平平平仄仄。平仄仄、平平仄仄，平平平仄。仄仄平平仄仄，仄仄平平，仄平平仄。平平仄仄，仄仄平平，仄仄仄平平仄。仄平平、仄仄平平，平仄平平仄仄。仄仄仄、仄仄平平，平平平仄。,0,50,54,104,"[4, 4, 6, 4, 4, 6, 3, 4, 6, 3, 4, 4, 6, 4, 4, 4, 4, 6, 3, 4, 6, 3, 4, 4]"
宴琼林 ,黄裳,平仄仄平平，仄仄仄平平，平仄平仄。仄平仄、仄仄仄平平，仄仄平平平仄。平平仄，仄平平，仄平平仄仄。仄平平、仄仄平平仄，仄平平平仄。仄仄平平，仄仄仄平平，平平平仄。仄仄仄、仄平平仄。仄平平平仄。平平仄、平平仄仄，平平仄、仄平平仄。仄平平平，仄平平仄，平平仄平仄。,0,54,50,104,"[5, 5, 4, 3, 5, 6, 3, 3, 5, 3, 5, 5, 4, 5, 4, 3, 4, 5, 3, 4, 3, 4, 4, 4, 5]"
宴琼林 ,黄裳,平仄仄平平，仄仄仄平平，平仄平仄。仄平平、仄仄仄平平，仄仄仄平平仄。平平仄仄，平仄仄、平平仄仄。仄平平、仄仄平平仄，仄平平平仄。平仄平平仄仄，仄平平、平仄平仄。仄仄仄仄平平仄，仄平平仄仄。平平仄、平平仄仄，仄平仄、仄平平仄。仄平平仄平平仄，平平仄平仄。,0,50,53,103,"[5, 5, 4, 3, 5, 6, 4, 3, 4, 3, 5, 5, 6, 3, 4, 7, 5, 3, 4, 3, 4, 7, 5]"
潇湘逢故人慢 ,王安礼,平平平仄，平平平仄仄，平仄平平。仄平仄平平。仄平仄平仄，仄仄平平。平平仄仄，仄平平、仄仄平平。仄平仄、仄平平仄，仄平仄仄平平。平平仄，平仄仄，仄平平、仄平平仄平平。仄仄仄平平。仄平仄平平，平仄平平。平平仄仄，仄平仄、平仄平平。平平仄、仄平平仄，仄平仄仄平平。,0,58,46,104,"[4, 5, 4, 5, 5, 4, 4, 3, 4, 3, 4, 6, 3, 3, 3, 6, 5, 5, 4, 4, 3, 4, 3, 4, 6]"
潇湘逢故人慢 ,钱应金,平平平仄，平平平平仄，仄仄平平。仄仄仄，平平仄，平仄平仄，仄仄平平。平平仄仄，仄平平、仄仄平平。仄平仄、仄平平仄，平平仄仄平平。平平仄，平仄仄，仄平平、仄平平仄平平。仄仄仄平平。仄平仄平平，平仄平平。平平仄仄，仄平仄、平仄平平。平平仄、仄平仄仄，仄平仄仄平平。,0,57,47,104,"[4, 5, 4, 3, 3, 4, 4, 4, 3, 4, 3, 4, 6, 3, 3, 3, 6, 5, 5, 4, 4, 3, 4, 3, 4, 6]"
惜余欢 ,黄庭坚,仄平仄仄，仄平仄仄平，平仄平仄。平仄仄平平，仄平仄平仄。平仄平平，仄平仄仄，仄平仄、仄仄平平仄。仄平平仄，仄平仄平，仄平平仄。平平仄平仄仄。仄仄仄平平，平仄平仄。平仄仄平平，仄平仄平仄。平平平仄，平平仄仄，仄平仄、仄仄平平仄。仄平平仄，平平仄平，仄平平仄。,0,50,54,104,"[4, 5, 4, 5, 5, 4, 4, 3, 5, 4, 4, 4, 6, 5, 4, 5, 5, 4, 4, 3, 5, 4, 4, 4]"
拜星月慢 ,周邦彦,仄仄平平，平平平仄，仄仄平平仄仄。仄仄平平，仄平平平仄。仄平仄，仄仄、平平仄仄平仄，仄仄平平平仄。仄仄平平，仄平平平仄。仄平平、仄仄平平仄。平平仄、仄仄平平仄。仄仄仄仄平平，仄平平平仄。仄平平、仄仄平平仄。平平仄、仄仄平平仄。平仄仄、仄仄平平，仄平平仄仄。,0,50,54,104,"[4, 4, 6, 4, 5, 3, 2, 6, 6, 4, 5, 3, 5, 3, 5, 6, 5, 3, 5, 3, 5, 3, 4, 5]"
拜星月慢 ,周密,仄仄平平，平平平仄，平仄平平平仄。仄仄平平，仄平平平仄。仄平仄、仄仄平平平仄，仄仄仄仄，平平平仄。平仄平平，仄平平平仄。仄平平、仄仄平平仄。仄平平、仄仄平平仄。仄仄仄平平仄，仄平平平仄。仄平平、仄仄平平仄。平平仄、仄仄平平仄。仄平仄、平仄平平，仄平平仄仄。,0,54,50,104,"[4, 4, 6, 4, 5, 3, 6, 4, 4, 4, 5, 3, 5, 3, 5, 6, 5, 3, 5, 3, 5, 3, 4, 5]"
拜星月慢 ,陈允平,仄仄平平，平平仄仄，仄仄平平仄仄。仄仄平平，仄仄平平仄。仄平仄，仄仄平平仄仄，仄仄平平平仄。仄仄平平，仄平平平仄。仄平平、仄仄平平仄。仄平平、仄仄平平仄。平仄仄仄平平，仄平平平仄。仄平平、仄仄平平仄。平平仄、仄仄平平仄。仄仄仄、仄仄平平，仄平平仄仄。,0,47,55,102,"[4, 4, 6, 4, 5, 3, 6, 6, 4, 5, 3, 5, 3, 5, 6, 5, 3, 5, 3, 5, 3, 4, 5]"
拜星月慢 ,彭泰翁,仄仄平平，平平平仄，仄仄平平仄仄。仄仄平平，仄平平平仄。仄平仄、仄仄平平仄仄，仄仄仄平平仄。仄仄平平，仄平平平仄。仄平平、仄仄平平仄。平平仄、仄仄平平仄。仄仄仄仄平平，仄平平平仄。平平仄仄平平仄。平平仄、平仄平平仄。仄仄仄、平仄平平，仄平平仄仄。,0,49,52,101,"[4, 4, 6, 4, 5, 3, 6, 6, 4, 5, 3, 5, 3, 5, 6, 5, 7, 3, 5, 3, 4, 5]"
绮寮怨 ,周邦彦,仄仄平平平仄，仄平平仄平。仄仄仄、仄仄平平，平平仄、仄仄平平。平平平平仄仄，平平仄、仄仄平仄平。仄仄平、仄仄平平，平平仄、仄仄平仄平。仄仄仄平仄平。平平仄仄，平平仄仄平平。仄仄平平。仄平仄、仄平平。平平仄平平仄，仄仄仄、仄平平。平平仄平。平平仄仄仄、平仄平。,0,53,51,104,"[6, 5, 3, 4, 3, 4, 6, 3, 5, 3, 4, 3, 5, 6, 4, 6, 4, 3, 3, 6, 3, 3, 4, 5, 3]"
绮寮怨 ,陈允平,仄仄平平平仄，仄平平仄平。仄仄仄、仄仄平平，平平仄、仄仄平平。平平平平仄仄，平平仄、仄仄平仄平。仄仄平仄仄，平平仄、仄仄平仄平。仄仄仄平仄平，平平平仄，平平仄仄平平。仄仄平平，平平仄、仄平平。平平仄平平仄，仄仄仄、仄平平。平平仄平，平平仄仄仄、平仄平。,0,53,49,102,"[6, 5, 3, 4, 3, 4, 6, 3, 5, 5, 3, 5, 6, 4, 6, 4, 3, 3, 6, 3, 3, 4, 5, 3]"
绮寮怨 ,鞠华翁,仄仄平平平仄，仄平平仄平。仄仄仄、仄仄平平，平平仄、仄仄平平。平平平平仄仄，平平仄、仄仄平仄平。仄仄平、仄仄平平，平平仄、仄仄平仄平。仄仄仄平仄平。平平仄仄，平平仄仄平平。仄仄平平。仄平仄、仄平平。平平仄平平仄，仄仄仄、仄平平。平平仄平。平平仄、仄仄仄平。,0,52,51,103,"[6, 5, 3, 4, 3, 4, 6, 3, 5, 3, 4, 3, 5, 6, 4, 6, 4, 3, 3, 6, 3, 3, 4, 3, 4]"
花心动 ,史达祖,平仄平平，仄平平、平平仄平平仄。仄仄仄平，平仄平平，平仄仄平平仄。仄平平仄平平仄，仄平仄、仄平平仄。仄平仄，平平仄仄，仄平平仄。仄仄平平仄仄。平仄仄、平平仄平平仄。仄仄仄平，仄仄平平，平仄仄平平仄。仄平平仄平平仄，仄平仄、仄平平仄。仄仄仄、平平仄平仄仄。,0,51,53,104,"[4, 3, 6, 4, 4, 6, 7, 3, 4, 3, 4, 4, 6, 3, 6, 4, 4, 6, 7, 3, 4, 3, 6]"
花心动 ,周邦彦,平仄平平，平平仄、平平仄平平仄。平仄仄平，平仄平平，仄仄仄平平仄。仄平平仄平平仄，平平仄、平平平仄。仄平仄，平平仄仄，仄平平仄。仄仄平平仄仄。平仄仄、平平仄平平仄。平仄仄平，仄仄平仄，仄仄仄平平仄。仄平仄仄平平仄。平仄仄、平平平仄。平仄仄。平平仄平仄仄。,0,53,51,104,"[4, 3, 6, 4, 4, 6, 7, 3, 4, 3, 4, 4, 6, 3, 6, 4, 4, 6, 7, 3, 4, 3, 6]"
花心动 ,吴文英,仄仄平平，仄平平、平仄仄平平仄。仄仄平平，仄仄平平，仄仄仄平平仄。仄平平仄平平仄。平仄仄、平平平仄。仄平仄，平平仄仄，仄平平仄。仄仄平平仄仄。平平仄、平平仄平平仄。仄仄平平，平仄平平，仄仄仄平平仄。平平仄仄平平仄，平平仄、平平平仄。仄平仄，平平仄平仄仄。,0,54,50,104,"[4, 3, 6, 4, 4, 6, 7, 3, 4, 3, 4, 4, 6, 3, 6, 4, 4, 6, 7, 3, 4, 3, 6]"
花心动 ,刘焘,平仄平平，仄平仄平平，仄仄平仄。平仄仄平，平仄平平，仄仄仄平平仄。仄平平仄平平仄，平仄仄、平平平仄。仄平仄平平，仄平仄平平仄。仄仄平平仄仄。仄平仄平平，仄平仄仄。仄仄仄平，平仄平平，仄仄仄平平仄。仄平平仄平平仄，平平仄、仄平仄仄。仄仄仄、平平仄平仄仄。,0,50,54,104,"[4, 5, 4, 4, 4, 6, 7, 3, 4, 5, 6, 6, 5, 4, 4, 4, 6, 7, 3, 4, 3, 6]"
花心动 ,赵长卿,平仄平平，仄平平、仄仄平仄平仄。仄仄仄平，平仄平平，仄仄仄平平仄。仄平平仄平平仄，平平仄、仄平平仄。仄平仄。平平仄仄，仄平仄仄。仄仄平平平仄。平仄仄、平平仄平平仄。仄仄仄平，仄仄平平，仄仄仄平平仄。仄平仄仄平平仄，平仄仄、平平平仄。仄平仄。仄平仄平仄仄。,0,48,56,104,"[4, 3, 6, 4, 4, 6, 7, 3, 4, 3, 4, 4, 6, 3, 6, 4, 4, 6, 7, 3, 4, 3, 6]"
花心动 ,谢逸,平仄平平平仄仄，平仄平平平仄。平仄平平，平仄平平，平仄仄平平仄。平平仄仄平平仄，平仄仄、仄平平仄。平平仄，平平平仄，仄平平仄。仄仄平平仄仄。仄仄仄平平，仄平平仄。仄仄平平，仄仄仄平，仄仄仄平平仄。仄平仄仄仄平平，平平仄，平平平仄。仄仄仄，仄仄平平平仄。,0,53,51,104,"[7, 6, 4, 4, 6, 7, 3, 4, 3, 4, 4, 6, 5, 4, 4, 4, 6, 7, 3, 4, 3, 6]"
花心动 ,曹勛,平仄平平，仄平平、平平仄平平仄。仄仄仄平，平仄平平，仄仄仄平平仄。仄仄仄平仄，仄平平、平平平仄。仄仄仄，平平仄仄，仄平平仄。平仄平平仄仄。平平仄平平，仄平平仄。仄平仄仄，平仄平平，仄仄仄平平仄。仄平仄仄仄，仄仄仄、平平平仄。仄平仄，仄平仄仄仄仄。,0,46,54,100,"[4, 3, 6, 4, 4, 6, 5, 3, 4, 3, 4, 4, 6, 5, 4, 4, 4, 6, 5, 3, 4, 3, 6]"
花心动 ,赵长卿,仄仄平平，仄平平仄仄，仄平平仄。仄仄仄平，平仄平平，仄仄仄平平仄。仄平平仄平平仄，仄平仄、仄平平仄。仄平仄，仄平平，仄平仄平平仄。平仄平平平仄。平仄仄、平平仄平平仄。仄仄仄平，仄仄平平，仄仄仄平平仄。仄平仄仄平平仄，平仄仄、平平平仄。仄仄仄。平平仄平仄仄。,0,49,56,105,"[4, 5, 4, 4, 4, 6, 7, 3, 4, 3, 3, 6, 6, 3, 6, 4, 4, 6, 7, 3, 4, 3, 6]"
花心动 ,无名氏,仄仄平平，仄仄平、仄仄平平平仄。平平仄仄，仄仄平平，平仄平平平仄。平仄平平平仄平，平仄仄平平仄仄。仄仄仄平平，平平仄仄。仄仄平平仄。平平平仄，仄仄平平仄。仄仄平平，平平仄仄，仄仄平平平仄。仄平平仄平仄平，仄仄仄平平平仄。平平仄仄平，平仄平仄。,0,52,49,101,"[4, 3, 6, 4, 4, 6, 7, 7, 5, 4, 5, 4, 5, 4, 4, 6, 7, 7, 5, 4]"
向湖边 ,江纬,仄仄平平，平平平仄，仄仄仄平平仄。仄仄平平，仄平平平仄。仄仄平、平仄平平，平平平仄，仄仄仄平平仄。仄仄平平，仄平平仄仄。仄仄平平，仄仄平平仄。平仄仄仄仄，平平平平仄。仄仄平平，仄平平平仄。仄平平平仄平平仄。平平仄、平仄仄平平仄仄。仄仄平平，仄仄平平仄。,0,53,51,104,"[4, 4, 6, 4, 5, 3, 4, 4, 6, 4, 5, 4, 5, 5, 5, 4, 5, 8, 3, 7, 4, 5]"
阳春 ,杨无咎,仄平平，平仄仄，平仄仄平平仄。平仄仄平平，平平仄、仄仄平仄仄平仄。仄平平仄。平仄仄、平平平仄。平仄仄仄平平仄，平平仄平平仄。仄平仄平平、平平仄，平仄仄、平平仄仄。平平平平仄仄，仄平平、仄仄平仄。平平仄仄仄仄。仄仄仄、平平平仄。仄平仄、仄仄平平仄，平平仄仄。,0,51,53,104,"[3, 3, 6, 5, 3, 7, 4, 3, 4, 7, 6, 5, 3, 3, 4, 6, 3, 4, 6, 3, 4, 3, 5, 4]"
阳春 ,史达祖,仄平平，平平仄，平仄仄平平仄。平仄仄平平，平平仄、仄仄平仄仄平仄。仄平平仄。平仄仄、仄平平仄。平仄仄仄平平，仄平平、仄平平仄。仄平仄平平、平平仄，平仄仄、平平仄仄。平平平平仄仄，仄平平、仄仄平仄。平平仄仄仄仄。仄仄仄、平平平仄。仄平仄、仄仄平平仄，平平仄仄。,0,51,53,104,"[3, 3, 6, 5, 3, 7, 4, 3, 4, 6, 3, 4, 5, 3, 3, 4, 6, 3, 4, 6, 3, 4, 3, 5, 4]"
送入我门来 ,胡浩然,平仄平平，平平仄仄，平平仄仄平平。仄仄平平，仄仄仄平平。平平平仄平平仄，仄仄仄平平平仄平。仄平仄，仄仄平平仄仄，平仄平平。平仄平平仄仄，平平仄平仄仄，仄仄平平。仄仄平平，平仄仄平平。仄平仄仄平平仄，仄平仄平平仄仄平。仄平平仄仄，仄平平仄，仄仄平平。,0,54,50,104,"[4, 4, 6, 4, 5, 7, 8, 3, 6, 4, 6, 6, 4, 4, 5, 7, 8, 5, 4, 4]"
绕池游慢 ,韩淲,平平仄仄，仄平平仄仄，仄仄平平。仄仄平平平仄仄，平平仄、平仄平平。仄仄平平仄，平仄仄、仄仄平平。平平仄仄，平平仄仄，仄仄平平。平仄平平仄仄，平仄仄平仄，平仄平平。仄仄平平平仄仄，仄仄仄、平仄平平。仄仄平仄仄，仄平平、平仄平平。仄仄仄平，平平平仄，平仄平平。,0,52,52,104,"[4, 5, 4, 7, 3, 4, 5, 3, 4, 4, 4, 4, 6, 5, 4, 7, 3, 4, 5, 3, 4, 4, 4, 4]"
索酒 ,曹勛,仄仄仄平平仄，仄平平仄，仄平平仄。仄平平平仄仄，仄平平仄，平仄平仄。仄仄平平，仄平平平仄仄平仄。仄平平平平仄，仄仄平平平仄。平平平仄仄平平，仄仄仄仄平，仄平平仄。仄仄平平仄，仄仄仄、平仄平平平仄。仄仄平平，仄平平、平平仄平仄。仄平仄仄平平，仄平仄仄。,0,51,53,104,"[6, 4, 4, 6, 4, 4, 4, 8, 6, 6, 7, 5, 4, 5, 3, 6, 4, 3, 5, 6, 4]"
瑞云浓慢 ,陈亮,仄平仄仄，仄平平仄，平仄仄平平仄。仄平仄仄，仄仄仄平，仄平仄仄仄仄。平平仄仄，仄仄仄、仄仄平平仄仄。仄仄平、仄平平仄仄，仄仄平仄。仄平平，平仄仄。仄平仄、仄仄平平仄。仄平平仄，平仄仄平，仄仄仄平平仄。平平仄仄，仄平平、平平仄仄。仄仄平、仄平仄平平，仄平仄仄。,0,40,64,104,"[4, 4, 6, 4, 4, 6, 4, 3, 6, 3, 5, 4, 3, 3, 3, 5, 4, 4, 6, 4, 3, 4, 3, 5, 4]"
霜花腴 ,吴文英,仄平仄仄，仄仄平，平平仄仄平平。平仄平平，仄平平仄，平平仄仄平平。仄平仄平。仄仄平、平仄平平。仄平平、仄仄平平，仄平平仄仄平平。平仄仄平平仄，仄平平仄仄，仄仄平平。平仄平平，平平平仄，平平仄仄平平。仄平仄平。仄仄平、平仄平平。仄平平、仄仄平平，仄平平仄平。,0,59,45,104,"[4, 3, 6, 4, 4, 6, 4, 3, 4, 3, 4, 7, 6, 5, 4, 4, 4, 6, 4, 3, 4, 3, 4, 5]"
绮罗香 ,史达祖,仄仄平平，平平仄仄，平仄平平平仄。仄仄平平，平仄仄平平仄。平仄仄、仄仄平平，仄平仄、仄平平仄。仄平平、平仄平平，仄平仄仄仄平仄。平平平仄仄仄，平仄平平仄仄，平平平仄。仄仄平平，平仄仄平平仄。平仄仄、平仄平平，仄仄平、仄平平仄。仄平仄、平仄平平，仄平平仄仄。,0,53,51,104,"[4, 4, 6, 4, 6, 3, 4, 3, 4, 3, 4, 7, 6, 6, 4, 4, 6, 3, 4, 3, 4, 3, 4, 5]"
绮罗香 ,张炎,仄仄平平，平平仄仄，平仄仄平平仄。平仄平平，仄仄仄平平仄。仄平仄、平仄平平，仄平仄、平平平仄。仄平平、仄仄平平，仄平仄仄仄平仄。平平平仄仄仄。平仄平平仄仄，平平平仄。仄仄平平，仄仄仄平平仄。仄平平、仄仄平平，仄仄仄、仄平平仄。仄平平、仄仄平平，仄平平仄仄。,0,51,53,104,"[4, 4, 6, 4, 6, 3, 4, 3, 4, 3, 4, 7, 6, 6, 4, 4, 6, 3, 4, 3, 4, 3, 4, 5]"
绮罗香 ,张炎,仄仄平平，平平仄仄，仄仄平平平仄。仄仄平平，平仄仄平平仄。平平仄、平仄平平，仄仄仄、仄平平仄。仄仄仄、平仄平平，平平仄仄仄平仄。平平平仄仄仄。仄平平仄仄，平仄平仄。仄仄平平，平仄仄平平仄。平仄仄、平仄平平，平仄仄、仄平平仄。平平仄、仄仄平平，仄平平仄仄。,0,50,53,103,"[4, 4, 6, 4, 6, 3, 4, 3, 4, 3, 4, 7, 6, 5, 4, 4, 6, 3, 4, 3, 4, 3, 4, 5]"
玉连环 ,冯艾子,仄平仄仄，仄平平、仄平平仄，平平平仄。仄平平仄仄，平平仄仄，平仄仄平平仄。平平平仄仄，仄仄仄平仄。仄平平仄，仄平平仄，平平仄仄。平仄仄仄平平，仄平平、仄仄平平平仄。仄仄仄平平，平平平仄，平仄平仄仄仄。仄平平仄仄，仄平平平仄。平平仄仄，仄平平仄，仄平仄仄。,0,50,54,104,"[4, 3, 4, 4, 5, 4, 6, 5, 5, 4, 4, 4, 6, 3, 6, 5, 4, 6, 5, 5, 4, 4, 4]"
春从天上来 ,吴激,仄仄平平。仄仄仄平平，仄仄平平。仄仄平仄，平仄平平。平仄仄仄平平。仄平平平仄，仄仄仄、仄仄平平。仄平平，仄平平仄仄，平仄平平。平平仄平仄仄，仄仄仄平平，仄仄平平。仄仄平平，平平平仄，平仄仄仄平平。仄平平平仄，平平仄、仄仄平平。仄平平。仄仄平平仄，平仄平平。,0,54,50,104,"[4, 5, 4, 4, 4, 6, 5, 3, 4, 3, 5, 4, 6, 5, 4, 4, 4, 6, 5, 3, 4, 3, 5, 4]"
春从天上来 ,张翥,仄仄平平。仄仄仄平平，仄仄平平。平仄平仄，仄仄平平。平仄仄仄平平。仄平平平仄，仄仄仄、仄仄平平。仄平平。仄平平仄仄，仄仄平平。平平仄平仄仄，仄仄仄平平，平仄平平。仄仄平平，平平平仄，仄仄平仄平平。仄平平平仄，平平仄、仄仄平平。仄平平。仄仄平平仄，平仄平平。,0,54,50,104,"[4, 5, 4, 4, 4, 6, 5, 3, 4, 3, 5, 4, 6, 5, 4, 4, 4, 6, 5, 3, 4, 3, 5, 4]"
春从天上来 ,张炎,仄仄平平。仄仄平平仄，平仄平平。仄仄平平，仄平平仄，平仄仄仄平平。平仄平平平仄，平仄仄、仄仄平平。仄平平。仄仄平平仄，平仄平平。平平。仄平仄仄，仄仄仄平平，仄仄平平。平仄平平，仄平仄仄，平平平仄平平。仄仄平平平仄，平平仄、平仄平平。仄平平。仄平平仄仄，仄仄平平。,0,58,48,106,"[4, 5, 4, 4, 4, 6, 6, 3, 4, 3, 5, 4, 2, 4, 5, 4, 4, 4, 6, 6, 3, 4, 3, 5, 4]"
春从天上来 ,周伯阳,仄仄平平。仄平仄平仄，仄仄平平。仄仄平仄，平仄平平。仄仄仄仄平平。仄平平平仄，仄平仄、仄仄平平。仄平平，仄平平仄，仄仄平平。平平仄平仄仄，仄仄平仄仄，仄仄平平。平仄平平，仄平平仄，仄仄仄仄平平。仄平平平仄，平平仄、平仄平平。仄平平，仄平平仄，平仄平平。,0,52,50,102,"[4, 5, 4, 4, 4, 6, 5, 3, 4, 3, 4, 4, 6, 5, 4, 4, 4, 6, 5, 3, 4, 3, 4, 4]"
西湖月 ,黄子行,平平仄仄平平，仄仄仄平平，仄平平仄。仄平平仄，平平仄仄，仄平平仄。仄平平仄仄，仄仄仄、平平平仄仄。仄仄仄、平仄平平，平仄仄平平仄。平平仄仄平平，仄仄仄平平，仄平平仄。仄平平仄，平平仄仄，仄平平仄。平平平仄仄，仄仄仄、平平平仄仄。仄平仄、平仄平平，仄平平仄。,0,51,53,104,"[6, 5, 4, 4, 4, 4, 5, 3, 5, 3, 4, 6, 6, 5, 4, 4, 4, 4, 5, 3, 5, 3, 4, 4]"
西湖月 ,黄子行,平平仄仄平平，仄仄仄平平，仄平平仄。仄平仄仄，平平仄仄，仄平平仄。平平平仄仄，仄仄仄平平、平仄仄。仄仄仄、仄仄平平，仄仄仄平平仄。仄平仄仄平平，仄仄仄平平，仄仄平仄。仄平平仄，平平仄仄，仄平平仄。平平平仄仄，仄仄仄、平平平仄仄。平仄仄仄平平，仄仄平仄。,0,45,58,103,"[6, 5, 4, 4, 4, 4, 5, 5, 3, 3, 4, 6, 6, 5, 4, 4, 4, 4, 5, 3, 5, 6, 4]"
爱月夜眠迟慢 ,无名氏,仄仄平平，仄仄平仄仄，平仄平平。仄平平仄，平平仄仄，平平仄仄平平。平平仄仄平平，仄平平仄平平。仄平平、仄平平，仄仄平仄平平。平仄仄仄平平，仄平平仄仄，仄仄平平。仄平平仄，仄仄仄仄，平仄仄仄平平。平平仄仄平平，平平仄仄平平。仄平平、仄平仄，仄仄仄仄平平。,0,54,50,104,"[4, 5, 4, 4, 4, 6, 6, 6, 3, 3, 6, 6, 5, 4, 4, 4, 6, 6, 6, 3, 3, 6]"
合欢带 ,柳永,平平平、仄仄平平。仄平仄、仄平平。仄仄平平平仄仄，仄平平、仄仄平平。平平仄仄，平平仄仄，仄仄平平。仄平平、仄仄平平仄仄，平仄平平。平平平仄，平仄平平，平平平仄平平。仄仄平平平仄仄，仄平平、仄仄平平。平平仄仄，平平平仄，仄仄平平。仄平平、仄仄平平，仄平平仄平平。,0,61,44,105,"[3, 4, 3, 3, 7, 3, 4, 4, 4, 4, 3, 6, 4, 4, 4, 6, 7, 3, 4, 4, 4, 4, 3, 4, 6]"
合欢带 ,杜安世,平平平仄平平。仄平仄、仄平平。仄仄平平平仄仄，仄平平、仄仄平平。平平仄仄，平平仄仄，仄仄平平。仄平平、仄平平仄，仄平平仄平平。仄平平仄仄平平。仄平平、仄仄平平。仄仄平平平仄仄，仄平平、仄仄平平。平平仄仄，平平仄仄，平仄平平。仄平平、仄平平仄，仄平平仄仄平平。,0,59,46,105,"[6, 3, 3, 7, 3, 4, 4, 4, 4, 3, 4, 6, 7, 3, 4, 7, 3, 4, 4, 4, 4, 3, 4, 7]"
曲玉管 ,柳永,仄仄平平，平平仄仄，平平仄仄平平仄。仄仄平平平仄，平仄平平。仄平平。仄仄平平，平平平仄，仄平仄仄平平仄。仄仄平平，仄仄平仄平平。仄平平。仄仄平平，仄平仄、平平平仄，仄平仄仄平平，平平仄仄平平。仄平平。仄平平平仄，仄仄平平平仄，仄平平仄，仄仄平平，仄仄平平。,0,58,47,105,"[4, 4, 7, 6, 4, 3, 4, 4, 7, 4, 6, 3, 4, 3, 4, 6, 6, 3, 5, 6, 4, 4, 4]"
早梅芳慢 ,柳永,仄平平，平平仄。仄平平仄平平仄。平平仄仄，仄平仄仄，平仄平平平仄。仄平仄仄，平仄平平，仄平平仄仄，平平平仄，平平仄仄，仄仄平平仄。仄平平，仄平仄仄平平，仄仄平平仄。平平仄仄，仄平仄仄，平平平平仄仄。平平仄仄，仄仄平平，仄平平，仄仄平平，平仄平平，仄仄平平仄。,0,55,50,105,"[3, 3, 7, 4, 4, 6, 4, 4, 5, 4, 4, 5, 3, 6, 5, 4, 4, 6, 4, 4, 3, 4, 4, 5]"
尉迟杯 ,柳永,仄平仄。仄仄平平仄平平仄。平平仄仄平平，仄仄平平平仄。平平平仄。仄仄仄、仄仄平平仄。仄平平、仄仄平平，仄仄平平平仄。平平仄仄平仄。平平仄、平平仄仄平仄。仄仄平平，平平仄仄，仄仄仄平平仄。平平仄、平平平仄。仄仄仄、平平平平仄。仄平平、仄仄平平，仄仄平平平仄。,0,54,51,105,"[3, 8, 6, 6, 4, 3, 5, 3, 4, 6, 6, 3, 6, 4, 4, 6, 3, 4, 3, 5, 3, 4, 6]"
尉迟杯 ,无名氏,仄平仄。仄平平仄仄平仄仄。平平仄仄平平，平平仄平平仄。平平平仄。平平仄、仄仄平平仄。仄平平、仄仄平平，仄平平仄平仄。平平仄仄平平，平平仄、平平仄仄平仄。仄仄平平，平平仄仄，平仄仄平平仄。平平仄、平平平仄。仄平仄、平平平平仄。仄平平、仄仄平平，仄平平平平仄。,0,60,45,105,"[3, 8, 6, 6, 4, 3, 5, 3, 4, 6, 6, 3, 6, 4, 4, 6, 3, 4, 3, 5, 3, 4, 6]"
尉迟杯 ,贺铸,仄平仄。仄平平仄仄平平仄。平平仄，仄平平，平仄仄，平平仄。平平平仄。仄平仄、平仄平平仄。仄平平、仄仄平平，仄仄平平平仄。仄平仄。平平仄。平平仄、平平仄平平仄。仄仄平平，平平仄仄。平仄仄平平仄。平平仄、平平平仄。仄平仄、平仄平平仄。仄平平、仄仄平平，仄仄平平平仄。,0,58,47,105,"[3, 8, 3, 3, 3, 3, 4, 3, 5, 3, 4, 6, 3, 3, 3, 6, 4, 4, 6, 3, 4, 3, 5, 3, 4, 6]"
尉迟杯 ,周邦彦,平平仄。仄仄仄、仄仄平平仄。平平仄仄平平，平仄平平平仄。平平仄仄，平仄仄、平平仄平仄。仄平平、仄仄平平，仄平平仄平仄。平仄仄仄平平，平平仄、平平仄仄平仄。仄仄平平平平仄，平仄仄、平平仄仄。平平仄、平平仄仄，仄平仄、平平仄仄仄。仄平平、仄仄平平，仄平平仄平仄。,0,54,51,105,"[3, 3, 5, 6, 6, 4, 3, 5, 3, 4, 6, 6, 3, 6, 7, 3, 4, 3, 4, 3, 5, 3, 4, 6]"
尉迟杯 ,万俟咏,仄平仄。仄仄仄平仄、仄仄仄。平平仄仄平平，平仄仄仄平仄。仄仄仄平仄。仄平仄、平仄平仄仄。平平平仄仄平仄，仄仄平平平仄。平平仄仄平仄。仄平仄平平，仄平仄仄。仄仄平平，平平仄仄，仄仄仄平平仄。平平仄平仄平仄。仄平仄、仄仄平平仄。仄平平、仄仄平平，仄平仄仄平仄。,0,45,61,106,"[3, 5, 3, 6, 6, 5, 3, 5, 7, 6, 6, 5, 4, 4, 4, 6, 7, 3, 5, 3, 4, 6]"
尉迟杯 ,陈允平,平平仄。仄仄仄、仄仄平平仄。平平仄仄平平，平仄平平平仄。平平仄仄，平仄仄、平平仄平仄。仄平平、仄仄平平，仄平平仄平仄。平仄仄仄平平，仄仄仄平平，仄仄平仄。仄仄平平平平仄，平仄平平仄仄。仄平平、平平仄仄，仄平仄、平平平仄仄。仄平平、仄仄平平，仄平平仄平仄。,0,53,51,104,"[3, 3, 5, 6, 6, 4, 3, 5, 3, 4, 6, 6, 5, 4, 7, 6, 3, 4, 3, 5, 3, 4, 6]"
尉迟杯 ,晁补之,仄平平。仄平仄、仄仄平仄平。平平仄仄平平，平仄仄仄平平。平平仄平仄，仄仄平、仄仄仄平平。平仄仄、平仄平平，仄平平仄平平。仄仄仄仄平平。仄平平平仄，仄仄平平。仄仄平平平仄仄，仄平平仄仄平平。平平仄、平仄平平，仄仄平、仄仄仄平平。仄平仄、仄仄平平，仄平平仄平平。,0,55,51,106,"[3, 3, 5, 6, 6, 5, 3, 5, 3, 4, 6, 6, 5, 4, 7, 7, 3, 4, 3, 5, 3, 4, 6]"
花发沁园春 ,刘圻父,仄仄平平，仄平平仄，仄平仄仄平仄。平平仄仄，仄仄平平，平仄仄平平仄。平平平仄。平仄仄、平平平仄。仄仄仄平仄平平，仄平平仄平仄。仄仄平平仄仄。仄平平平平，仄仄平仄。平平仄仄，仄仄平平，仄仄仄平平仄。平平仄仄。平仄仄、平平平仄。仄仄仄、仄仄平平，仄平平仄平仄。,0,50,55,105,"[4, 4, 6, 4, 4, 6, 4, 3, 4, 7, 6, 6, 5, 4, 4, 4, 6, 4, 3, 4, 3, 4, 6]"
花发沁园春 ,王诜,仄仄平平，仄平平仄，平平平仄平平。平平仄平，仄仄仄平，平仄仄仄平平。平平平仄，仄仄仄、仄仄平平。仄仄仄、平仄平平，仄平平仄平平。仄仄平平仄仄，仄平仄平仄，平仄平平。平平仄仄，仄平仄仄，平平仄仄平平。平平平仄，仄仄平、平仄平平。仄仄仄、平仄平平，仄平平仄平平。,0,56,49,105,"[4, 4, 6, 4, 4, 6, 4, 3, 4, 3, 4, 6, 6, 5, 4, 4, 4, 6, 4, 3, 4, 3, 4, 6]"
赏南枝 ,曾巩,仄平平仄仄，仄平仄仄仄，仄仄平平。仄仄仄平平，仄平仄、仄仄平仄平平。平仄仄、仄仄平。仄仄仄、仄平仄平。仄仄仄平仄仄，仄仄仄平平。平平仄仄平平。仄平平仄，仄平仄平平。仄仄仄平平，平平仄、仄仄仄仄平平。平仄仄、平仄平。仄仄仄、平平仄平。仄平仄平平仄，仄平仄平平。,0,45,60,105,"[5, 5, 4, 5, 3, 6, 3, 3, 3, 4, 6, 5, 6, 4, 5, 5, 3, 6, 3, 3, 3, 4, 6, 5]"
南浦 ,程垓,平仄仄平平，仄仄平，平平仄仄平仄。平仄仄平平，平平仄、平仄仄平平仄。平平仄仄，仄平平仄平平仄。仄平仄仄。平平仄平平，仄平平仄。平平仄仄平平，仄平仄平平，平平平仄。仄仄仄平平，平平仄、平仄仄平平仄。平平仄仄，仄平平仄平平仄。仄平仄仄。平仄仄平平，平平平仄。,0,58,47,105,"[5, 3, 6, 5, 3, 6, 4, 7, 4, 5, 4, 6, 5, 4, 5, 3, 6, 4, 7, 4, 5, 4]"
南浦 ,周邦彦,仄仄仄平平，仄仄平、平平仄仄平仄。平仄仄平平，平平仄、平仄仄平平仄。平平仄仄，仄平仄仄平平仄。仄仄仄平平，平仄平平，平平平仄。平平仄仄平平，仄仄仄、平平平仄平仄。平仄仄平平，平平仄、平平仄仄平仄。平平仄仄，仄仄平仄平平仄。仄平平仄仄，仄仄平平，平平平仄。,0,55,50,105,"[5, 3, 6, 5, 3, 6, 4, 7, 5, 4, 4, 6, 3, 6, 5, 3, 6, 4, 7, 5, 4, 4]"
南浦 ,史达祖,仄仄仄平平，仄仄平，平平仄仄平仄。平仄仄平平，平仄仄、平仄仄平平仄。平平仄仄，仄平仄仄平平仄。仄仄仄仄，平平仄平平，平平平仄。平平仄仄平平，仄仄平平平，平仄平仄。平仄仄平平，平平仄、平仄仄平平仄。平平仄仄，仄平平仄平平仄。仄平仄仄，平平仄平平，平平平仄。,0,56,49,105,"[5, 3, 6, 5, 3, 6, 4, 7, 4, 5, 4, 6, 5, 4, 5, 3, 6, 4, 7, 4, 5, 4]"
南浦 ,张炎,平仄仄平平，仄平平，仄仄平平平仄。平仄仄平平，平平仄、平仄平平平仄。平平仄仄，仄平平仄平平仄。平仄平平平仄仄，仄仄仄平平仄。平平平仄平平，仄平平、仄仄平平仄仄。平仄仄平平，平平仄、平仄仄平平仄。平平仄仄。仄平平仄平平仄。平仄平平平仄仄，平仄仄平平仄。,0,59,46,105,"[5, 3, 6, 5, 3, 6, 4, 7, 7, 6, 6, 3, 6, 5, 3, 6, 4, 7, 7, 6]"
南浦 ,鲁逸仲,平平仄仄，仄平平、平仄仄平平。平仄平平平仄，平仄仄平平。仄仄仄平平仄，仄平平、仄仄仄平平。仄仄平平仄，仄平平仄，平仄仄平平。仄仄仄平仄仄，仄平平、平仄仄平平。仄平平平平仄，平仄仄平平。仄仄仄平平仄，仄平平、仄仄仄平平。仄仄平平仄，仄平平仄仄平平。,0,52,50,102,"[4, 3, 5, 6, 5, 6, 3, 5, 5, 4, 5, 6, 3, 5, 6, 5, 6, 3, 5, 5, 7]"
西河 ,周邦彦,平仄仄。平平仄仄平仄。平平仄仄仄平平，仄平仄仄。仄平仄仄仄平平，平平平仄平仄。仄平仄，平仄仄。仄平仄仄平仄。平平仄仄仄平平，仄平仄仄。仄平仄仄仄平平，平平平仄平仄。仄平仄仄仄仄仄。仄平平、平仄平仄。仄仄仄平平仄。仄平平、仄仄平平，平仄平仄平平，平平仄。,0,49,56,105,"[3, 6, 7, 4, 7, 6, 3, 3, 6, 7, 4, 7, 6, 7, 3, 4, 6, 3, 4, 6, 3]"
西河 ,辛弃疾,平平仄。仄仄平平平仄。平平仄仄仄平平，仄平平仄。平平仄仄仄平平，平平平仄平仄。仄平平，仄平仄。仄仄仄平平仄。仄平仄仄仄平平，仄平平仄。仄平仄仄仄平平，平平仄仄平仄。仄平平、仄平仄仄。仄平平、平仄平仄。仄仄仄平平仄。仄平平、仄仄平平平仄，仄仄平平平平仄。,0,53,52,105,"[3, 6, 7, 4, 7, 6, 3, 3, 6, 7, 4, 7, 6, 3, 4, 3, 4, 6, 3, 6, 7]"
西河 ,周邦彦,平平仄，平仄平平平仄。平平平仄仄平平，仄平平仄。仄平平仄仄平平，平平平仄平仄。仄仄仄。平平仄。仄仄平平平仄。平平平仄仄平平，仄平平仄。仄平平仄仄平平，平平平仄平仄。仄仄仄、平仄平仄。仄平平、平平平仄。仄仄仄平平仄。仄平平、仄仄平平，仄仄仄、仄平平，平平仄。,0,58,47,105,"[3, 6, 7, 4, 7, 6, 3, 3, 6, 7, 4, 7, 6, 3, 4, 3, 4, 6, 3, 4, 3, 3, 3]"
西河 ,陈允平,平仄仄。平平仄仄平仄。平平仄仄仄平平，平平仄仄。仄平平仄仄平平，平平仄仄平仄。仄平平仄仄仄。平平仄仄平仄。平平仄仄仄平平，仄平仄仄。仄平仄仄仄平平，平平平仄平仄。仄平仄仄仄仄仄。仄平平、平仄平仄。仄仄仄平平仄。仄平平、仄仄平平，仄仄仄仄平平，平平仄。,0,49,56,105,"[3, 6, 7, 4, 7, 6, 6, 6, 7, 4, 7, 6, 7, 3, 4, 6, 3, 4, 6, 3]"
西河 ,刘一止,平仄仄，平平仄平平仄。仄平仄仄仄平平，仄平平仄。仄平仄仄仄平平，仄平平仄平仄。仄仄仄，平平仄。仄平仄，平仄仄。平平仄仄平仄。平平仄仄仄平平，仄平平仄。仄平平仄仄平平，仄平平仄平仄。仄平仄仄仄平仄。仄平平、平仄平仄。平仄平平平仄。仄平平、仄仄平平平仄。仄仄平平平平仄。,0,55,56,111,"[3, 6, 7, 4, 7, 6, 3, 3, 3, 3, 6, 7, 4, 7, 6, 7, 3, 4, 6, 3, 6, 7]"
西河 ,王彧,平仄仄。仄平仄仄平仄。平平平仄仄平平，仄平仄仄。仄平仄仄仄平平，平平仄仄平仄。平仄仄，平仄仄。平平平仄平仄。仄平平仄仄平平，仄平仄仄。仄平仄仄仄平平，平平平仄平仄。仄平仄仄仄仄仄。仄平平、平仄平仄。仄仄平平平仄。仄平平、仄仄平平仄。仄仄平平平平仄。,0,49,55,104,"[3, 6, 7, 4, 7, 6, 3, 3, 6, 7, 4, 7, 6, 7, 3, 4, 6, 3, 5, 7]"
梦横塘 ,刘一止,仄平平仄，平仄平平，仄平平仄平仄。仄仄平平，仄仄仄、平平平仄。平仄平平，仄平平仄，仄平平仄。仄平平仄仄，仄仄平平，平平仄、平平仄。平平仄仄平平，平平平仄仄，仄仄平仄。仄仄平平，平仄仄、仄平平仄。仄平仄、平平仄仄，仄仄平平仄平仄。仄仄平平，仄平平仄，仄平平平仄。,0,54,51,105,"[4, 4, 6, 4, 3, 4, 4, 4, 4, 5, 4, 3, 3, 6, 5, 4, 4, 3, 4, 3, 4, 7, 4, 4, 5]"
西吴曲 ,刘过,仄平平、仄仄平仄。仄平平仄仄、仄平仄。仄平平仄仄，平平平仄平仄。仄仄平平，平仄仄、平平平仄。仄仄仄、平仄平平，仄仄仄、仄平平仄。仄平平仄，平仄仄平平，平平仄平仄仄。仄仄仄。仄平平仄平平，平平平仄，仄仄平平仄仄。平平平仄，仄仄仄仄平平，平仄仄平平，平仄仄平仄。,0,50,55,105,"[3, 4, 5, 3, 5, 6, 4, 3, 4, 3, 4, 3, 4, 4, 5, 6, 3, 6, 4, 6, 4, 6, 5, 5]"
秋霁 ,史达祖,平仄平平，仄仄仄平平，仄仄平仄。仄仄平平，仄平平仄，仄平仄平平仄。仄平仄仄。仄平仄仄平平仄。仄仄仄。平仄、仄平平仄仄平仄。平仄仄仄，仄仄平平，仄平平平，平仄平仄。仄平平、平平仄仄，平平平仄仄平仄。平仄仄平平仄仄。仄仄平仄，平仄仄仄平平，仄平平仄，仄平平仄。,0,48,57,105,"[4, 5, 4, 4, 4, 6, 4, 7, 3, 2, 7, 4, 4, 4, 4, 3, 4, 7, 7, 4, 6, 4, 4]"
秋霁 ,吴文英,仄仄平平，仄仄仄平平，仄仄平仄。平仄平平，仄平平仄，仄平仄平平仄。仄平仄仄。仄平仄仄平平仄。仄仄仄。平仄仄平，平仄仄平仄。平仄仄仄，仄仄平平，仄平平平，平仄平仄。仄平平、平平仄仄。平平平仄仄平仄。仄仄仄平平仄仄。仄仄平仄，仄平仄仄平平，仄平平仄，仄平仄仄。,0,46,59,105,"[4, 5, 4, 4, 4, 6, 4, 7, 3, 4, 5, 4, 4, 4, 4, 3, 4, 7, 7, 4, 6, 4, 4]"
秋霁 ,陈允平,平仄平平，仄仄仄平平，仄仄平仄。平仄平平，仄平平仄，仄平仄平仄仄。仄平仄仄。仄平平仄平平仄。仄仄平，平仄仄平，平仄仄平仄。平平仄仄，仄仄平平，仄平平平，平仄平仄。仄平平、平平仄仄，平平仄仄仄平仄。平仄仄平平仄仄。仄仄平仄，平仄仄仄平平，仄平平仄，仄平平仄。,0,50,55,105,"[4, 5, 4, 4, 4, 6, 4, 7, 3, 4, 5, 4, 4, 4, 4, 3, 4, 7, 7, 4, 6, 4, 4]"
秋霁 ,曾纡,仄仄平平，仄平仄，平仄仄平平仄。仄仄平平，平平仄仄，平平仄平平仄。仄平仄仄。仄平仄仄平平仄。仄仄仄。平仄仄平、仄仄仄平仄。平平仄仄平平，仄平仄仄，平平平仄。仄平仄、平平平仄，平仄平平仄仄仄。平仄仄平平仄仄。仄平平仄，平平仄仄平平，仄仄平平，仄平平仄。,0,49,54,103,"[4, 3, 6, 4, 4, 6, 4, 7, 3, 4, 5, 6, 4, 4, 3, 4, 7, 7, 4, 6, 4, 4]"
清风八咏楼 ,王行,仄仄仄平平，仄仄仄平平，平平平仄。平仄平平仄。仄仄平仄仄，平平平仄。仄平平仄，仄仄仄、平平平仄。仄平仄、平仄平平，仄平仄仄平仄。平平平仄平仄，仄平仄平平，仄平平仄。仄仄平平仄。仄平平平仄，仄平平仄。平平平仄，仄平平、平仄平仄。仄平仄、平仄平平，仄仄仄平平仄。,0,54,51,105,"[5, 5, 4, 5, 5, 4, 4, 3, 4, 3, 4, 6, 6, 5, 4, 5, 5, 4, 4, 3, 4, 3, 4, 6]"
暗香疏影 ,张肎,平平仄仄。仄仄平平仄，仄平平仄。平仄平平，仄仄仄平平仄仄。仄仄平平仄仄，平仄仄、平平平仄。仄仄仄、仄仄平平，平仄仄平仄。平仄仄平平仄，平平仄仄仄、仄平平仄。仄仄平平，平仄平平，仄仄平平平仄。仄平平仄平平仄，仄仄仄、平平平仄。仄平平、平仄平平，仄仄仄平平仄。,0,50,55,105,"[4, 5, 4, 4, 7, 6, 3, 4, 3, 4, 5, 6, 5, 4, 4, 4, 6, 7, 3, 4, 3, 4, 6]"
真珠髻 ,无名氏,平平平仄，仄仄平平，仄仄平平平仄。仄平平仄，平平平仄，仄仄仄平平仄。平仄平平，仄仄仄、平平平仄。仄仄仄、仄仄平平，仄仄仄平平仄。平平平仄平仄。仄平平仄仄，仄平平仄。仄平平仄，平平仄仄，仄仄仄平平仄。仄仄平平，平仄仄、仄平平仄。仄仄仄、平仄平平，仄仄平平平仄。,0,50,55,105,"[4, 4, 6, 4, 4, 6, 4, 3, 4, 3, 4, 6, 6, 5, 4, 4, 4, 6, 4, 3, 4, 3, 4, 6]"
征部乐 ,柳永,仄平平仄，平仄仄仄平平仄。仄平仄、平平仄仄。平仄仄、平仄平仄。平平仄，平平仄。仄仄仄、仄平平仄。仄仄仄、仄仄平平，仄仄平平仄平仄。平平仄仄，平平仄仄，平仄仄平平仄。仄仄仄、平平平仄，仄平平仄，平仄平平仄。仄仄平平仄。仄仄仄、仄平平仄。仄仄平、仄仄平平，仄仄平平仄。,0,46,60,106,"[4, 7, 3, 4, 3, 4, 3, 3, 3, 4, 3, 4, 7, 4, 4, 6, 3, 4, 4, 5, 5, 3, 4, 3, 4, 5]"
解连环 ,柳永,仄平平仄。仄平平仄仄，仄平平仄。仄仄平、平仄平平，仄仄仄，平平仄平平仄。平仄平平，仄平仄、平平平仄。仄平平仄仄，仄仄仄平，仄仄平仄。平平仄平仄仄。仄平平仄仄，平仄平仄。仄仄平、平仄平平，仄仄仄平平，仄平平仄。平仄平平，仄仄仄、平平平仄。仄平平仄仄，平仄仄平仄仄。,0,50,56,106,"[4, 5, 4, 3, 4, 3, 6, 4, 3, 4, 5, 4, 4, 6, 5, 4, 3, 4, 5, 4, 4, 3, 4, 5, 6]"
解连环 ,周邦彦,仄平平仄。平平平仄仄，仄平平仄。仄仄仄、平仄平平，仄平仄仄平，仄平平仄。仄仄平平，仄平仄、仄平平仄。仄平平仄仄，仄仄仄平，仄仄平仄。平平仄平仄仄。仄平平仄仄，平仄平仄。仄仄仄、平仄平平，仄平仄平平，仄仄平仄。仄仄平平，仄仄仄、平平平仄。平平平、仄平仄仄，仄平仄仄。,0,47,59,106,"[4, 5, 4, 3, 4, 5, 4, 4, 3, 4, 5, 4, 4, 6, 5, 4, 3, 4, 5, 4, 4, 3, 4, 3, 4, 4]"
解连环 ,杨无咎,仄平平仄。平平平仄仄，仄平平仄。仄仄平、仄仄平平，仄仄仄平平，仄平平仄。仄仄平平，仄仄仄、平平平仄。仄平平、仄平仄仄，仄平仄平平仄。平平仄平仄仄。仄平平仄仄，平仄平仄。仄仄仄、平仄平平，仄仄仄平平，仄平平仄。仄仄平平，仄仄仄、平平平仄。仄平平、仄平仄仄，仄平仄仄。,0,48,58,106,"[4, 5, 4, 3, 4, 5, 4, 4, 3, 4, 3, 4, 6, 6, 5, 4, 3, 4, 5, 4, 4, 3, 4, 3, 4, 4]"
内家娇 ,柳永,仄仄平平，平平仄仄，平仄仄平平仄。平平仄仄，平仄平平，仄仄平平平仄。仄仄仄平仄仄，平平平平仄仄。仄仄平、仄仄平平仄仄，平仄平仄。仄仄。平平平仄仄，仄仄仄平平仄。仄平平平仄。仄平仄仄平平，仄平平仄。仄仄平平平仄。平平仄平平仄。仄平仄、仄仄平平，仄平仄仄平仄。,0,50,56,106,"[4, 4, 6, 4, 4, 6, 6, 6, 3, 6, 4, 2, 5, 6, 5, 6, 4, 6, 6, 3, 4, 6]"
夜飞鹊慢 ,周邦彦,平平仄平仄，平仄平平。平仄仄仄平平。平平仄仄仄平仄，平平平仄平平。平平仄平仄，仄平平平仄，仄仄平平。平平仄仄，仄平平、仄仄平平。平仄仄平平仄，平仄仄平平，平仄平平。平仄平平平仄，平平仄仄，平仄平平。仄平仄仄，仄平平、仄仄平平。仄平平平仄、平平仄仄，仄仄平平。,0,61,45,106,"[5, 4, 6, 7, 6, 5, 5, 4, 4, 3, 4, 6, 5, 4, 6, 4, 4, 4, 3, 4, 5, 4, 4]"
夜飞鹊慢 ,赵以夫,平平仄平仄，仄仄平平。平仄仄仄平平。平平仄仄平平仄，平平平仄平平。平平仄平仄，仄平平仄仄，平仄平平。平平平仄，仄平平、仄仄平平。平仄仄平平仄，平仄仄平平，仄仄平平。平仄平平仄仄，平平仄仄，平仄平平。仄平平仄，仄平平、仄仄平平。仄平平，平仄平平，平仄仄仄平平。,0,62,44,106,"[5, 4, 6, 7, 6, 5, 5, 4, 4, 3, 4, 6, 5, 4, 6, 4, 4, 4, 3, 4, 3, 4, 6]"
泛清波摘遍 ,晏几道,平平仄仄，仄仄平平，平仄仄平平仄仄。仄平平仄，仄仄平平仄平仄。平平仄。平平仄仄，平仄平平，平仄仄平平仄仄。仄仄平平，仄仄平平仄平仄。仄平仄。平仄仄平仄平，仄仄仄平平仄。平仄平平仄仄平，仄平平仄。仄平仄。平仄仄仄仄平，平平仄平平仄。仄仄平平仄仄，仄平平仄。,0,50,56,106,"[4, 4, 7, 4, 7, 3, 4, 4, 7, 4, 7, 3, 6, 6, 7, 4, 3, 6, 6, 6, 4]"
望明河 ,刘一止,平平仄仄，仄平仄仄平，平平平仄。仄仄平平，仄仄仄仄平、仄平平仄。仄平平平仄，仄平仄、平平平平仄。仄平仄、平仄平平仄仄，仄平平仄。平平仄平平仄。仄平仄仄仄，平平平仄。仄仄平平，仄仄仄仄平、仄平平仄。仄平平平仄，仄仄仄、平平平平仄。仄平仄、平仄平平，仄仄仄平平仄。,0,52,54,106,"[4, 5, 4, 4, 5, 4, 5, 3, 5, 3, 6, 4, 6, 5, 4, 4, 5, 4, 5, 3, 5, 3, 4, 6]"
楚宫春慢 ,僧挥,平平仄仄。仄平仄平平，平仄平仄。仄仄仄平，平仄平平平仄。仄仄平平仄仄，仄仄仄、平平平仄。仄仄平平，平仄仄、仄仄平平，仄仄仄平平仄。平平仄仄，平仄仄、平平平平平仄。平仄仄平，平仄平平平仄。仄仄平平仄仄，仄仄仄、平平平仄。仄仄平平、仄平仄，仄仄平平，仄仄平平平仄。,0,51,55,106,"[4, 5, 4, 4, 6, 6, 3, 4, 4, 3, 4, 6, 4, 3, 6, 4, 6, 6, 3, 4, 4, 3, 4, 6]"
楚宫春慢 ,周密,平平仄仄。仄平仄平平，仄平平仄。仄仄仄平，平仄平平平仄。平仄平平仄仄，仄仄仄、平平平仄。仄仄平平，仄仄平、平仄平平，仄平平仄平仄。平仄平平平仄。平仄仄、平仄平平平仄。平仄仄平，平仄平平平仄。仄仄平平仄仄，仄仄仄、平平仄仄。仄仄平平、仄仄平，平仄平平，仄仄平平平仄。,0,55,53,108,"[4, 5, 4, 4, 6, 6, 3, 4, 4, 3, 4, 6, 6, 3, 6, 4, 6, 6, 3, 4, 4, 3, 4, 6]"
望海潮 ,柳永,平平平仄，平平平仄，平平仄仄平平。平仄仄平，平平仄仄，平平仄仄平平。平仄仄平平。仄平仄平仄，平仄平平。仄仄平平，仄平平仄仄平平。平平仄仄平平。仄平平仄仄，仄仄平平。平仄仄平，平平仄仄，平平仄仄平平。平仄仄平平。平仄平平仄，平仄平平。仄仄平平仄仄，平仄仄平平。,0,62,45,107,"[4, 4, 6, 4, 4, 6, 5, 5, 4, 4, 7, 6, 5, 4, 4, 4, 6, 5, 5, 4, 6, 5]"
望海潮 ,秦观,平平平仄，平平平仄，平平仄仄平平。平仄仄平，平平仄仄，平平仄仄平平。平仄仄平平。仄仄平仄仄，平仄平平。仄仄平平，仄平平仄仄平平。平平仄仄平平。仄平平仄仄，平仄平平。平仄仄平，平平仄仄，平平仄仄平平。平仄仄平平。仄仄平仄仄，平仄平平。平仄平平，仄平平仄仄平平。,0,62,45,107,"[4, 4, 6, 4, 4, 6, 5, 5, 4, 4, 7, 6, 5, 4, 4, 4, 6, 5, 5, 4, 4, 7]"
望海潮 ,邓千江,平平平仄，平平仄仄，平平仄仄平平。平平仄仄，平平仄仄，平平仄仄平平。平仄仄平平。仄仄平仄仄，平仄平平。仄仄平平，仄仄平仄仄平平。平平。仄仄平平。仄平平仄仄，仄仄平平。平仄仄平，平平仄仄，平平仄仄平平。平仄仄平平。仄仄平平仄，平仄平平。平仄平平仄仄，平仄仄平平。,0,59,48,107,"[4, 4, 6, 4, 4, 6, 5, 5, 4, 4, 7, 2, 4, 5, 4, 4, 4, 6, 5, 5, 4, 6, 5]"
望湘人 ,贺铸,仄平平仄仄，平仄仄平，仄平平仄平仄。仄仄平平，仄平仄仄。仄仄平平平仄。仄仄平平，仄平平仄，平平平仄。仄仄平、平仄平平，仄仄平平平仄。平仄平平仄仄。仄平平仄仄，仄平平仄。仄平仄平平，仄仄仄平平仄。平仄仄，仄仄平平仄。仄仄平平平仄。仄仄仄、仄仄平平，仄仄平平平仄。,0,50,57,107,"[5, 4, 6, 4, 4, 6, 4, 4, 4, 3, 4, 6, 6, 5, 4, 5, 6, 3, 5, 6, 3, 4, 6]"
青门饮 ,秦观,平仄平平，仄平平仄，平平仄仄，平平平仄。仄仄平平，仄平平仄，平仄仄平平仄。平仄平平仄，平平仄、平平平仄。仄仄平平，仄仄平平，平仄平仄。平仄平平平仄。平仄仄平平，平平平仄。平仄平平，仄平仄仄，平仄仄平平仄。仄仄平平仄，仄仄平、仄平平仄。仄平平仄，仄平仄仄，平平平仄。,0,59,48,107,"[4, 4, 4, 4, 4, 4, 6, 5, 3, 4, 4, 4, 4, 6, 5, 4, 4, 4, 6, 5, 3, 4, 4, 4, 4]"
青门饮 ,曹组,平仄平平，仄平平仄。平平仄仄，平平平仄。仄仄平平，仄平平仄，平仄仄平平仄。仄仄平平仄，仄平平平平平仄。仄仄平平，平仄仄平，平仄平仄。仄仄平平平仄，平仄仄平平，仄平平仄。仄仄平平，仄平平仄，平仄仄平平仄。平仄平平仄，仄平平、平平平仄。仄仄平平，平仄仄平平仄。,0,58,47,105,"[4, 4, 4, 4, 4, 4, 6, 5, 7, 4, 4, 4, 6, 5, 4, 4, 4, 6, 5, 3, 4, 4, 6]"
青门饮 ,无名氏,平仄平平，仄平平仄，平平仄仄，仄平平仄。仄仄平平，仄平平仄，平仄仄平平仄。平仄平平仄，仄平平、平平平仄。仄平平仄，平平仄仄，平平平仄。平仄仄平平仄。仄平仄仄，平平平仄。仄仄平平，仄平平仄，平仄仄平平仄。仄仄平平仄，仄平平，仄平平仄。仄平仄仄平平，仄仄平平平仄。,0,57,49,106,"[4, 4, 4, 4, 4, 4, 6, 5, 3, 4, 4, 4, 4, 6, 4, 4, 4, 4, 6, 5, 3, 4, 6, 6]"
落梅 ,王诜,仄平平仄，平平仄仄，平平仄平平仄。平平仄仄，仄平平仄，仄平平平仄。仄仄平平，仄平仄仄，平平平仄。仄平平仄仄平平，平平仄仄，平仄仄平仄。平仄平平平仄。仄平平、仄平平仄。仄平仄仄，平平仄仄，仄平平平仄。平仄平平，仄平平仄，仄平平仄。仄平平仄仄平平，平平平仄平平仄。,0,59,48,107,"[4, 4, 6, 4, 4, 5, 4, 4, 4, 7, 4, 5, 6, 3, 4, 4, 4, 5, 4, 4, 4, 7, 7]"
落梅 ,无名氏,仄平平仄，平平仄仄，平平仄平平仄。平平仄仄仄平平，平平平仄平仄。平仄平平仄仄，仄仄平平平仄。仄平平仄平平，平仄仄、仄平平仄平仄。平仄平平仄仄。仄平仄、平平平仄。平平仄仄，仄平平平仄，仄平平仄。平仄平平仄仄，平仄仄平平仄。仄平仄仄仄平平，平仄平仄平平仄。,0,57,49,106,"[4, 4, 6, 7, 6, 6, 6, 6, 3, 6, 6, 3, 4, 4, 5, 4, 6, 6, 7, 7]"
飞雪满群山 ,蔡伸,平仄平平，平平平仄，仄平平仄平平。仄平平仄，平平仄仄，仄平仄仄平平。仄平平仄仄，仄平仄、平平仄平。仄平平仄，平平仄仄，平仄仄平平。平仄仄、平平平仄仄，仄仄平平仄，平仄平平。仄平平仄，平平仄仄，仄平仄仄平平。仄平平仄仄，仄平仄、平平仄平。仄平平仄，平平仄仄平仄平。,0,58,49,107,"[4, 4, 6, 4, 4, 6, 5, 3, 4, 4, 4, 5, 3, 5, 5, 4, 4, 4, 6, 5, 3, 4, 4, 7]"
飞雪满群山 ,张榘,仄仄平平，平平平仄，仄平仄仄平平。平平仄仄，平平平仄，仄仄平仄平平。仄平平平仄，仄仄仄、平平仄平。仄平平仄，平仄平平，平仄仄平平。平仄仄、平平平仄仄，平平平仄，仄仄平平。平平仄仄，平平平仄，仄平仄仄平平。仄平平平仄，平平仄、平平仄平。平平仄仄，平平仄仄平仄平。,0,61,45,106,"[4, 4, 6, 4, 4, 6, 5, 3, 4, 4, 4, 5, 3, 5, 4, 4, 4, 4, 6, 5, 3, 4, 4, 7]"
角招 ,赵以夫,仄平仄。平平仄，仄平仄仄平仄。仄平平仄仄。仄仄仄平，平仄平仄。平平仄仄。仄仄仄、平平平仄。仄仄平平平仄。平平仄仄平平，仄平平平仄。平仄。仄平仄仄。平平仄仄，仄仄平平仄。仄平平仄仄。仄仄平平，平平平仄。平平仄仄。仄仄仄、平平平仄。仄仄平平仄仄。仄平仄、仄平平，平平仄。,0,50,57,107,"[3, 3, 6, 5, 4, 4, 4, 3, 4, 6, 6, 5, 2, 4, 4, 5, 5, 4, 4, 4, 3, 4, 6, 3, 3, 3]"
一寸金 ,柳永,仄仄平平，仄仄平平仄平仄。仄仄仄、仄仄平平，平仄平平，仄仄平平仄仄。仄仄平平仄，平平仄、仄平仄仄。平平仄，仄仄平平、仄平平仄仄平仄。仄仄平平，平平仄仄，平平仄平仄。仄仄仄、仄仄平平，平仄仄平平仄，平平平仄。平仄平平仄，平仄仄、仄平仄仄。平平仄，平仄平平，仄仄平平仄。,0,51,57,108,"[4, 7, 3, 4, 4, 6, 5, 3, 4, 3, 4, 7, 4, 4, 5, 3, 4, 6, 4, 5, 3, 4, 3, 4, 5]"
一寸金 ,周邦彦,平仄平平，仄仄平平仄平仄。仄仄平仄仄，平平仄仄，平平平仄，平平平仄。平仄平平仄，平平仄、仄平仄仄。平平仄、仄仄平平，仄仄平平仄平仄。仄仄平平，平平平仄，平平仄平仄。仄仄平平仄，平平平仄，平平仄仄，平平平仄。平仄平平仄，平平仄、仄平仄仄。平平仄、仄仄平平，仄仄平仄仄。,0,57,51,108,"[4, 7, 5, 4, 4, 4, 5, 3, 4, 3, 4, 7, 4, 4, 5, 5, 4, 4, 4, 5, 3, 4, 3, 4, 5]"
一寸金 ,李弥逊,平仄平平，仄仄平平仄平仄。仄仄仄平平，平平仄仄，仄平平仄，平平仄仄。仄仄平平仄。平平仄、平平仄仄。平平仄，平仄平平，仄仄平平仄平仄。仄仄平平，平平平仄，平平仄平仄。仄仄仄平平，平平平仄，仄平仄仄，平平平仄。仄仄平平仄。平仄仄、平平仄仄。平平仄、平仄平平，仄仄平平仄。,0,57,51,108,"[4, 7, 5, 4, 4, 4, 5, 3, 4, 3, 4, 7, 4, 4, 5, 5, 4, 4, 4, 5, 3, 4, 3, 4, 5]"
一寸金 ,曹勛,平仄平平，仄仄平平仄平仄。仄仄仄、仄仄平平，平仄平平，平仄平平平仄。仄仄平平仄，平平仄、仄平仄仄。平平仄，仄仄平平，仄仄平平仄平仄。仄仄平平，平平仄仄，平平仄平仄。仄仄平平仄，平平平仄，平仄平平，平平平仄。仄仄平平仄，平平仄、仄平仄仄。平平仄、仄仄平平，仄仄平平仄。,0,56,52,108,"[4, 7, 3, 4, 4, 6, 5, 3, 4, 3, 4, 7, 4, 4, 5, 5, 4, 4, 4, 5, 3, 4, 3, 4, 5]"
一寸金 ,无名氏,平仄平平，仄平平，仄平仄。仄仄平、仄仄平平，平仄仄平，仄仄平平平仄。仄仄平平仄，平仄仄平平仄。平平仄，仄仄平平，仄仄平平仄平仄。仄仄平平，平平仄仄，平仄仄平仄。仄仄平平仄，平平仄仄，平平仄仄，仄平平仄。平仄平平仄，平仄仄平平仄。平平仄，仄仄平平，仄仄平平仄。,0,52,53,105,"[4, 3, 3, 3, 4, 4, 6, 5, 6, 3, 4, 7, 4, 4, 5, 5, 4, 4, 4, 5, 6, 3, 4, 5]"
击梧桐 ,柳永,平仄平平，平平仄仄，仄仄平平平仄。仄仄平平，仄仄平平，仄仄平平平仄。平平仄仄平平，仄仄平仄平平平仄。仄仄平平、仄仄平平，仄仄平平平仄。仄仄平平，平平平仄，仄仄平平平仄。仄仄仄、平平仄仄，仄仄平平平仄。仄仄平平仄仄，平平平仄仄平仄。仄仄仄、平平仄仄，平平平仄仄。,0,54,54,108,"[4, 4, 6, 4, 4, 6, 6, 8, 4, 4, 6, 4, 4, 6, 3, 4, 6, 6, 7, 3, 4, 5]"
击梧桐 ,无名氏,仄仄平平，平平仄仄，仄仄平平平仄。仄仄平平，仄仄平平，仄仄平平平仄。平平仄仄平平，仄仄平仄平平平仄。仄仄平平仄仄，平平仄仄，平平平仄。仄仄平平，平平平仄，仄仄平平平仄。仄仄仄、平平仄仄，平仄平平平仄。仄仄平平仄仄，平平仄仄仄平仄。仄平仄、平平仄仄，仄平平仄仄。,0,53,55,108,"[4, 4, 6, 4, 4, 6, 6, 8, 6, 4, 4, 4, 4, 6, 3, 4, 6, 6, 7, 3, 4, 5]"
击梧桐 ,李甲,仄仄平平仄。平仄仄、平仄平平平仄。仄仄平平仄，仄平仄、仄仄平平仄仄。平平仄仄，平平平仄，仄仄平平仄仄。仄仄、平平仄，仄仄仄仄仄，平平平仄。仄仄平平，仄平仄仄，仄仄平平平仄。仄仄平平仄，仄仄仄、仄仄平平平仄。平仄平平仄仄，仄平平仄，仄仄平仄仄。仄平平、平平平仄，平仄平仄。,0,48,62,110,"[5, 3, 6, 5, 3, 6, 4, 4, 6, 2, 3, 5, 4, 4, 4, 6, 5, 3, 6, 6, 4, 5, 3, 4, 4]"
折红梅 ,杜安世,仄平平平仄，平平仄仄，平平平仄。仄平平、仄仄仄平，平平仄仄平仄。平平仄仄。平仄仄、平平平仄。仄平仄仄、平仄平平，仄平仄平平，仄仄平仄。平平仄仄。仄平仄仄平，平平平仄。平平仄、仄平仄仄，平平仄平平仄。平平平仄。平仄仄、仄平平仄。仄仄仄仄、仄仄平平，仄平平平仄，仄平平仄。,0,55,53,108,"[5, 4, 4, 3, 4, 6, 4, 3, 4, 4, 4, 5, 4, 4, 5, 4, 3, 4, 6, 4, 3, 4, 4, 4, 5, 4]"
折红梅 ,杜安世,仄平平平仄，平平仄仄，平平平仄。平平仄、仄平仄仄，平平仄平平仄。仄平平仄，仄仄仄、平平平仄。仄平仄仄、仄仄平平，仄平仄平平，仄平平仄。平平仄仄。仄平仄平平，仄平平仄。仄平仄、仄平仄仄，仄仄仄平平仄。平平仄仄。平仄仄、平平平仄。仄平平仄、平仄平平，平仄平平仄，仄平平仄。,0,55,53,108,"[5, 4, 4, 3, 4, 6, 4, 3, 4, 4, 4, 5, 4, 4, 5, 4, 3, 4, 6, 4, 3, 4, 4, 4, 5, 4]"
泛青苕 ,张先,仄仄平平。仄仄仄平平，仄仄平平。平平仄，仄平仄，平平仄，仄仄平平。平平仄仄平平仄，仄仄平、仄仄平平。仄平平仄，仄仄仄，平平仄仄平平。平平仄仄平平。仄平平仄仄，仄仄平平。平仄仄，仄平仄，仄平仄，仄仄平平。平平仄仄平平仄，仄仄平、仄仄平平。平平仄仄，平仄仄平平，仄仄平平。,0,53,55,108,"[4, 5, 4, 3, 3, 3, 4, 7, 3, 4, 4, 3, 6, 6, 5, 4, 3, 3, 3, 4, 7, 3, 4, 4, 5, 4]"
薄倖 ,贺铸,仄平平仄。仄仄仄、平平仄仄。仄仄仄、平平平仄，仄仄仄平平仄。仄仄平、平仄平平，平平仄仄平平仄。仄仄仄平平，平平平仄，平仄平平仄仄。仄仄仄、平平仄，平仄仄、仄平仄仄。仄平平平仄，平平平仄，仄平平仄平平仄。仄平平仄。仄平平仄仄，平平仄仄平平仄。平平仄仄，平仄平平仄仄。,0,52,56,108,"[4, 3, 4, 3, 4, 6, 3, 4, 7, 5, 4, 6, 3, 3, 3, 4, 5, 4, 7, 4, 5, 7, 4, 6]"
薄倖 ,沈端节,仄平平仄。仄平仄、平平仄仄。仄平仄、平平平仄，平仄平平平仄。仄仄平、平仄平平，平平仄仄平平仄。仄仄仄平平，平平仄仄，平仄平平平仄。仄仄仄、平平仄，仄仄仄、平平平仄。平平平仄仄，平平平仄。仄平平仄平平仄。仄平平仄。仄平平、平仄平平，平仄平平仄。平平仄仄，仄仄平平仄仄。,0,58,50,108,"[4, 3, 4, 3, 4, 6, 3, 4, 7, 5, 4, 6, 3, 3, 3, 4, 5, 4, 7, 4, 3, 4, 5, 4, 6]"
薄倖 ,韩元吉,仄平平仄。仄平仄、平平仄仄。仄仄仄、平平平仄，仄仄平平仄仄。仄仄平、平仄平平，平平仄仄平平仄。仄仄仄平平，平平仄仄，平仄平平平仄。平仄仄、平平仄，仄仄平平平仄。仄平平仄仄，平平平仄，平平仄仄平平仄。仄平平仄。仄平平平仄，平平仄仄平平仄。平平仄仄，平仄平平仄仄。,0,55,52,107,"[4, 3, 4, 3, 4, 6, 3, 4, 7, 5, 4, 6, 3, 3, 6, 5, 4, 7, 4, 5, 7, 4, 6]"
倚阑人 ,曹勛,平平平仄，平平仄仄，平平仄仄平仄仄。仄仄平平，仄平平仄，仄仄仄平平仄。仄仄平仄仄，平仄仄平平仄。平仄平平，仄平平仄，仄平平仄平平仄。仄仄平平仄仄。仄仄平、仄仄仄平平仄。仄仄平平，平平仄仄，仄仄仄平平仄。平仄平仄仄，平仄平平仄仄。平平平仄，仄平平仄，仄仄平平仄。,0,50,58,108,"[4, 4, 7, 4, 4, 6, 5, 6, 4, 4, 7, 6, 3, 6, 4, 4, 6, 5, 6, 4, 4, 5]"
惜黄花慢 ,杨无咎,仄平平仄。仄仄仄仄平，平平平仄。仄仄平平，仄平仄仄平平，仄仄仄平平仄。仄平平仄仄平平，仄仄仄、仄平平仄。仄平仄。仄仄仄平，平仄平仄。平平仄仄平平，仄平仄、仄仄平平平仄。仄仄平平，仄平平仄仄平，仄仄仄平平仄。平平平仄仄平平，仄平仄、平平平仄。平仄仄。仄仄仄平平仄。,0,50,58,108,"[4, 5, 4, 4, 6, 6, 7, 3, 4, 3, 4, 4, 6, 3, 6, 4, 6, 6, 7, 3, 4, 3, 6]"
惜黄花慢 ,赵以夫,仄平平仄。平仄仄、仄仄平平平仄。仄仄平仄。仄平仄仄平平，仄仄平平平仄。仄平仄仄仄平平，仄仄仄平平平仄。仄平仄。仄仄仄平，平仄平仄。平平仄仄平平，仄仄仄、仄仄平平平仄。仄仄平仄。仄平仄仄平平，仄仄仄平平仄。平平仄仄仄平平，仄仄仄、平平平仄。平仄仄。仄仄仄平平仄。,0,46,62,108,"[4, 3, 6, 4, 6, 6, 7, 7, 3, 4, 4, 6, 3, 6, 4, 6, 6, 7, 3, 4, 3, 6]"
惜黄花慢 ,吴文英,仄仄平平。仄仄平仄仄，平仄平平。仄平仄仄，仄平仄仄，平平仄仄，仄仄平平。仄平平仄平平仄，仄平仄、平仄平平。仄仄平。仄平仄仄，平仄平平。平平仄仄平平。仄仄平仄仄，仄仄平平。仄平平仄，仄平仄仄，平平仄仄，平仄平平。仄平仄仄平平仄，仄平仄、仄仄平平。仄仄平。仄平仄仄平平。,0,50,58,108,"[4, 5, 4, 4, 4, 4, 4, 7, 3, 4, 3, 4, 4, 6, 5, 4, 4, 4, 4, 4, 7, 3, 4, 3, 6]"
一萼红 ,姜夔,仄平平。仄平平仄仄，平仄仄平平。平仄平平，平平仄仄，平仄平仄平平。仄平仄、平平仄仄，仄仄仄、平仄仄平平。仄仄平平，仄平平仄，平仄平平。平仄仄平平仄，仄平平仄仄，仄仄平平。平仄平平，平平仄仄，平仄平仄平平。仄平仄、平平仄仄，仄平仄、平仄仄平平。仄仄平平仄平，仄仄平平。,0,57,51,108,"[3, 5, 5, 4, 4, 6, 3, 4, 3, 5, 4, 4, 4, 6, 5, 4, 4, 4, 6, 3, 4, 3, 5, 6, 4]"
一萼红 ,李彭老,仄平平。仄平平平仄，平仄仄平平。仄仄平平，平平仄仄，仄仄平仄平平。仄平仄、平平仄仄，平仄仄、平仄仄平平。仄仄平平，仄平平仄，仄仄平平。平仄平平仄仄，仄平平平仄，仄仄平平。仄仄平平，平平仄仄，平平平仄平平。仄平平、平平仄仄，仄平平仄仄平平。仄仄平平仄仄，平仄平平。,0,58,49,107,"[3, 5, 5, 4, 4, 6, 3, 4, 3, 5, 4, 4, 4, 6, 5, 4, 4, 4, 6, 3, 4, 7, 6, 4]"
一萼红 ,刘天迪,仄平平，仄仄平平仄，平仄仄平平。平仄平平，平平仄仄，平仄平仄平平。仄平仄、平平仄仄，仄平仄、平仄仄平平。平仄平平，平平仄仄，仄仄平平。平仄平平仄仄，仄平平仄仄，仄仄平平。仄仄平平，平平仄仄，平仄平仄平平。仄平仄、平平仄仄，平平仄、平仄仄平平。仄仄平平，仄平仄仄平平。,0,58,50,108,"[3, 5, 5, 4, 4, 6, 3, 4, 3, 5, 4, 4, 4, 6, 5, 4, 4, 4, 6, 3, 4, 3, 5, 4, 6]"
一萼红 ,无名氏,仄平仄仄，平平仄，仄仄平平平仄。仄仄平平，平平平仄，平仄平平平仄。仄仄仄、平平仄仄，仄仄仄、平仄仄平仄。仄仄仄仄，仄平仄仄，平平平仄。平仄仄平平仄。仄平平仄仄，平平平仄。平仄平平，仄平仄仄，仄仄平平平仄。平仄仄、平平平仄，平仄仄平平仄平仄。仄平仄，仄仄仄、平平仄仄。,0,49,59,108,"[4, 3, 6, 4, 4, 6, 3, 4, 3, 5, 4, 4, 4, 6, 5, 4, 4, 4, 6, 3, 4, 8, 3, 3, 4]"
夺锦标 ,张埜,平仄平平，平平仄仄，仄仄平平平仄。仄仄平平仄仄，平仄平平，仄平平仄。仄平平仄仄，仄平仄、平平平仄。仄平平、仄仄平平，仄仄平平平仄。平仄平平仄仄。仄仄平平，仄仄仄平平仄。仄仄平平平仄，平仄平平，仄平平仄。仄平平仄仄，仄平仄、平平平仄。仄平平、仄仄平平，仄仄平平平仄。,0,56,52,108,"[4, 4, 6, 6, 4, 4, 5, 3, 4, 3, 4, 6, 6, 4, 6, 6, 4, 4, 5, 3, 4, 3, 4, 6]"
夺锦标 ,白朴,平仄平平，平平仄仄，仄仄平平平仄。仄仄平平仄仄，平仄平平，仄平平仄。仄平平平仄，仄平平、平平平仄。仄平平、平仄平平，仄仄平平平仄。平仄平平平仄，平仄平平，平平仄仄平仄。仄仄平平仄仄，平仄平平，仄平平仄。仄平平平仄，仄平平、平平平仄。仄平平、平仄平平，仄仄平平平仄。,0,64,44,108,"[4, 4, 6, 6, 4, 4, 5, 3, 4, 3, 4, 6, 6, 4, 6, 6, 4, 4, 5, 3, 4, 3, 4, 6]"
夺锦标 ,滕应宾,仄仄平平，平平仄仄，仄仄平平平仄。平仄平平仄仄。平仄平平，平平平仄。仄平平平仄，仄平平、平平平仄。仄平平、仄仄平平，仄仄平平平仄。仄仄平平平仄，仄仄平平，仄平仄仄。平仄平平仄仄，仄仄平平，平平仄仄。仄平平平仄，仄平平、平平平仄。仄平平、平仄仄平，仄仄平平平仄。,0,59,47,106,"[4, 4, 6, 6, 4, 4, 5, 3, 4, 3, 4, 6, 6, 4, 4, 6, 4, 4, 5, 3, 4, 3, 4, 6]"
菩萨蛮慢 ,罗志仁,仄平平仄。仄平平仄仄，仄平仄仄。仄仄仄、平仄平平，仄平仄仄平，仄平平仄。仄仄平平，仄平仄、仄平平仄。仄平平仄仄，仄仄仄平，仄仄平仄。平平仄平仄仄。仄平平仄仄，平仄平仄。仄仄仄平平，平仄平平，仄仄仄平平，仄仄平仄。仄仄平平，仄仄仄、平平平仄。仄平平、平平仄仄，仄平仄仄。,0,46,62,108,"[4, 5, 4, 3, 4, 5, 4, 4, 3, 4, 5, 4, 4, 6, 5, 4, 5, 4, 5, 4, 4, 3, 4, 3, 4, 4]"
杜韦娘 ,杜安世,仄平平仄，平平仄仄平平仄。仄仄仄、平仄平平仄，仄仄仄、平平平仄。平仄平仄仄，平平仄仄，平平仄仄平平仄。仄平平，仄仄平仄、平平仄仄。仄仄仄。平平平仄，仄平仄仄仄平仄。仄仄平、平仄平平仄，仄仄仄、平平平仄。仄平平仄仄平平，仄仄平平，仄仄平平仄。仄平平，仄仄仄仄、平平仄仄。,0,49,60,109,"[4, 7, 3, 5, 3, 4, 5, 4, 7, 3, 4, 4, 3, 4, 7, 3, 5, 3, 4, 7, 4, 5, 3, 4, 4]"
杜韦娘 ,无名氏,平平平仄，平平仄仄平平仄。仄仄仄、平仄平平仄。仄仄仄、平平平仄。仄平仄仄仄，平平仄仄，平平仄仄平平仄。仄平平，仄仄平平，平平平仄。平仄仄，平仄平平仄仄，仄仄平平仄。仄仄仄、平仄平平仄。仄仄仄、平平平仄。仄平平仄仄，平平仄仄，仄仄仄仄平平仄。仄平平仄仄，平仄平平平仄。,0,51,58,109,"[4, 7, 3, 5, 3, 4, 5, 4, 7, 3, 4, 4, 3, 6, 5, 3, 5, 3, 4, 5, 4, 7, 5, 6]"
无愁可解 ,苏轼,平仄仄平，平仄仄仄。平平仄仄平仄。仄平平仄平，仄平仄仄仄仄。仄仄平平平仄仄。仄平仄、仄仄平仄。仄仄仄、仄仄平平，仄仄仄仄，仄仄仄仄。仄仄。仄仄平平，平平仄、平平仄平平仄。仄仄平仄仄，仄仄平平仄仄。仄仄平平仄仄仄。仄仄仄、仄平平仄。仄平仄仄仄，平平仄平，仄平仄、仄平仄。,0,38,71,109,"[4, 4, 6, 5, 6, 7, 3, 4, 3, 4, 4, 4, 2, 4, 3, 6, 5, 6, 7, 3, 4, 5, 4, 3, 3]"
无愁可解 ,无名氏,仄仄平平，平平仄仄。仄仄平仄平仄。仄平平仄仄，仄仄平、仄平平仄。仄仄平平仄仄仄，仄仄仄、仄平平仄。仄平平、仄仄平平，仄平仄仄，仄平平仄。仄仄。仄仄平平平仄仄，平仄仄、仄平平仄。仄平仄仄仄，仄平平、平仄平仄。仄仄平平平仄仄，仄仄平、仄平平仄。仄平平、仄仄平平，仄平仄仄，仄平平仄。,0,46,66,112,"[4, 4, 6, 5, 3, 4, 7, 3, 4, 3, 4, 4, 4, 2, 7, 3, 4, 5, 3, 4, 7, 3, 4, 3, 4, 4, 4]"
过秦楼 ,李甲,仄仄平平，平平平仄，仄平平仄平平。仄仄平平仄，仄仄仄平平，仄仄平平。仄仄仄平平。仄平平、仄仄平平。仄平平平仄，平平平仄，平仄平平。仄仄平仄仄、平平仄，仄平平仄仄，平仄平平。平仄平平仄，仄平平仄仄，仄仄平平。平仄仄平平，仄平平、仄仄平平。仄平平仄仄，平仄平平，平仄平平。,0,60,49,109,"[4, 4, 6, 5, 5, 4, 5, 3, 4, 5, 4, 4, 5, 3, 5, 4, 5, 5, 4, 5, 3, 4, 5, 4, 4]"
江城子慢 ,吕渭老,平平仄平仄。平仄仄、仄仄仄平仄。仄平仄。平仄仄、仄仄仄平平仄。仄平仄。平仄平平平仄仄，平平仄、平平平仄仄。仄仄仄仄平平，平平仄仄平仄。平平平平仄仄，仄平平平仄，平仄平仄。仄平仄。平平仄、平仄平平平仄。仄平仄。平仄平平平仄仄，平平仄、平平平仄仄。仄平仄仄平平仄平仄。,0,54,55,109,"[5, 3, 5, 3, 3, 6, 3, 7, 3, 5, 6, 6, 6, 5, 4, 3, 3, 6, 3, 7, 3, 5, 9]"
江城子慢 ,蔡松年,仄平仄平仄。平仄仄、平平仄平仄。仄平仄。平平仄、仄仄平平平仄。仄平仄。仄仄平平平仄仄，平平仄、平平平仄仄。仄平仄仄平平，平平仄仄平仄。平平平平仄仄。仄平平仄仄，平仄平仄。仄仄平仄。平平仄、仄仄平平平仄。仄平仄。平仄平平平仄仄，平平仄、平平平仄仄。仄平平仄平平仄平仄。,0,56,54,110,"[5, 3, 5, 3, 3, 6, 3, 7, 3, 5, 6, 6, 6, 5, 4, 4, 3, 6, 3, 7, 3, 5, 9]"
江南春慢 ,吴文英,平仄平平，平平仄仄，平平平仄平仄。平平仄仄，仄仄平、平仄平仄。平仄平平仄。平平仄、仄平仄仄。仄仄仄、平平仄仄，仄仄平平，平平仄仄平仄。平平仄，平仄仄。仄仄仄平平，仄平平仄。平平仄仄，仄仄仄、平平平仄。平仄平平仄。平平仄、仄平仄仄。平仄仄、平仄仄平，平仄平平，平平仄平平仄。,0,55,54,109,"[4, 4, 6, 4, 3, 4, 5, 3, 4, 3, 4, 4, 6, 3, 3, 5, 4, 4, 3, 4, 5, 3, 4, 3, 4, 4, 6]"
罥马索 ,无名氏,仄平平，平仄平平仄平仄。平平仄仄，仄平平仄平平仄。平平仄仄，仄平平仄，仄仄平平平平仄。仄仄平、仄仄平平，仄仄仄平仄平仄。平仄。仄平平仄，仄平平仄，仄仄平平仄平仄。仄仄平平平仄，平平平仄平平仄。平平仄仄，仄仄平平，平仄平平平平仄。仄仄平、仄平平仄仄仄，平平仄平仄。,0,56,53,109,"[3, 7, 4, 7, 4, 4, 7, 3, 4, 7, 2, 4, 4, 7, 6, 7, 4, 4, 7, 3, 6, 5]"
八宝妆 ,李甲,平仄平平，仄平平仄，仄仄仄平平仄。平仄平平平仄仄，仄仄平平平仄。平平平仄，仄平平仄平平，平平平仄平平仄。平仄仄平平仄，平平平仄。平仄仄仄平平，仄平仄仄，仄平平仄平仄。仄平仄、仄平仄仄，仄平仄、平平平仄。仄平仄、平平仄仄。仄平平仄平平仄。仄仄仄平平，平平仄仄平平仄。,0,58,52,110,"[4, 4, 6, 7, 6, 4, 6, 7, 6, 4, 6, 4, 6, 3, 4, 3, 4, 3, 4, 7, 5, 7]"
八宝妆 ,仇远,平仄平平，仄平平仄，仄仄仄平平仄。平仄平平平仄仄，仄仄平平平仄。平平平仄。仄仄平仄平平，平平平仄平平仄。平仄仄平平仄，平平平仄。仄平仄仄仄平，仄平仄仄。平平平仄平仄。仄平仄、平平平仄。仄平仄、平平平仄。仄平仄、平平仄仄。仄平平仄平平仄。仄仄仄平平，平平仄仄平平仄。,0,59,51,110,"[4, 4, 6, 7, 6, 4, 6, 7, 6, 4, 6, 4, 6, 3, 4, 3, 4, 3, 4, 7, 5, 7]"
疏影 ,姜夔,平平仄仄。仄仄平仄仄，平仄平仄。仄仄平平，平仄平平，平平仄仄平仄。平平仄仄平平仄，仄仄仄、平平平仄。仄仄平、仄仄平平，仄仄仄平平仄。平仄平平仄仄，仄平仄仄仄，平仄平仄。仄仄平平，仄仄平平，仄仄平平平仄。平平仄仄平平仄，仄仄仄、仄平平仄。仄仄平、平仄平平，仄仄仄平平仄。,0,50,60,110,"[4, 5, 4, 4, 4, 6, 7, 3, 4, 3, 4, 6, 6, 5, 4, 4, 4, 6, 7, 3, 4, 3, 4, 6]"
疏影 ,张炎,仄平仄仄。仄仄平、平仄仄平平仄。仄仄平平，平仄平平，平仄仄平平仄。平平仄仄平平仄，仄平平、仄平平仄。仄仄平、仄仄平平，仄仄仄平平仄。平仄平平仄仄，仄平仄仄仄，平仄平仄。仄仄平平，仄仄平平，平仄平平仄仄。仄平仄仄平平仄，仄平仄、平平平仄。仄仄平平仄平平，平仄仄平平仄。,0,53,57,110,"[4, 3, 6, 4, 4, 6, 7, 3, 4, 3, 4, 6, 6, 5, 4, 4, 4, 6, 7, 3, 4, 7, 6]"
疏影 ,陈允平,平平仄仄，仄平平仄仄，平平平仄。仄仄平平，平仄平平，平平仄仄平仄。平平仄仄平平仄，仄平仄、平平平仄。仄仄平、平仄平平，平仄仄平平仄。平仄平平仄仄，仄平平仄仄，平仄平仄。仄仄平平，仄仄平平，仄仄仄平平仄。平平仄仄平平仄，仄仄仄、仄平平仄。仄仄平、平仄平平，仄仄仄平平仄。,0,55,55,110,"[4, 5, 4, 4, 4, 6, 7, 3, 4, 3, 4, 6, 6, 5, 4, 4, 4, 6, 7, 3, 4, 3, 4, 6]"
疏影 ,张炎,仄平仄仄，仄平平仄仄，平平仄仄。平仄平平，仄仄平平，仄仄仄仄平仄。平平仄仄平平仄，仄仄仄、仄平平仄。仄仄平、平仄平平，仄仄仄平平仄。平仄平平仄仄。仄仄平仄仄，平仄平仄。仄仄平平，仄仄平平，仄仄仄平平仄。平平仄仄平平仄，平平仄、仄平平仄。仄仄平、平仄平平，仄仄仄平平仄。,0,49,61,110,"[4, 5, 4, 4, 4, 6, 7, 3, 4, 3, 4, 6, 6, 5, 4, 4, 4, 6, 7, 3, 4, 3, 4, 6]"
疏影 ,张翥,平平仄仄。仄仄平仄仄，平仄平仄。仄仄平平，平仄平平，仄仄平平平仄。平平仄仄平平仄，仄仄仄、仄平平仄。仄仄平平仄，平平仄仄，仄平平仄。平仄平平仄仄，仄平仄仄仄，平仄平仄。仄仄平平，仄仄平平，仄仄平平平仄。仄平仄仄平平仄，仄仄仄、仄平平仄。仄仄平、仄仄平平，仄仄仄平平仄。,0,48,62,110,"[4, 5, 4, 4, 4, 6, 7, 3, 4, 5, 4, 4, 6, 5, 4, 4, 4, 6, 7, 3, 4, 3, 4, 6]"
大圣乐 ,康与之,平仄平平，仄平平仄，仄平平仄。仄仄仄、仄仄平平，仄仄仄平平仄，平仄平平。仄平平平平仄仄，仄平仄、平平平仄平。平平仄，仄平平仄仄，平仄平平。平平仄仄仄仄，仄仄仄、平平平仄平。仄仄平平仄，仄仄仄仄，平仄平平。仄仄平平，平平平仄，平仄平平平仄平。平平仄，仄平平仄仄，平仄平平。,0,58,52,110,"[4, 4, 4, 3, 4, 6, 4, 7, 3, 5, 3, 5, 4, 6, 3, 5, 5, 4, 4, 4, 4, 7, 3, 5, 4]"
大圣乐 ,周密,平仄平平，仄平平仄，仄平平仄。仄仄平仄仄平平，平仄仄平，平仄仄平平仄。仄仄平平平仄仄，仄仄仄、平平平仄仄。平平仄，仄平平仄仄，平仄平仄。平平仄平仄仄。仄平仄、平平平仄仄。仄仄平平仄，平平平仄，平平平仄。仄仄平平平平仄，仄平仄平平平仄仄。平平仄，仄平平、仄平平仄。,0,56,52,108,"[4, 4, 4, 7, 4, 6, 7, 3, 5, 3, 5, 4, 6, 3, 5, 5, 4, 4, 7, 8, 3, 3, 4]"
大圣乐 ,张炎,仄仄平平，仄平平仄，仄平平仄。仄仄平、平仄平平，仄仄仄平，平仄平平平仄。仄仄仄平平平仄，仄仄仄、平平平仄仄。平平仄。仄平仄仄平，平仄平仄。平平仄平仄仄。仄仄仄平平平仄仄。仄仄平平仄，平平仄仄，平仄平平平仄。仄仄仄平平平仄，仄平仄、平平平仄仄。平平仄。仄平平、仄平平仄。,0,54,56,110,"[4, 4, 4, 3, 4, 4, 6, 7, 3, 5, 3, 5, 4, 6, 8, 5, 4, 6, 7, 3, 5, 3, 3, 4]"
高山流水 ,吴文英,仄平仄仄仄平平。仄平平、平仄平平。平仄仄平平，平平仄仄平平。平平仄、仄仄平平。平平仄，平仄平平仄仄，仄仄平平。仄平平仄仄，仄仄仄平平。平平。平平仄平仄，平仄仄、仄仄平平。平仄仄平平，仄仄仄仄平平。仄平平、仄仄平平。仄平仄，平仄平平仄仄，仄仄平平。仄平平仄，仄平仄、仄平平。,0,58,52,110,"[7, 3, 4, 5, 6, 3, 4, 3, 6, 4, 5, 5, 2, 5, 3, 4, 5, 6, 3, 4, 3, 6, 4, 4, 3, 3]"
慢卷绸 ,柳永,平平仄仄，平平仄仄，平仄平平仄。仄平仄平平，仄仄平平，平平仄仄，平平平仄。仄仄平平，仄平平仄，平仄平平仄。仄仄仄平平，仄仄平平，平仄平仄。平平仄仄。平平仄、仄仄平平仄。仄平仄平平，仄仄平平仄仄，仄仄仄平平仄。仄仄平平，仄平平仄，平仄平平仄。仄平仄平平，仄仄平平，仄仄平仄。,0,56,55,111,"[4, 4, 5, 5, 4, 4, 4, 4, 4, 5, 5, 4, 4, 4, 3, 5, 5, 6, 6, 4, 4, 5, 5, 4, 4]"
慢卷绸 ,李甲,仄仄平平，平平仄仄，仄仄平平仄。仄仄仄平平，仄仄平平，仄仄仄平，平平仄仄。仄仄平平，仄平平仄，仄仄平平仄。仄仄平平仄仄，平平平仄平仄。平平仄仄。平平仄、平仄平平仄。仄仄仄平平，仄平平仄，平平仄仄，平平仄仄。仄仄仄平，仄平平仄，仄仄平平仄。仄仄仄平平，仄仄平平，平仄平仄。,0,51,59,110,"[4, 4, 5, 5, 4, 4, 4, 4, 4, 5, 6, 6, 4, 3, 5, 5, 4, 4, 4, 4, 4, 5, 5, 4, 4]"
选冠子 ,周邦彦,仄仄平平，仄平平仄，仄仄仄平平仄。平平仄仄，仄仄平平，仄仄仄平平仄。平仄仄仄平平，平仄平平，仄平平仄。仄平平仄仄，平平平仄，仄平平仄。平仄仄、仄仄平平，平平平仄，仄仄仄平平仄。平平仄仄，平仄平平，仄仄仄平平仄。平仄平平，仄平平仄平平，平平平仄。仄平平仄仄，平仄平平仄仄。,0,57,54,111,"[4, 4, 6, 4, 4, 6, 6, 4, 4, 5, 4, 4, 3, 4, 4, 6, 4, 4, 6, 4, 6, 4, 5, 6]"
选冠子 ,蔡伸,仄仄平平，平平平仄，仄仄平平平仄。平平仄仄，仄仄平平，平仄仄平平仄。平仄平平，仄平平仄平平，平平平仄。仄仄平平仄，平平平仄，仄平平仄。仄仄平、仄仄平平，仄平平仄，仄仄平平平仄。平平仄仄，仄仄平平，平仄仄平平仄。仄仄平平，仄平平仄平平，平平仄仄。仄平平、平仄平平，平平仄仄。,0,62,49,111,"[4, 4, 6, 4, 4, 6, 4, 6, 4, 5, 4, 4, 3, 4, 4, 6, 4, 4, 6, 4, 6, 4, 3, 4, 4]"
选冠子 ,吴文英,仄仄平平，仄平平仄，仄仄仄平平仄。平平仄仄，仄仄平平，仄仄仄平平仄。平仄平平，仄平仄仄平平，平平平仄。仄平平仄仄，平平平仄，仄平平仄。平仄仄、仄仄平平，平平平仄，仄仄仄平平仄。平平仄仄，平仄平平，仄仄仄平平仄。平仄平平，仄平平仄平平，仄平平仄。仄平平仄仄，平仄平平仄仄。,0,57,54,111,"[4, 4, 6, 4, 4, 6, 4, 6, 4, 5, 4, 4, 3, 4, 4, 6, 4, 4, 6, 4, 6, 4, 5, 6]"
选冠子 ,曹勛,仄仄平平，平平仄仄，仄仄仄平平仄。平平仄仄，仄仄平平，平仄仄平平仄。平仄平平，仄平平仄，平仄平平平仄。仄平平平仄，平仄平仄，仄平平仄。平仄仄、仄仄平平，平平仄仄，仄仄平平平仄。平平仄仄，仄仄平平，平仄仄平平仄。平仄平平，仄平平仄，仄仄仄平平仄。仄平平、平仄平平，平平仄仄。,0,58,53,111,"[4, 4, 6, 4, 4, 6, 4, 4, 6, 5, 4, 4, 3, 4, 4, 6, 4, 4, 6, 4, 4, 6, 3, 4, 4]"
选冠子 ,鲁逸仲,仄仄平平，平平平仄，仄仄平平平仄。平平仄仄，仄仄平平，平仄仄平平仄。平仄平平仄平，平仄平平，仄平平仄。仄平平平仄，平平平仄，仄平平仄。平仄仄、平仄平平，平平平仄，仄仄平平平仄。平平仄仄，仄仄平平，仄仄仄平平仄。平仄平平仄平，平仄仄平，平平平仄。仄平平平仄，平平平仄，仄平平仄。,0,65,48,113,"[4, 4, 6, 4, 4, 6, 6, 4, 4, 5, 4, 4, 3, 4, 4, 6, 4, 4, 6, 6, 4, 4, 5, 4, 4]"
选冠子 ,张景修,仄仄平平，平平仄仄，仄仄仄平平仄。平平仄仄，仄仄平平，平仄仄平平仄。平仄平平，仄平平仄，平平仄平平仄。仄平平、仄仄平平，平仄仄平平仄。平仄仄、仄仄平平，平平仄仄，仄仄仄平平仄。平平仄仄，仄仄平平，平仄仄平平仄。平仄仄仄平平，平仄平平，仄平平仄。仄平平仄仄，平平平仄，仄平平仄。,0,58,55,113,"[4, 4, 6, 4, 4, 6, 4, 4, 6, 3, 4, 6, 3, 4, 4, 6, 4, 4, 6, 6, 4, 4, 5, 4, 4]"
选冠子 ,无名氏,平仄平平，平平仄仄，平仄仄平平仄。平平仄仄，仄仄平平，平仄仄平平仄。仄仄平平，仄仄平平，仄仄平平平仄。仄平平、仄仄平平，平仄仄平平仄。平仄仄、仄仄平平，仄平平仄，平仄仄平平仄。平平仄仄，仄仄平平，平仄仄平平仄。平仄仄仄仄仄，平仄平平，仄平平仄。仄平平、仄仄平平，平仄仄平平仄。,0,57,56,113,"[4, 4, 6, 4, 4, 6, 4, 4, 6, 3, 4, 6, 3, 4, 4, 6, 4, 4, 6, 6, 4, 4, 3, 4, 6]"
选冠子 ,陆游,仄仄平平，平平平仄，仄仄仄平平仄。平平仄仄，仄仄平平，平仄仄平平仄。仄仄平平，仄平平仄，平仄仄平平仄。仄平平平仄，平平平仄，仄平平仄。平仄仄、仄仄平平，平平平仄，仄仄仄平平仄。平平仄仄，仄仄平平，平仄仄平平仄。平仄平平，仄平平仄，仄仄仄平平仄。仄仄平平仄，平平平仄，仄平平仄。,0,58,55,113,"[4, 4, 6, 4, 4, 6, 4, 4, 6, 5, 4, 4, 3, 4, 4, 6, 4, 4, 6, 4, 4, 6, 5, 4, 4]"
选冠子 ,虞集,平仄平平，仄平平仄，平仄仄平平仄。平平仄仄，平仄平平，仄仄仄平平仄。平仄平平，仄平平仄，仄仄仄平平仄。仄平平，平仄平平，平仄仄平平仄。平仄仄、仄仄平平，仄平平仄，仄仄仄平平仄。平平平仄，平仄平平，仄仄仄平平仄。平平仄仄，仄仄平平，平仄仄平平仄。仄仄平、平仄平平，平仄仄平平仄。,0,59,54,113,"[4, 4, 6, 4, 4, 6, 4, 4, 6, 3, 4, 6, 3, 4, 4, 6, 4, 4, 6, 4, 4, 6, 3, 4, 6]"
选冠子 ,陈允平,仄仄平平，平平仄仄，仄仄仄平平仄。平平仄仄，仄仄平平，仄仄仄平平仄。平仄仄仄平平，仄仄平平，仄平平仄。仄平平仄仄，仄平平仄，仄平平仄。平平仄、仄仄平平，仄平平仄，仄仄仄平平仄。平平仄仄，仄仄平平，平仄仄平平仄。仄仄平平，仄平仄仄平平，仄平平仄。仄平平平仄，平平仄仄，仄平平仄。,0,54,59,113,"[4, 4, 6, 4, 4, 6, 6, 4, 4, 5, 4, 4, 3, 4, 4, 6, 4, 4, 6, 4, 6, 4, 5, 4, 4]"
选冠子 ,陈允平,仄仄平平，平平平仄，仄仄仄平平仄。平平仄仄，仄仄平平，平仄仄平平仄。仄仄平平，平平仄仄，平平仄平平仄。仄仄平平仄，平平平仄，仄平平仄。仄仄仄、仄仄平平，平平平仄，仄仄仄平平仄。平平仄仄，仄仄平平，平仄仄平平仄。平仄平平仄仄，仄仄平平，仄平平仄。仄平平平仄，平平仄仄，仄平平仄。,0,57,56,113,"[4, 4, 6, 4, 4, 6, 4, 4, 6, 5, 4, 4, 3, 4, 4, 6, 4, 4, 6, 6, 4, 4, 5, 4, 4]"
选冠子 ,虞集,平仄平平，仄平平仄，平仄仄平平仄。平仄平平，仄平平仄，平仄仄平平仄。平仄平平，平平平仄，平仄仄平平仄。仄平平、平仄平平，仄仄仄平平仄。平仄仄、平仄平平，仄平平仄，平仄平平平仄。仄仄平平，平平仄仄，平仄仄平平仄。平仄平平，仄平平仄，仄仄仄平仄仄。平平仄仄，仄仄平平，仄仄仄平平仄。,0,61,53,114,"[4, 4, 6, 4, 4, 6, 4, 4, 6, 3, 4, 6, 3, 4, 4, 6, 4, 4, 6, 4, 4, 6, 4, 4, 6]"
选冠子 ,张雨,平仄平平，平平平仄，平仄仄平平仄。平仄平平，仄平平仄，仄仄仄平平仄。仄仄平平，平平仄仄，仄仄仄平平仄。仄平平、仄仄平平，平仄仄平平仄。平仄仄。仄仄平平，平平仄仄，平仄仄平平仄。平仄平平，仄平平仄，仄仄仄平平仄。仄仄平平，平平仄仄，仄仄仄平平仄。仄平平、平仄平平，仄仄仄平平仄。,0,57,56,113,"[4, 4, 6, 4, 4, 6, 4, 4, 6, 3, 4, 6, 3, 4, 4, 6, 4, 4, 6, 4, 4, 6, 3, 4, 6]"
选冠子 ,吕渭老,仄仄平平，平平仄仄，平仄仄平平仄。平平仄仄，仄仄平平，平仄仄平平仄。平仄仄平，仄仄平平，仄平平仄。仄平平平仄，仄平平仄，仄平平仄。平仄仄、仄仄平平，平平平仄，平仄仄平平仄。平平仄仄，仄仄平平，仄仄仄平平仄。平仄仄平，平仄平平，平平平仄。仄仄平平仄，平仄平平仄仄。,0,55,52,107,"[4, 4, 6, 4, 4, 6, 4, 4, 4, 5, 4, 4, 3, 4, 4, 6, 4, 4, 6, 4, 4, 4, 5, 6]"
选冠子 ,张肎,仄仄平平，平平仄仄，仄仄仄平仄。平平仄仄，仄仄平平，仄仄仄平平仄。平平平平仄仄，仄仄平平，平平仄仄。仄平平平仄，平平仄，平平仄仄。仄平仄仄仄平平，仄仄仄仄，仄仄仄平仄。仄平平仄，平仄平平，平仄仄平平仄。仄仄平平，仄平仄仄，仄仄平平仄仄。仄平平仄仄，仄平仄，平平平仄。,0,49,60,109,"[4, 4, 5, 4, 4, 6, 6, 4, 4, 5, 3, 4, 7, 4, 5, 4, 4, 6, 4, 4, 6, 5, 3, 4]"
选冠子 ,曹勛,仄仄平平，平平平仄，仄仄平平平仄。平平仄仄，仄仄平平，平仄仄仄平仄。平仄平平，仄平平仄，平仄仄平平仄。仄平平仄仄，平平仄仄，仄仄平平仄。平仄仄、仄仄平平，平平平仄，仄仄平平仄仄。平平仄仄，仄仄平平，平仄仄平平仄。平仄平平仄仄，平平平仄，仄平平仄。仄平平平仄，平平仄仄平仄仄。,0,57,56,113,"[4, 4, 6, 4, 4, 6, 4, 4, 6, 5, 4, 5, 3, 4, 4, 6, 4, 4, 6, 6, 4, 4, 5, 7]"
霜叶飞 ,周邦彦,仄平平仄。平平仄，平平平仄平仄。仄平平仄仄平平，仄仄平平仄。仄仄仄、平平仄仄。平平平仄平平仄。仄仄仄平平，仄仄仄、平平仄仄，仄仄平仄。平仄仄仄平平，平平平仄，仄仄平仄平仄。仄平平仄仄平平，仄仄平平仄。仄仄仄平平仄仄。平平平仄平平仄。仄仄平、平平仄，平仄平平，仄平平仄。,0,55,56,111,"[4, 3, 6, 7, 5, 3, 4, 7, 5, 3, 4, 4, 6, 4, 6, 7, 5, 7, 7, 3, 3, 4, 4]"
霜叶飞 ,方千里,平平平仄，平平仄，平平平仄平仄。仄平平仄仄平平，平仄平平仄。仄仄仄、平平仄仄。平平平仄平平仄。仄仄仄平平，仄仄仄平平，仄仄平仄。平仄仄仄平平，平平平仄，仄仄平仄平仄。仄平平仄仄平平，仄仄平平仄。仄仄仄平平仄仄。平平平仄平平仄。仄仄仄、平平仄，平仄平平，仄平平仄。,0,56,53,109,"[4, 3, 6, 7, 5, 3, 4, 7, 5, 5, 4, 6, 4, 6, 7, 5, 7, 7, 3, 3, 4, 4]"
霜叶飞 ,张炎,仄平平仄。平平仄，平平平仄平仄。仄平仄仄仄平平，仄仄平平仄。仄仄仄、平平仄仄。平平平仄平平仄。仄仄平平仄，仄仄仄、平平仄仄。平仄平仄。平仄仄仄平平，仄平平仄，仄平平仄平仄。仄平平仄仄平平，仄仄平平仄。仄仄仄平平仄仄。平平仄仄平平仄。仄仄仄、平平仄，平仄平平，仄平仄仄。,0,52,59,111,"[4, 3, 6, 7, 5, 3, 4, 7, 5, 3, 4, 4, 6, 4, 6, 7, 5, 7, 7, 3, 3, 4, 4]"
霜叶飞 ,张炎,仄平平仄。平平仄，平平平仄平仄。仄平平仄仄平平，仄仄平平仄。仄仄仄、平平仄仄。仄平平仄平平仄。仄仄平平仄，仄仄仄平平，仄平平仄平仄。仄仄仄仄平平，仄平平仄，仄平平仄平仄。仄平仄仄仄平平，仄仄平平仄。仄仄仄、平平仄仄。平平平仄平平仄。仄仄仄平平，仄仄平平，仄平平仄。,0,52,58,110,"[4, 3, 6, 7, 5, 3, 4, 7, 5, 5, 6, 6, 4, 6, 7, 5, 3, 4, 7, 5, 4, 4]"
霜叶飞 ,沈唐,平平平仄，平平仄，平平平仄平仄。仄平平仄，仄平平仄，仄平平仄。仄平仄、平平仄仄。平平平仄平平仄。仄仄平平仄，平仄仄、平平仄平，仄平平仄。平仄平仄平平，仄平仄仄，仄仄平平平仄。仄平平仄，仄仄平平，仄平平仄。仄平仄、平平仄仄。平平仄仄平平仄。仄仄仄、平平仄，平仄平平，仄平平仄。,0,59,52,111,"[4, 3, 6, 4, 4, 4, 3, 4, 7, 5, 3, 4, 4, 6, 4, 6, 4, 4, 4, 3, 4, 7, 3, 3, 4, 4]"
霜叶飞 ,沈唐,仄平平仄，平平仄，平平平仄平仄。仄平平仄，仄平平仄，仄平平仄。仄仄仄、平平仄仄。平平平仄平平仄。仄仄仄平平，仄仄平平，仄平平仄平仄。平仄平仄平平，仄仄平平平，仄仄平仄平仄。仄平平仄，仄仄平平，仄平平仄。仄平仄平平仄仄。平平平仄平平仄。仄仄仄平平，仄仄仄平平，仄平平仄。,0,57,54,111,"[4, 3, 6, 4, 4, 4, 3, 4, 7, 5, 4, 6, 6, 5, 6, 4, 4, 4, 7, 7, 5, 5, 4]"
霜叶飞 ,黄裳,平平平仄平平仄。平平平仄平仄。仄平平仄，仄平平仄，仄平平仄。仄平仄、平平仄仄。平平平仄平平仄。仄仄仄、平平仄。平仄平平仄平，仄平平仄。平仄平仄平平，平仄仄仄仄，仄仄平仄平仄。仄平平仄，仄仄平平，仄平平仄。仄平仄、平平仄仄。平平仄仄平平仄。仄仄仄、平平仄。平仄平平，仄平平仄。,0,58,54,112,"[7, 6, 4, 4, 4, 3, 4, 7, 3, 3, 6, 4, 6, 5, 6, 4, 4, 4, 3, 4, 7, 3, 3, 4, 4]"
五綵结同心 ,赵彦端,平平平仄，仄仄平平，平平仄仄平平。平仄平平仄，平平仄、平仄仄仄平平。平平平仄平平仄，平平仄、平仄平平。平平仄、平平仄仄，仄平仄仄平平。仄平仄平平仄，仄平平仄仄，仄仄平平。平仄平平仄，平平仄、平仄仄仄平平。仄平平仄平平仄，仄平仄、平仄平平。仄仄仄、平平平仄，仄平仄仄平平。,0,63,48,111,"[4, 4, 6, 5, 3, 6, 7, 3, 4, 3, 4, 6, 6, 5, 4, 5, 3, 6, 7, 3, 4, 3, 4, 6]"
五綵结同心 ,无名氏,平平平仄。平仄平平，平仄仄平平仄。平仄平平仄，仄平仄、仄仄仄平平仄。仄平仄仄平平仄，平平仄、平平平仄。平平仄、仄平平仄，仄仄仄平仄仄。平平仄平平仄。平仄平仄仄，仄平平仄。平仄平平仄，平平仄、平仄仄平平仄。仄平仄仄平平仄。仄仄仄、平平平仄。仄仄仄、平平仄仄，仄仄平平仄仄。,0,54,57,111,"[4, 4, 6, 5, 3, 6, 7, 3, 4, 3, 4, 6, 6, 5, 4, 5, 3, 6, 7, 3, 4, 3, 4, 6]"
透碧霄 ,柳永,仄平平。仄平平仄仄平平。仄平仄仄，平平平仄，仄仄平平。平平平仄，平平仄仄，平仄平平。仄平平、平仄平平。仄仄平平仄，平平平仄，仄仄平平。仄平平仄仄，平平平仄，仄仄仄平平。仄仄平、平平仄，平仄仄仄平平。仄平仄仄，平平仄仄，平仄平平。仄平平、平仄平平。仄仄平平仄，平仄平平，仄仄平平。,0,63,49,112,"[3, 7, 4, 4, 4, 4, 4, 4, 3, 4, 5, 4, 4, 5, 4, 5, 3, 3, 6, 4, 4, 4, 3, 4, 5, 4, 4]"
透碧霄 ,查荎,仄平平。仄平平仄仄平平。仄平仄仄，平平平仄，仄仄平平。平平平仄，平平仄平，仄仄平平。仄平平、仄仄平平。仄平平平仄，平平平仄，仄仄平平。仄平平仄仄，平平平仄，平仄仄平平。仄仄平、平平仄，平仄仄、仄平平。仄平仄仄，平平平仄，平仄平平。仄仄平、平仄平平。仄平平仄仄，平仄平平，仄仄平平。,0,64,48,112,"[3, 7, 4, 4, 4, 4, 4, 4, 3, 4, 5, 4, 4, 5, 4, 5, 3, 3, 3, 3, 4, 4, 4, 3, 4, 5, 4, 4]"
透碧霄 ,曹勛,仄仄仄平平。仄仄平、平仄仄平。仄仄平平，仄平平仄，平平仄平平。平平仄仄平平仄，仄仄仄平平。仄平平、平仄平平。仄仄仄、平平平仄，仄平平仄仄平平。仄平平。平平平平，平仄仄仄仄平平。仄仄平仄，仄平平仄，仄仄平平。平平仄仄，平平仄仄，平仄平平。仄平仄、仄仄平平。仄仄仄平平，平平仄仄，平仄仄平平。,0,62,55,117,"[5, 3, 4, 4, 4, 5, 7, 5, 3, 4, 3, 4, 7, 3, 4, 7, 4, 4, 4, 4, 4, 4, 3, 4, 5, 4, 5]"
玉山枕 ,柳永,仄仄平仄。仄平仄、平平仄。仄平仄仄，平平仄仄，平仄平平，仄仄平仄。仄平平仄仄平平，仄仄仄、仄平平仄。平仄平、平仄平平，仄平平，仄平平平仄。仄平平仄平平仄。仄平仄、平平仄。仄平仄仄，平平仄仄，仄仄平平，仄仄平仄。仄平平仄仄平平，仄平仄、仄平平仄。仄平平、仄仄平平，仄平平，仄平平平仄。,0,56,57,113,"[4, 3, 3, 4, 4, 4, 4, 7, 3, 4, 3, 4, 3, 5, 7, 3, 3, 4, 4, 4, 4, 7, 3, 4, 3, 4, 3, 5]"
期夜月 ,刘濬,平平平仄仄平仄。平平仄平仄。平仄仄，平仄仄。平平仄仄，仄仄仄平平仄。平仄。平平仄仄仄平仄。平平仄平仄。平仄仄，平仄仄，平平仄仄，仄仄仄平平仄。平平仄仄仄仄，仄仄仄仄，平平平仄。仄仄平平仄仄，仄仄平平仄。平仄。平平仄仄平平仄。仄仄平平仄。平平仄，仄平仄，仄平仄仄，仄仄仄平平仄。,0,48,65,113,"[7, 5, 3, 3, 4, 6, 2, 7, 5, 3, 3, 4, 6, 6, 4, 4, 6, 5, 2, 7, 5, 3, 3, 4, 6]"
轮台子 ,柳永,仄仄平平仄仄，仄仄仄、平平仄仄。平平仄仄平平，仄仄仄平平仄。平平平仄平平，仄平平、仄仄平平仄。仄平平仄仄，仄仄平平平平仄。平平仄仄平平，仄平仄、仄平仄仄。仄平平、仄平平仄仄，平平平仄。仄仄仄平平，仄平仄仄。仄仄仄平平，仄平平平仄。仄平平、平平仄仄。仄平仄、仄仄平平，平仄平平仄。,0,56,58,114,"[6, 3, 4, 6, 6, 6, 3, 5, 5, 7, 6, 3, 4, 3, 5, 4, 5, 4, 5, 5, 3, 4, 3, 4, 5]"
轮台子 ,柳永,仄仄平平，平仄平平仄。平平仄平平，仄仄仄仄，仄平平仄。平平仄仄平仄仄。平仄仄、仄仄仄平平仄。仄平平仄平仄仄，平仄仄、仄平平仄。仄平仄。平平仄平，仄平平仄仄。仄仄平平仄。仄仄平平仄平平仄。平仄平平、平仄仄。仄仄平平仄，平平仄平，平平平仄。平平仄仄平平仄。仄仄仄仄仄，平平仄仄。仄平平仄，平仄平平，平平仄仄平平仄。仄平平仄。仄平仄、仄平仄平仄。,0,67,73,140,"[4, 5, 5, 4, 4, 7, 3, 6, 7, 3, 4, 3, 4, 5, 5, 8, 4, 3, 5, 4, 4, 7, 5, 4, 4, 4, 7, 4, 3, 5]"
沁园春 ,苏轼,平仄平平，仄仄平平，仄仄仄平。仄仄平平仄，平平仄仄，平平平仄，平仄平平。仄仄平平，平平仄仄，仄仄平平平仄平。平平仄，仄平平平仄，仄仄平平。平平仄仄平平。仄仄仄、平平平仄平。仄仄平平仄，平平仄仄，仄平平仄，仄仄平平。仄仄平平，平平仄仄，仄仄平平平仄平。平平仄，仄平平仄仄，仄仄平平。,0,61,53,114,"[4, 4, 4, 5, 4, 4, 4, 4, 4, 7, 3, 5, 4, 6, 3, 5, 5, 4, 4, 4, 4, 4, 7, 3, 5, 4]"
沁园春 ,贺铸,平仄平平，仄平平仄，仄平仄平。仄仄平平仄，平平仄仄，平平平仄，平仄平平。仄仄平平，平平平仄，平仄平平平仄平。平平仄，仄平平仄仄，仄仄平平。平平。仄仄平平。仄平仄、平平平仄平。仄仄平平仄，平平仄仄，平平平仄，平仄平平。平仄平平，仄平平仄，仄仄平平平仄平。平平仄，仄平平仄仄，仄仄平平。,0,67,47,114,"[4, 4, 4, 5, 4, 4, 4, 4, 4, 7, 3, 5, 4, 2, 4, 3, 5, 5, 4, 4, 4, 4, 4, 7, 3, 5, 4]"
沁园春 ,葛长庚,平仄平平，平仄平平，平平仄平。仄仄平平仄，平平平仄，仄平仄仄，仄仄平平。平仄平平，仄平仄仄，仄平仄平平平仄平。平平仄，仄仄平仄仄，仄仄平平。平平。仄仄平平。平仄仄平平仄仄平。仄仄平平仄，平平仄仄，平平平仄，仄仄平平。平仄仄平，仄平平仄，仄仄仄平平仄仄平。平平仄，仄仄平平仄，平仄平平。,0,62,54,116,"[4, 4, 4, 5, 4, 4, 4, 4, 4, 8, 3, 5, 4, 2, 4, 8, 5, 4, 4, 4, 4, 4, 8, 3, 5, 4]"
沁园春 ,林正大,仄平平平，仄平平仄，仄仄平平。仄平平仄仄，仄平仄仄，仄平平仄仄，平仄平平。仄仄平平，仄平平仄，平仄平平仄仄平。仄平仄，平平平仄仄，平仄平平。平平仄仄平平。仄仄仄、平平仄仄平。仄平平平仄，平平仄仄，仄平平平仄，仄仄平平。仄仄平平，仄平平仄，仄仄平平仄仄平。平平仄，仄平平仄仄，平仄平平。,0,61,55,116,"[4, 4, 4, 5, 4, 5, 4, 4, 4, 7, 3, 5, 4, 6, 3, 5, 5, 4, 5, 4, 4, 4, 7, 3, 5, 4]"
沁园春 ,李刘,仄仄平平，平平仄仄，仄平仄平。仄平平仄仄，仄平平仄，平平平仄，仄仄平平。仄仄平平，平平仄仄，仄仄平平平仄平。平平仄，平平仄仄，平仄平平。平平仄仄平平。仄仄仄、平平平仄平。仄平平平仄，仄平仄仄，平平平仄，仄仄平平。仄仄平平，仄平平仄，平仄平平平仄平。仄仄仄，平平平仄，平仄平平。,0,62,50,112,"[4, 4, 4, 5, 4, 4, 4, 4, 4, 7, 3, 4, 4, 6, 3, 5, 5, 4, 4, 4, 4, 4, 7, 3, 4, 4]"
沁园春 ,秦观,仄仄平平，仄平平仄，仄仄仄平。仄平平平仄，平平仄仄，仄平平仄，仄仄平平。仄仄平平平仄仄，仄平仄平平平仄平。平仄仄，仄平平仄仄，平仄平平。平平仄平仄仄，仄平平仄仄，平仄平平。仄仄平平仄，平平仄仄，仄平平仄，平仄平平。仄仄平平平仄仄，仄平仄平平平仄平。平仄仄，仄平平仄仄，平仄平平。,0,59,56,115,"[4, 4, 4, 5, 4, 4, 4, 7, 8, 3, 5, 4, 6, 5, 4, 5, 4, 4, 4, 7, 8, 3, 5, 4]"
沁园春 ,程垓,仄仄平平，仄平平仄，仄仄仄平。仄仄平平仄，平平仄仄，仄平平仄，平仄平平。仄仄平平平仄仄，仄仄仄平平平仄平。平仄仄，仄平平仄仄，平仄平平。平平仄平仄仄，仄平仄平仄平平。仄仄平平仄，平平仄仄，仄平平仄，平仄平平。平仄仄平平仄仄，仄平平、平平平仄平。平平仄，仄平平仄仄，仄仄平平。,0,58,55,113,"[4, 4, 4, 5, 4, 4, 4, 7, 8, 3, 5, 4, 6, 7, 5, 4, 4, 4, 7, 3, 5, 3, 5, 4]"
丹凤吟 ,周邦彦,平仄平平平仄，仄仄平平，平平平仄。平平平仄，平仄仄平平仄。平平仄仄，仄平平仄，仄仄平平，平平平仄。仄仄平平仄仄，仄仄平平，平仄平仄平仄。仄仄仄平仄仄，仄平仄仄平仄仄。仄仄平平仄，仄平平平仄，平仄平仄。平平平仄，仄仄仄平平仄。仄仄平平平仄仄，仄平平平仄。仄平仄仄，平仄平仄仄。,0,55,59,114,"[6, 4, 4, 4, 6, 4, 4, 4, 4, 6, 4, 6, 6, 7, 5, 5, 4, 4, 6, 7, 5, 4, 5]"
丹凤引 ,吴文英,仄仄平平平仄，仄仄平平，仄平平仄。平平仄仄，平仄仄平平仄。平平仄仄，仄平仄仄，仄仄平平，平平仄仄。仄仄平平仄仄，仄仄平平平仄，平仄平仄。仄仄平平仄仄，仄平仄仄平仄仄。仄仄平平仄，仄平平平仄，仄平平仄。平平平仄，仄仄仄平平仄。仄仄仄平平仄仄，仄平平平仄。仄平仄仄，平仄平仄仄。,0,50,64,114,"[6, 4, 4, 4, 6, 4, 4, 4, 4, 6, 6, 4, 6, 7, 5, 5, 4, 4, 6, 7, 5, 4, 5]"
丹凤引 ,张翥,平平平仄。仄仄仄平平，平平平仄。仄仄平平，仄仄仄平平仄。平平仄平仄仄，仄平平、仄平平仄。仄仄平平，平平仄仄，仄仄平平仄。仄仄平、平仄仄平仄。仄仄仄平平，平仄平仄。仄仄平平仄，仄仄平平仄。仄平仄平仄仄，仄平平、仄平平仄。仄仄平平仄仄，仄平平平仄。,0,47,53,100,"[4, 5, 4, 4, 6, 6, 3, 4, 4, 4, 5, 3, 5, 5, 4, 5, 5, 6, 3, 4, 6, 5]"
紫萸香慢 ,姚云文,仄平平、平平平仄，仄平仄仄平平。仄平平平仄，仄平仄，仄平平。仄仄平平平仄，仄平平平仄，仄仄平平。仄平平、仄仄仄仄仄平平，仄仄仄、仄平仄平。平平。仄仄平平。平仄仄、仄平平。仄平平仄仄，平平仄仄，平仄平平。仄平仄平平仄，仄平仄、仄平平。仄平平、仄平平仄，仄平平仄，平仄平仄平平。平仄仄平。,0,60,54,114,"[3, 4, 6, 5, 3, 3, 6, 5, 4, 3, 7, 3, 4, 2, 4, 3, 3, 5, 4, 4, 6, 3, 3, 3, 4, 4, 6, 4]"
瑶台月 ,无名氏,平平仄仄，仄仄仄，平平平仄平仄。平平仄平，平平仄仄平仄。仄仄平、仄仄平平，平平仄、平平平仄。平仄仄，平平仄。仄仄仄，仄平仄。平平仄仄，平平仄仄。仄仄仄、平平仄仄。仄仄平仄仄仄仄。仄平平仄仄，平平平仄。仄平平、仄仄平平，仄仄仄、平平平仄。平仄仄，平平仄。仄仄仄，平仄仄。平平仄仄，平仄仄仄。,0,50,64,114,"[4, 3, 6, 4, 6, 3, 4, 3, 4, 3, 3, 3, 3, 4, 4, 3, 4, 7, 5, 4, 3, 4, 3, 4, 3, 3, 3, 3, 4, 4]"
瑶台月 ,葛长庚,平平平仄。仄仄仄平平，平仄平仄。平平仄，平平仄仄平平仄。仄平仄、仄仄平平，仄仄仄、平平仄仄。仄平仄，平平仄。平仄仄，平仄仄。平仄。仄平平仄仄，平平仄仄。仄平平、仄仄平平，仄仄平、平仄平仄。平仄平仄仄，仄平平仄。仄仄仄、仄仄平平，仄仄仄、平平平仄。仄平仄，仄平仄。平平仄，仄平仄。平仄。仄平平仄仄，平平仄仄。,0,54,66,120,"[4, 5, 4, 3, 7, 3, 4, 3, 4, 3, 3, 3, 3, 2, 5, 4, 3, 4, 3, 4, 5, 4, 3, 4, 3, 4, 3, 3, 3, 3, 2, 5, 4]"
瑶台月 ,无名氏,平平仄仄。平平仄，平平平仄平仄。平平仄仄，仄仄平平平仄。平仄仄、仄仄平平，仄仄仄、平平平仄。平平仄，平平仄。平平仄，仄平仄。平仄。平平仄仄，平平仄仄。仄平仄、平仄平仄。仄仄仄、平平仄仄。平平仄平仄，仄平平仄。仄平平、平仄平平，仄仄仄、平平平仄。平平仄，平平仄。仄平仄，仄平仄。平仄。平平仄仄，平平平仄。,0,61,57,118,"[4, 3, 6, 4, 6, 3, 4, 3, 4, 3, 3, 3, 3, 2, 4, 4, 3, 4, 3, 4, 5, 4, 3, 4, 3, 4, 3, 3, 3, 3, 2, 4, 4]"
宣清 ,柳永,平仄平平，仄仄平平，平平平平仄仄。仄平平、平仄仄平，仄平平、仄平平仄。仄仄平平，平平仄仄，平平仄仄。仄平平，仄平平，平平平仄平仄。仄仄仄平平，仄平仄仄，平平平仄仄。仄仄仄平平，平平仄仄，仄仄平平，仄仄平平平仄。仄平平、平平仄仄。仄平平、仄平平仄。仄平平仄，仄仄仄平平，仄平平、仄平平仄。,0,62,53,115,"[4, 4, 6, 3, 4, 3, 4, 4, 4, 4, 3, 3, 6, 5, 4, 5, 5, 4, 4, 6, 3, 4, 3, 4, 4, 5, 3, 4]"
八归 ,姜夔,平平仄仄，平平平仄，平仄仄仄仄仄。平平仄仄平平仄，平仄仄平平仄，仄平平仄。仄仄平平平仄仄，仄仄仄平平平仄。仄仄仄、仄仄平平，仄仄仄平仄。平仄平平仄仄，平平平仄，仄仄平平平仄。仄平平仄，仄平平仄，仄仄平平平仄。仄平平仄仄，仄仄平平仄平仄。平平仄、仄平平仄，仄仄平平，平平平仄仄。,0,54,61,115,"[4, 4, 6, 7, 6, 4, 7, 7, 3, 4, 5, 6, 4, 6, 4, 4, 6, 5, 7, 3, 4, 4, 5]"
八归 ,高观国,仄平仄仄，平平平仄，平仄仄仄平平。平平仄仄平平仄，平平仄仄平平，仄仄平平。仄仄平平平仄仄，仄平仄、平仄平平。仄仄仄、平仄平平。仄平仄平平。平平。平平平仄，平平平仄，仄平平仄平平。仄平平仄，仄平平仄，平仄平仄平平。仄平平仄仄，仄平仄仄仄平平。仄平仄、仄平平仄，仄仄平平平仄平。,0,62,51,113,"[4, 4, 6, 7, 6, 4, 7, 3, 4, 3, 4, 5, 2, 4, 4, 6, 4, 4, 6, 5, 7, 3, 4, 7]"
摸鱼儿 ,晁补之,仄平平、仄平平仄，平平平仄平仄。平平仄仄平平仄，平仄仄平平仄。平仄仄。仄仄仄、仄平仄仄平平仄。平平仄仄。仄仄仄平平，平平仄仄，仄仄仄平仄。平平仄，平仄平平仄仄。平平平仄平仄。平平平仄平平仄，平仄仄平平仄。平仄仄。仄平仄、平平仄仄平平仄。平平仄仄。仄仄仄平平，平平仄仄，平仄仄平仄。,0,57,59,116,"[3, 4, 6, 7, 6, 3, 3, 7, 4, 5, 4, 5, 3, 6, 6, 7, 6, 3, 3, 7, 4, 5, 4, 5]"
摸鱼儿 ,辛弃疾,仄平平、仄平平仄。平平平仄平仄。仄平平仄平平仄，平仄仄平平仄。平仄仄。仄仄仄、平平平仄平平仄。仄平仄仄。仄仄仄平平，仄平平仄，仄仄仄平仄。平平仄，仄仄平平仄仄。平平平仄平仄。平平仄仄平平仄，仄仄仄平平仄。平仄仄。平仄仄、仄平平仄平平仄。平平仄仄。平仄仄平平，平平仄仄，平仄仄平仄。,0,56,60,116,"[3, 4, 6, 7, 6, 3, 3, 7, 4, 5, 4, 5, 3, 6, 6, 7, 6, 3, 3, 7, 4, 5, 4, 5]"
摸鱼儿 ,李演,仄平平、仄平平仄，平平平仄平仄。平平仄仄平平仄，仄仄平平平仄。平仄仄。仄仄仄平平，仄仄平平仄。平平仄仄。仄仄仄平平，平平仄仄，平仄仄平仄。平平仄。仄仄平平仄仄。平平平仄平仄。平平仄仄平平仄，平仄仄平平仄。平仄仄。仄仄仄平平，仄仄平平仄。平平仄仄。仄仄仄平平，平平仄仄，平仄仄平仄。,0,56,60,116,"[3, 4, 6, 7, 6, 3, 5, 5, 4, 5, 4, 5, 3, 6, 6, 7, 6, 3, 5, 5, 4, 5, 4, 5]"
摸鱼儿 ,张炎,仄平平、仄平平仄。平平仄仄平仄。平平仄仄平平仄，平仄仄平平仄。平仄仄。仄仄仄平平，仄仄平平仄。平平仄仄。仄仄仄平平，平平平仄，平仄仄平仄。平平仄。仄仄平平平仄。平平平仄平仄。平平仄仄平平仄，仄仄平平仄仄。平仄仄。仄仄仄平平，仄仄平平仄。平平仄仄。仄仄仄平平，平平仄仄，仄仄仄平仄。,0,55,61,116,"[3, 4, 6, 7, 6, 3, 5, 5, 4, 5, 4, 5, 3, 6, 6, 7, 6, 3, 5, 5, 4, 5, 4, 5]"
摸鱼儿 ,白朴,仄平平、仄平仄仄。平平仄仄平仄。平平仄仄平平仄，平仄仄平平仄。平仄仄。平仄仄。仄平平仄平平仄。平平仄仄。仄平仄平平，平平仄仄，仄仄仄平仄。平平仄。仄仄平平仄仄。平平平仄平仄。仄平平仄平平仄，仄仄仄平平仄。平仄仄。平仄仄。平平仄仄平平仄。平平仄仄。仄平仄平平，平平平仄，仄仄仄平仄。,0,56,60,116,"[3, 4, 6, 7, 6, 3, 3, 7, 4, 5, 4, 5, 3, 6, 6, 7, 6, 3, 3, 7, 4, 5, 4, 5]"
摸鱼儿 ,赵从橐,仄平平、仄平仄仄。平平平仄平仄。仄平仄仄平平仄，仄仄仄平平仄。平仄仄。仄仄平平，仄仄平平仄。平平仄仄。仄仄仄平平，平平平仄，仄仄仄平仄。平平仄，平仄平平仄仄。平平平仄平仄。平平仄仄平平仄，平仄仄平平仄。平仄仄。仄仄平平，仄仄平平仄。平平仄仄。仄仄仄平平，平平仄仄，平仄仄平仄。,0,54,60,114,"[3, 4, 6, 7, 6, 3, 4, 5, 4, 5, 4, 5, 3, 6, 6, 7, 6, 3, 4, 5, 4, 5, 4, 5]"
摸鱼儿 ,徐一初,仄平平、仄平仄仄。平平平仄平仄。平平仄仄平平仄，平仄平平平仄。平仄仄。仄仄仄平平，仄仄平平仄。平平仄仄。平平仄平平，仄平平仄，仄仄仄平仄。平仄仄，仄仄平平仄仄。平平仄仄平仄。平平仄仄平平仄，仄仄仄平平仄。平仄仄。平仄仄平平，仄仄平平仄。平平平仄。仄仄仄、平平平仄，平仄仄平仄。,0,55,59,114,"[3, 4, 6, 7, 6, 3, 5, 5, 4, 5, 4, 5, 3, 6, 6, 7, 6, 3, 5, 5, 4, 3, 4, 5]"
摸鱼儿 ,欧阳修,仄仄平、平平平仄仄，仄仄仄平平仄。仄仄平、平仄平平仄，仄仄仄平平仄。平仄仄。仄平仄仄仄，仄仄平平仄。仄平仄仄。仄仄仄平平，仄平仄仄，仄仄平平仄。平平仄。仄仄平平仄仄，平平平仄平仄。仄平平平仄，平平仄仄平平仄。仄平仄、仄平仄平平，仄仄平平仄。平平仄仄，仄仄仄平平，平平平仄，平平仄平仄。,0,53,64,117,"[3, 5, 6, 3, 5, 6, 3, 5, 5, 4, 5, 4, 5, 3, 6, 6, 5, 7, 3, 5, 5, 4, 5, 4, 5]"
摸鱼儿 ,无名氏,仄平仄仄，平平仄平平，仄仄平平。平平仄仄仄平平，仄平平仄平平。仄平平，仄仄仄。平平仄仄平平仄。平平平仄。仄仄平平仄平平。仄仄平平仄仄仄。平平仄，仄平仄。平平仄平平，平仄平平。平平平仄仄平平，仄平平仄平仄。仄平平，仄平仄平平，仄仄平仄仄。平平平仄。仄仄平平仄平平。仄仄平平仄平仄。,0,64,52,116,"[4, 5, 4, 7, 6, 3, 3, 7, 4, 7, 7, 3, 3, 5, 4, 7, 6, 3, 5, 5, 4, 7, 7]"
贺新郎 ,叶梦得,仄仄平平仄。仄平平、平平仄仄，仄平平仄。平仄平平平平仄，平仄平平仄仄。仄仄仄、平平平仄。仄仄平平平仄仄，仄平平、仄仄平平仄。平仄仄，仄平仄。平平仄仄平平仄。仄平平、平平仄平，仄平平仄。平仄平平平平仄，平仄仄平仄仄。仄仄仄、平平平仄。仄仄平平平平仄，仄平平、仄仄平平仄。平仄仄，仄平仄。,0,59,57,116,"[5, 3, 4, 4, 7, 6, 3, 4, 7, 3, 5, 3, 3, 7, 3, 4, 4, 7, 6, 3, 4, 7, 3, 5, 3, 3]"
贺新郎 ,辛弃疾,仄仄平平仄。仄平平、仄仄平平，仄平平仄。平仄平平平平仄。仄仄仄平平仄。仄仄仄、平平仄仄。仄仄平平平仄仄。仄平平、仄仄平平仄。平仄仄，平平仄。平平仄仄平平仄。仄平平、平平仄仄，仄平平仄。仄仄平平平仄仄。平仄平平仄仄。仄平仄、平平平仄。仄仄平平平平仄。仄平平、仄仄平平仄。平仄仄，仄平仄。,0,57,59,116,"[5, 3, 4, 4, 7, 6, 3, 4, 7, 3, 5, 3, 3, 7, 3, 4, 4, 7, 6, 3, 4, 7, 3, 5, 3, 3]"
贺新郎 ,苏轼,仄仄平平仄。仄平平、平平仄仄，仄平平仄。仄仄平平仄平仄，仄仄仄平仄仄。仄仄仄、平平平仄。平仄平平平仄仄，仄平平、仄仄平平仄。仄仄仄，平平仄。仄平仄仄平平仄。仄平平仄仄平仄，仄平平仄。平仄仄平仄仄仄，平仄平平仄仄。仄仄仄、平平平仄。仄仄仄平平仄仄，平平仄仄仄仄仄。仄仄仄，仄仄仄。,0,45,70,115,"[5, 3, 4, 4, 7, 6, 3, 4, 7, 3, 5, 3, 3, 7, 7, 4, 7, 6, 3, 4, 7, 7, 3, 3]"
贺新郎 ,辛弃疾,仄仄平平仄。仄平平、仄平平仄，仄平仄仄。平仄平平平平仄，平仄平平仄仄。仄平仄、平平平仄。仄仄平平平平仄。仄平平、仄仄平平仄。平仄仄，平平仄。平平平仄平平仄。仄平平、平平仄仄，仄平平仄。平仄平平平仄仄。仄平仄、平平仄仄。仄平仄、平平平仄。平仄平平平平仄，仄平平、平仄平平仄。平仄仄，平平仄。,0,65,52,117,"[5, 3, 4, 4, 7, 6, 3, 4, 7, 3, 5, 3, 3, 7, 3, 4, 4, 7, 3, 4, 3, 4, 7, 3, 5, 3, 3]"
贺新郎 ,《豹隐纪谈》平江妓,平仄平平仄。仄平平、仄仄平平，仄平平仄。平仄平平平仄仄，仄仄仄、仄平平仄。仄仄仄、仄平平仄。仄仄平平平仄仄。仄平平、仄仄平平仄。平仄仄，平平仄。平平仄仄平平仄。仄平平、平仄平平，仄平平仄。仄仄平平平仄仄，平仄平平仄仄。仄仄仄、仄平平仄。仄仄平平平仄仄。仄仄平、仄仄平平仄。仄仄仄，仄平仄。,0,53,64,117,"[5, 3, 4, 4, 7, 3, 4, 3, 4, 7, 3, 5, 3, 3, 7, 3, 4, 4, 7, 6, 3, 4, 7, 3, 5, 3, 3]"
贺新郎 ,史达祖,平仄平平仄。仄平平、平平仄仄，仄平平仄。平仄平平平仄仄，平仄仄平平仄。仄仄仄、平平平仄。仄仄仄平平仄仄，仄仄平、仄仄平平仄。仄平仄，仄平仄。仄平仄仄平平仄。仄平平仄仄，平仄仄平平仄。仄仄仄平平仄仄，仄仄平平仄仄。仄仄仄、平平平仄。仄仄仄平平仄仄，仄仄平、平仄平平仄。仄仄仄，仄平仄。,0,48,68,116,"[5, 3, 4, 4, 7, 6, 3, 4, 7, 3, 5, 3, 3, 7, 5, 6, 7, 6, 3, 4, 7, 3, 5, 3, 3]"
贺新郎 ,史达祖,仄仄平平仄。仄平平平平，平仄仄平平仄。仄仄仄平平仄仄，仄仄平平仄仄。仄平仄、平平平仄。平仄仄平平仄仄，仄平平、平仄平平仄。平仄仄，仄平仄。仄平仄仄平平仄。仄平平仄仄，平仄仄平平仄。仄仄平平平仄仄，仄仄平平平仄。仄仄仄、仄平平仄。平仄平平平仄仄，仄平平、平仄平平仄。平仄仄，仄平仄。,0,54,62,116,"[5, 5, 6, 7, 6, 3, 4, 7, 3, 5, 3, 3, 7, 5, 6, 7, 6, 3, 4, 7, 3, 5, 3, 3]"
贺新郎 ,李南金,平仄平平仄。仄仄平平仄仄，仄平平仄仄。平仄平平平仄仄，仄仄平平平仄。平仄仄、仄平平仄。仄仄平平平仄仄，仄平平、平仄平平仄。平仄仄，仄平仄。平平仄仄平平仄。仄仄仄、平平平仄，仄平仄仄。仄仄平平平仄仄，平仄仄平平仄。仄平仄、平平平仄。平仄仄平平仄仄，仄平平、仄仄平平仄。平仄仄，平平仄。,0,55,61,116,"[5, 6, 5, 7, 6, 3, 4, 7, 3, 5, 3, 3, 7, 3, 4, 4, 7, 6, 3, 4, 7, 3, 5, 3, 3]"
贺新郎 ,马庄父,仄仄平平仄。仄平平平仄，平仄仄平仄仄。仄仄平平平仄仄。仄仄平平仄仄。仄仄仄、平平仄仄。仄仄平平平仄仄。仄平平、平仄平平仄。平仄仄，仄平仄。仄平仄仄平平仄。仄平平仄仄，平平平仄。仄仄平平仄平仄。平仄仄、平平仄仄。仄仄仄、平平平仄。仄仄平平平仄仄。仄平平、仄仄平平仄。平仄仄，仄平仄。,0,50,65,115,"[5, 5, 6, 7, 6, 3, 4, 7, 3, 5, 3, 3, 7, 5, 4, 7, 3, 4, 3, 4, 7, 3, 5, 3, 3]"
贺新郎 ,吕渭老,平仄平平仄。仄仄平、平平仄仄，平平平仄。仄仄平平平仄仄，平平仄平仄仄。仄仄仄、平平平仄。平仄平平平仄仄，仄平平、仄仄平平仄。平仄仄，仄平仄。平平仄仄平平仄。仄平平、仄仄仄平平仄。仄仄仄平平仄仄，平平仄平仄仄。仄平仄、仄平平仄。平仄仄，平平仄，仄平平仄仄平平仄。平仄仄，仄平仄。,0,53,60,113,"[5, 3, 4, 4, 7, 6, 3, 4, 7, 3, 5, 3, 3, 7, 3, 6, 7, 6, 3, 4, 3, 3, 8, 3, 3]"
贺新郎 ,周紫芝,仄仄平平仄。仄仄平、平平仄仄，仄平平仄。平仄平平仄平仄，仄仄平平仄仄。仄仄仄、平平仄仄。平仄平平平仄仄，仄平平、仄仄平平仄。平仄仄，平平仄。平平仄仄平平仄。仄平平仄仄，平仄仄平平仄。平仄平平平仄仄，仄仄平平仄仄。仄仄仄、平平仄仄。平仄仄平平，仄仄平平，仄仄平平仄。平仄仄，平平仄。,0,53,62,115,"[5, 3, 4, 4, 7, 6, 3, 4, 7, 3, 5, 3, 3, 7, 5, 6, 7, 6, 3, 4, 5, 4, 5, 3, 3]"
子夜歌 ,彭元逊,仄平平、仄平仄仄，仄仄仄平平仄。仄平仄、平平仄仄，仄仄仄平平仄。平仄仄平，平平平仄，仄仄平平仄。仄平平、平仄平平，平仄仄平，仄仄仄平平仄。仄平仄、平平仄仄，仄仄仄平平仄。平仄平平，平平仄仄，平仄平平仄。仄平平仄仄，平平平仄平仄。平仄平平，仄平平仄，平仄平平仄。仄平平、平仄平平，仄平平仄。,0,60,57,117,"[3, 4, 6, 3, 4, 6, 4, 4, 5, 3, 4, 4, 6, 3, 4, 6, 4, 4, 5, 5, 6, 4, 4, 5, 3, 4, 4]"
吊严陵 ,李甲,仄平平仄，平仄平平，平平仄仄。平仄仄仄，平平平仄。仄仄仄仄，平仄仄平，仄仄平平平仄。平仄平平仄平仄。仄仄仄平仄仄，平仄平平仄仄。仄仄仄平平，平平仄仄。平仄仄平仄。平仄。平平仄平平仄，平平仄仄平平仄。平平平仄，平平仄仄，平仄平平平仄。平平仄仄仄仄。仄仄平平仄仄。仄仄平仄，平仄仄平平仄仄。,0,56,63,119,"[4, 4, 4, 4, 4, 4, 4, 6, 7, 6, 6, 5, 4, 5, 2, 6, 7, 4, 4, 6, 6, 6, 4, 7]"
金明池 ,秦观,平仄平平，平平仄仄，仄仄平平仄仄。平仄仄、平平仄仄，平平仄仄仄仄仄。仄平平、仄仄平平，仄仄仄、平仄平平平仄。仄仄仄平平，平平平仄，仄仄平平平仄。仄仄平平平平仄。仄仄仄平平，仄平平仄。平平仄、平平仄仄，平仄仄、仄平平仄。仄平平、仄仄平平，仄仄仄平平，平平平仄。仄仄仄平平，平平仄仄，仄仄平平平仄。,0,59,61,120,"[4, 4, 6, 3, 4, 7, 3, 4, 3, 6, 5, 4, 6, 7, 5, 4, 3, 4, 3, 4, 3, 4, 5, 4, 5, 4, 6]"
金明池 ,僧挥,平仄平平，平平仄仄，仄仄平平平仄。平平仄、平平仄仄，平平仄、平平平仄。仄平平、仄仄平平，仄仄仄平平，仄平平仄。仄仄仄平平，平平平仄，仄仄平平平仄。仄仄平平平仄仄。仄仄仄平平，平平平仄。平平仄、平平仄仄，平平仄、平平平仄。平平仄、仄仄平平，仄平仄平平，平平平仄。仄平仄平平，平平仄仄，仄仄仄平平仄。,0,67,53,120,"[4, 4, 6, 3, 4, 3, 4, 3, 4, 5, 4, 5, 4, 6, 7, 5, 4, 3, 4, 3, 4, 3, 4, 5, 4, 5, 4, 6]"
送征衣 ,柳永,仄平平。平平仄仄，平仄平平，仄仄平仄仄平。仄平仄、仄平平。平平。仄平仄、平平仄仄，仄仄平平。仄仄仄、平平仄仄，仄平仄、仄平平。仄平平、平仄平平，平仄仄平平。平仄平平平仄，仄仄仄、仄平平。平平仄平仄仄，仄仄平平。平平。平仄仄、平平平仄，平仄平平。仄仄仄平平仄仄，仄平平、仄平平。仄平平、仄仄平平，平平仄平平。,0,66,55,121,"[3, 4, 4, 6, 3, 3, 2, 3, 4, 4, 3, 4, 3, 3, 3, 4, 5, 6, 3, 3, 6, 4, 2, 3, 4, 4, 7, 3, 3, 3, 4, 5]"
笛家 ,柳永,平仄平平，仄平平仄，平平平仄，仄平平仄平平仄。仄平平仄，仄仄平平，平平仄仄，平平平仄。仄仄平平，仄平平仄，仄仄平平仄。仄平平，仄平仄，仄仄平平，仄平仄仄。仄仄。仄平平仄，平平仄仄，仄仄平平，仄仄平平，仄平平仄。仄仄、仄仄平平平仄，仄仄仄平平仄。仄平平平，仄平平仄，平仄平平仄。平平仄，仄平平，仄仄平平，仄平平仄。,0,64,61,125,"[4, 4, 4, 7, 4, 4, 4, 4, 4, 4, 5, 3, 3, 4, 4, 2, 4, 4, 4, 4, 4, 2, 6, 6, 4, 4, 5, 3, 3, 4, 4]"
笛家 ,朱雍,平仄平平，仄仄平仄，平平平仄。仄平平仄平平仄。仄仄平仄，仄仄平平，仄平仄仄，平平平仄。仄仄平平，仄平平仄，仄仄平平仄。仄平平，仄平仄，仄仄仄平仄仄。仄仄。仄仄平仄，平平仄仄，仄仄平平，仄仄平平，平平平仄。仄仄、仄仄平平平仄，仄仄平平平仄。平仄平平，仄平平仄，仄仄平平仄。平平仄，仄平平仄仄，仄平平仄。,0,57,64,121,"[4, 4, 4, 7, 4, 4, 4, 4, 4, 4, 5, 3, 3, 6, 2, 4, 4, 4, 4, 4, 2, 6, 6, 4, 4, 5, 3, 5, 4]"
秋思耗 ,吴文英,平仄平平仄。仄仄平、平仄仄平平仄。平仄仄平，仄平平仄，平仄平仄。仄平仄平平、仄平平仄仄仄仄。仄仄平、平仄仄。仄仄仄平平，仄平平仄，仄仄仄平平仄，仄平平仄。平仄。平平仄仄。仄仄平、仄仄平仄。仄平平仄。平平平仄，仄平仄仄。仄仄仄平平仄平，平仄平仄仄。仄仄仄、平仄仄。仄仄仄平平，平平平仄仄仄。仄仄平平仄仄。,0,52,71,123,"[5, 3, 6, 4, 4, 4, 5, 7, 3, 3, 5, 4, 6, 4, 2, 4, 3, 4, 4, 4, 4, 7, 5, 3, 3, 5, 6, 6]"
春风袅娜 ,冯艾子,仄平平平仄，仄仄平平。平仄仄，仄平平。仄平平、仄仄仄平平仄，仄平平仄，平仄平平。仄仄平平，平平平仄，仄仄平平平仄平。仄仄平平仄平仄，平平平仄仄平平。平仄平平仄仄，平平仄仄，仄平仄、仄仄平平。平平仄，仄平平。平平仄仄，平仄平平。仄仄平平，仄平平仄，仄平平仄，仄仄平平。平平平仄，仄平平平仄，平平仄仄，平仄平平。,0,70,55,125,"[5, 4, 3, 3, 3, 6, 4, 4, 4, 4, 7, 7, 7, 6, 4, 3, 4, 3, 3, 4, 4, 4, 4, 4, 4, 4, 5, 4, 4]"
春雪间早梅 ,无名氏,平平仄仄平。仄仄仄仄仄平平。仄仄平平平平仄，平平仄仄仄平平。平平平平仄仄，仄仄仄仄平平。平仄平平仄，平平仄仄平。平平仄仄平仄仄，仄仄仄平平。平仄平平平仄，平平仄仄，仄仄仄平平。平平平仄平仄仄，仄仄仄仄仄平平。仄仄平平仄仄，平平仄仄平平。平平平仄仄，仄平平仄仄平平。仄平仄仄平平仄，平平仄仄平。,0,63,62,125,"[5, 7, 7, 7, 6, 6, 5, 5, 7, 5, 6, 4, 5, 7, 7, 6, 6, 5, 7, 7, 5]"
白苎 ,柳永,仄平平，仄平仄，平平仄仄。平平仄仄，仄仄平平仄仄。仄平平、仄平平仄仄平仄。平仄。仄平平，仄仄仄平平平仄。平平仄平，平仄平平仄仄。平仄平、仄平平仄平平仄。平仄。平平仄仄，仄仄平平，仄平平仄，平仄平平仄仄。平仄仄平平，仄平平仄。平平仄仄，仄平平仄仄，仄平平仄。仄仄平平，仄仄平平，平仄平仄。仄仄平平，仄仄平平仄。,0,63,62,125,"[3, 3, 4, 4, 6, 3, 7, 2, 3, 7, 4, 6, 3, 7, 2, 4, 4, 4, 6, 5, 4, 4, 5, 4, 4, 4, 4, 4, 5]"
翠羽吟 ,蒋捷,仄仄平。仄仄平。平仄仄平平。仄仄仄平，仄平平仄仄平平。仄平平平仄仄，平仄平仄平平。仄仄平、仄平平仄，平平仄仄平平。平仄平仄仄平平。平平平仄，仄仄平平。仄仄平平仄仄，平仄仄仄，平平平仄平。仄平仄仄平平，仄仄仄仄平平。仄仄平平仄，平仄仄、平仄平平。仄仄平平仄平。仄平平仄仄平平。平平仄仄，仄仄平平，仄仄仄平。,0,63,63,126,"[3, 3, 5, 4, 7, 6, 6, 3, 4, 6, 7, 4, 4, 6, 4, 5, 6, 6, 5, 3, 4, 6, 7, 4, 4, 4]"
六州 ,无名氏,平仄仄，仄仄仄平平。平仄仄，平平仄，仄仄仄平平。平仄仄、仄仄平平。平仄平仄仄，仄仄平平。仄平仄、平仄平平。平仄仄平平。平平仄仄，平平仄仄，平平仄仄，平仄仄平平。平平仄，仄平仄仄平平。平仄仄，仄平仄，平仄仄平平。平平仄、仄仄平平。仄平平。仄平仄仄平平。平平仄，仄仄平平。仄平仄平平。平平平仄，平平仄仄，平平仄仄，仄仄仄平平。,0,66,63,129,"[3, 5, 3, 3, 5, 3, 4, 5, 4, 3, 4, 5, 4, 4, 4, 5, 3, 6, 3, 3, 5, 3, 4, 3, 6, 3, 4, 5, 4, 4, 4, 5]"
十二时慢 ,柳永,仄平平，仄平平仄，平仄平平平仄。仄仄仄、平平平仄。仄仄平平平仄。仄仄平平，平平仄仄，仄仄平平仄。平仄仄、仄仄平平，仄仄仄平，平仄平平平仄。平仄平，平平仄仄，仄仄仄平平仄。仄仄仄平，平平仄仄，仄仄平平仄。仄仄平仄仄，平平仄仄仄仄。仄仄平，平平仄仄，仄仄平平平仄。仄仄平平，平平平仄。仄仄平平仄。仄仄平仄仄，平平仄平平仄。,0,60,70,130,"[3, 4, 6, 3, 4, 6, 4, 4, 5, 3, 4, 4, 6, 3, 4, 6, 4, 4, 5, 5, 6, 3, 4, 6, 4, 4, 5, 5, 6]"
十二时慢 ,朱雍,仄平平，仄平仄仄，平仄平平平仄。仄仄平、平平平仄，仄仄平平平仄。仄仄平、平平仄仄，仄仄平平仄。平仄仄、平仄平平，仄仄仄平，平仄平平平仄。平仄平平平仄，仄仄平平仄仄。仄仄仄平平平，仄仄仄平平平仄。平仄仄平仄，平平仄仄平仄。,0,45,46,91,"[3, 4, 6, 3, 4, 6, 3, 4, 5, 3, 4, 4, 6, 6, 6, 6, 7, 5, 6]"
十二时慢 ,葛长庚,仄平平，仄平平仄。平仄平平仄仄。仄仄仄、平平仄仄。仄仄平平仄仄。平仄平平，平平平仄。仄仄平平仄。仄仄仄、平仄平平，仄仄平平，平仄仄平平仄。平仄平，平平平仄。仄仄仄平平仄。平仄仄平，仄平平仄，平仄平平仄。仄仄平仄仄，仄平平仄平仄。仄平平，仄平平仄，平仄平平平仄。仄仄平平，仄平平仄，仄仄平平仄。仄平平仄仄，仄仄仄仄仄。仄平平仄仄平平，仄仄平平仄。,0,67,74,141,"[3, 4, 6, 3, 4, 6, 4, 4, 5, 3, 4, 4, 6, 3, 4, 6, 4, 4, 5, 5, 6, 3, 4, 6, 4, 4, 5, 5, 5, 7, 5]"
十二时慢 ,无名氏,仄平仄，仄仄平平。仄仄仄平平。平平仄仄，仄仄仄平。平仄仄平平。平平仄、平仄平平。仄平平。仄仄仄平平。仄仄仄平平。平平平仄，平仄仄平平。仄平平。平仄仄平平。平平仄，平仄平平仄，仄平仄平平。仄平仄仄，仄仄平平。平仄仄平平。平平仄、仄仄平平。仄平平。平平平仄仄，仄仄仄平平。平平仄仄，仄仄仄平平。仄平平。仄仄仄平平。,0,66,59,125,"[3, 4, 5, 4, 4, 5, 3, 4, 3, 5, 5, 4, 5, 3, 5, 3, 5, 5, 4, 4, 5, 3, 4, 3, 5, 5, 4, 5, 3, 5]"
兰陵王 ,秦观,仄平仄。平仄仄平仄仄。仄平仄，仄仄平平，仄仄平平仄平仄。仄仄平仄仄。平仄平平仄仄。平平仄，仄仄平平，仄仄平平仄平仄。平平仄平仄。仄平仄平平，平仄平仄。平平平仄平平仄。仄平仄仄平，仄平仄仄，仄仄平平仄仄仄。平平仄平仄。平仄。仄平仄。仄仄仄平平，仄仄平仄。仄平平仄平平仄。仄平平平仄，平平仄仄。仄平平仄，仄仄平仄仄平仄。,0,59,72,131,"[3, 6, 3, 4, 7, 5, 6, 3, 4, 7, 5, 5, 4, 7, 5, 4, 7, 5, 2, 3, 5, 4, 7, 5, 4, 4, 7]"
兰陵王 ,周邦彦,仄平仄。平仄平平仄仄。平平仄，平仄仄平，仄仄平平仄平仄。平平仄仄仄。平仄。平平仄仄。平平仄，平仄仄平，平仄平平仄平仄。平平仄平仄。仄仄仄平平，平仄平仄。平平平仄平平仄。平仄仄平仄，仄平平仄，平平平仄仄仄仄。仄平仄平仄。平仄。仄平仄。仄仄仄平平，平仄平仄。平平仄仄平平仄。仄仄仄平仄，仄平平仄。平平平仄，仄仄仄，仄仄仄。,0,61,69,130,"[3, 6, 3, 4, 7, 5, 2, 4, 3, 4, 7, 5, 5, 4, 7, 5, 4, 7, 5, 2, 3, 5, 4, 7, 5, 4, 4, 3, 3]"
兰陵王 ,辛弃疾,仄平仄。仄仄平平仄仄。平平仄，平仄仄平，仄仄仄平仄平仄。平平平仄仄。仄仄平平仄仄。平平仄，仄仄仄平，仄仄平平仄平仄。平平仄平仄。仄平仄平平，平仄平仄。平平平仄平平仄。仄仄仄平仄，平平平仄，平平仄仄仄仄仄。仄平仄仄仄。仄仄，仄平仄。仄仄仄平平，仄仄平仄，仄平仄仄平平仄。仄仄仄平仄，仄平平仄。仄平平仄，仄仄仄。仄仄仄。,0,52,78,130,"[3, 6, 3, 4, 7, 5, 6, 3, 4, 7, 5, 5, 4, 7, 5, 4, 7, 5, 2, 3, 5, 4, 7, 5, 4, 4, 3, 3]"
兰陵王 ,陈允平,仄平仄。仄仄平平仄仄。平平仄，平仄仄平平仄，平平仄平仄。平平仄平仄。平仄平平仄仄。平平仄，平仄仄平，仄仄平平仄平仄。平平仄平仄。仄平仄平平，平仄平仄。平平平仄仄平仄。平仄仄，平仄仄平平仄，平平平仄仄平仄。仄平仄平仄。仄仄。仄平仄。仄仄仄平平，平仄平仄。平平仄仄平平仄。仄平仄平仄，仄平平仄。平平仄仄，仄仄仄，仄仄仄。,0,61,69,130,"[3, 6, 3, 6, 5, 5, 6, 3, 4, 7, 5, 5, 4, 7, 3, 6, 7, 5, 2, 3, 5, 4, 7, 5, 4, 4, 3, 3]"
兰陵王 ,刘辰翁,仄平仄。平仄平平平仄。平平仄，平仄平平，平仄平平仄平仄。平平仄仄仄。仄仄仄平平仄。仄平仄，仄仄平平，仄仄平平仄平仄。平仄。仄平仄。仄仄仄平平，平仄平仄。仄平平仄平平仄。仄仄仄平平，仄平平仄。平平仄仄仄平仄。平仄仄平仄。平仄。仄平仄。仄平仄仄仄，仄仄平仄。平平仄仄平平仄。仄平平仄仄，平仄平仄。平平平仄，仄仄仄，仄仄仄。,0,58,72,130,"[3, 6, 3, 4, 7, 5, 6, 3, 4, 7, 2, 3, 5, 4, 7, 5, 4, 7, 5, 2, 3, 5, 4, 7, 5, 4, 4, 3, 3]"
大酺 ,周邦彦,仄仄平平，平平仄，平仄平平平仄。平平平仄仄，仄平平平仄，仄平平仄。仄仄平平，平平仄仄，平仄平平平仄。平平平平仄，仄平平仄仄，仄平平仄。仄平仄平平，仄平平仄，仄平平仄。平平平仄仄。仄平仄、平仄平平仄。仄仄仄、平平平仄，仄仄平平，仄平平、仄平平仄。仄仄平平仄，平仄仄、仄平平仄。仄平仄、平平仄。平仄平仄，平仄平平平仄。仄平仄平仄仄。,0,71,62,133,"[4, 3, 6, 5, 5, 4, 4, 4, 6, 5, 5, 4, 5, 4, 4, 5, 3, 5, 3, 4, 4, 3, 4, 5, 3, 4, 3, 3, 4, 6, 6]"
大酺 ,周密,仄仄平平，平平仄，仄仄平平平仄。平平平仄仄，仄平平平仄，仄平平仄。仄仄平平，平平平仄，平仄平平平仄。平平平仄仄，仄平仄平仄，仄平平仄。仄平仄平平，仄平平仄，仄平平仄。仄仄平仄仄。仄平仄、仄仄平平仄。仄仄仄、平平仄仄，仄仄平平，仄平平仄平平仄。仄仄平仄仄，仄平仄、仄平平仄。仄平仄、平平仄。平平仄仄，仄仄平平平仄。仄平仄平仄仄。,0,64,69,133,"[4, 3, 6, 5, 5, 4, 4, 4, 6, 5, 5, 4, 5, 4, 4, 5, 3, 5, 3, 4, 4, 7, 5, 3, 4, 3, 3, 4, 6, 6]"
破阵乐 ,柳永,仄平仄仄，平平仄仄，平仄平仄。平仄平平仄仄，仄仄仄平平平仄。平仄平平，平平仄仄，仄平仄仄。仄平平、仄仄平平仄，仄平平平仄，平平平仄。仄仄平平，仄平仄仄，平平平仄。平仄。仄仄平平，平平仄仄，平仄仄，平仄仄。仄仄平平平仄仄，仄仄仄平平仄。平平平，平平仄，平平仄仄。仄仄平平平仄，仄仄平平，平平仄仄，平平平仄，仄仄平仄平平，仄平仄仄。,0,66,67,133,"[4, 4, 4, 6, 7, 4, 4, 4, 3, 5, 5, 4, 4, 4, 4, 2, 4, 4, 3, 3, 7, 6, 3, 3, 4, 6, 4, 4, 4, 6, 4]"
破阵乐 ,张先,仄平仄仄，平平仄仄，平仄平仄。仄仄平平仄仄，仄仄平平仄平仄。平仄平平，平平仄仄，平平仄仄。仄平平、仄仄平平仄，仄平平平仄，平平平仄，仄仄平平，仄平仄仄，平平平仄。平仄。仄仄平平，平平仄仄，平仄仄，平仄仄。仄仄平平平仄仄，仄仄仄平平仄。仄平平，平平仄，平平仄仄。仄仄平平平仄，仄仄平平，平平仄仄，平平平仄，仄仄平仄平平，仄平仄仄。,0,65,68,133,"[4, 4, 4, 6, 7, 4, 4, 4, 3, 5, 5, 4, 4, 4, 4, 2, 4, 4, 3, 3, 7, 6, 3, 3, 4, 6, 4, 4, 4, 6, 4]"
瑞龙吟 ,周邦彦,平平仄。平仄仄仄平平，仄平平仄。平平平仄平平，仄平仄仄，平平仄仄。仄平仄。平仄仄平平仄，仄平平仄。平平仄仄平平，仄平仄仄，平平仄仄。平仄平平平仄，仄平平仄，平平平仄。平仄仄平平平，平仄平仄。平平仄仄，平仄平平仄。平平仄、平平仄仄，平平平仄。仄仄平平仄。仄平仄仄，平平仄仄。平仄平平仄。平仄仄，平平平平平仄。仄平仄仄，仄平平仄。,0,72,61,133,"[3, 6, 4, 6, 4, 4, 3, 6, 4, 6, 4, 4, 6, 4, 4, 6, 4, 4, 5, 3, 4, 4, 5, 4, 4, 5, 3, 6, 4, 4]"
瑞龙吟 ,吴文英,仄平仄。平仄仄仄平平，仄平平仄。平平平仄仄平，平平仄仄，平平仄仄。仄平仄。平仄仄平平仄，仄平仄仄。平平仄仄平平，仄平仄仄，平平仄仄。平仄平平平仄，仄平仄仄，平平平仄。平仄仄平，仄平平仄平仄。平平仄仄，平仄平平仄。平平仄，平平平仄。平平仄仄。仄仄平平仄。仄平仄仄，平平仄仄。平仄平平仄，平仄仄仄平，平平平仄。平平仄仄，平平仄仄。,0,68,65,133,"[3, 6, 4, 6, 4, 4, 3, 6, 4, 6, 4, 4, 6, 4, 4, 4, 6, 4, 5, 3, 4, 4, 5, 4, 4, 5, 5, 4, 4, 4]"
瑞龙吟 ,陈允平,平平仄。平仄仄仄平平，仄平平仄。平平仄仄平平，仄平仄仄，平平仄仄。仄平仄。平仄仄平平仄，仄平平仄。平平平仄平平，仄平仄仄，平平仄仄。平仄平平平仄，仄平平仄，平平平仄。平仄仄仄平平，平仄平仄。平平仄仄，平仄平平仄。平平仄，平平仄仄，平平平仄。仄仄平平仄。仄仄仄，仄平平仄仄。平仄平平仄。平仄仄，平平仄平平仄。仄平仄仄，仄平平仄。,0,69,64,133,"[3, 6, 4, 6, 4, 4, 3, 6, 4, 6, 4, 4, 6, 4, 4, 6, 4, 4, 5, 3, 4, 4, 5, 3, 5, 5, 3, 6, 4, 4]"
瑞龙吟 ,翁元龙,平平仄。平仄仄仄平平，仄平平仄。平平仄仄平平，仄平仄仄，平平仄仄。仄平仄。仄仄仄平平仄，仄平平仄。平平仄仄平平，仄平仄仄，平平仄仄。仄仄平平平仄，仄平平仄，仄平平仄。平仄仄仄平平，平仄平仄。平平仄仄，仄仄平平仄。仄平仄，平平仄仄，仄平平仄。仄仄平平仄。仄平仄仄平平仄。平仄平平仄。平仄仄，仄仄平平平仄。仄平仄仄，仄平平仄。,0,62,70,132,"[3, 6, 4, 6, 4, 4, 3, 6, 4, 6, 4, 4, 6, 4, 4, 6, 4, 4, 5, 3, 4, 4, 5, 7, 5, 3, 6, 4, 4]"
浪淘沙慢 ,柳永,仄仄、仄平平仄仄，平平平仄。平平仄仄，仄平平平，仄仄平仄。平平平仄仄平平仄。仄平平、仄仄平平，仄仄仄、平平平仄，仄仄平平平仄。平仄。仄平平平，仄平平仄，仄仄仄仄平平，平仄平平仄，仄仄平平仄，仄平平仄。仄仄平平，仄仄平平仄平平仄。仄平平、平平仄仄，平平仄平平仄。平平平、仄仄平平仄，仄平平仄仄，平平仄仄仄，平平仄仄，仄平平平仄。,0,69,64,133,"[2, 5, 4, 4, 4, 4, 8, 3, 4, 3, 4, 6, 2, 4, 4, 6, 5, 5, 4, 4, 8, 3, 4, 6, 3, 5, 5, 5, 4, 5]"
浪淘沙慢 ,周邦彦,仄仄仄、平平仄仄，仄仄平仄。仄仄平平仄仄，平平仄仄仄仄。仄仄仄平平平仄仄。仄仄仄、平平平仄，仄仄平、平仄仄平仄。平仄仄平仄。仄仄。仄平仄仄平仄。仄平仄、平仄平平仄，平仄平平仄。仄仄平平仄，平平平仄。仄平仄仄，平仄平，仄仄平平平仄。平仄仄、平平平仄，平平仄、仄仄仄仄。仄平平、平平仄仄仄。仄仄仄、仄仄平平，仄仄仄。平平仄仄平平仄。,0,54,79,133,"[3, 4, 4, 6, 6, 8, 3, 4, 3, 5, 5, 2, 6, 3, 5, 5, 5, 4, 4, 3, 6, 3, 4, 3, 4, 3, 5, 3, 4, 3, 7]"
浪淘沙慢 ,周邦彦,仄平平，平平仄仄，仄仄平仄。平仄平平仄仄。平平仄仄仄仄。仄仄仄平平平仄仄。仄平仄、仄仄平仄。仄仄仄平平仄平仄，平平仄平仄。平仄。仄平仄仄平仄。仄仄仄平平，平平仄、仄仄平仄仄。平仄仄平平，平仄平仄。仄平仄仄。平仄平平仄，平平平仄。平仄平平平平仄。平平仄、仄平仄仄。仄平仄、平平平仄仄。仄平仄、仄仄平平，仄仄仄，平平仄仄平平仄。,0,60,73,133,"[3, 4, 4, 6, 6, 8, 3, 4, 8, 5, 2, 6, 5, 3, 5, 5, 4, 4, 5, 4, 7, 3, 4, 3, 5, 3, 4, 3, 7]"
浪淘沙慢 ,陈允平,仄平平，平平仄仄，仄仄平仄。平仄平平仄仄。平平平仄仄仄。仄仄平平平仄仄。平平仄、仄仄平仄。仄仄仄平平仄，仄仄平平平仄仄。平仄。仄平仄仄平仄。仄仄仄平平，平平仄、仄仄平仄仄。仄仄仄平平，仄仄平仄。仄平仄仄。仄仄平仄仄，仄平平仄。仄仄平平平平仄。平平仄、平平仄仄。仄平仄、平平平仄仄。平平仄，仄仄平平，仄仄仄，平平仄仄平平仄。,0,57,75,132,"[3, 4, 4, 6, 6, 7, 3, 4, 6, 7, 2, 6, 5, 3, 5, 5, 4, 4, 5, 4, 7, 3, 4, 3, 5, 3, 4, 3, 7]"
歌头 ,唐庄宗,仄平平、仄平平仄。平平仄仄，平平平仄仄。仄平平，平平仄。平平仄、仄仄平平，平平平仄。仄平平、平平平仄。平仄仄平平，平平仄。平仄仄，仄平仄。平仄仄、仄仄平平仄，仄平仄。仄平平，仄平平，平仄仄。仄仄仄平，平平平仄仄。仄仄仄平平，平平仄，平平仄平平，仄平仄。平平仄，仄平仄，仄平平，仄仄平平仄仄。仄平平，仄仄平平平仄，平平平平，仄平平，平仄仄，仄平仄。,0,74,62,136,"[3, 4, 4, 5, 3, 3, 3, 4, 4, 3, 4, 5, 3, 3, 3, 3, 5, 3, 3, 3, 3, 4, 5, 5, 3, 5, 3, 3, 3, 3, 6, 3, 6, 4, 3, 3, 3]"
多丽 ,晁补之,平平仄，仄平仄仄平平。仄平平、平平仄仄，仄平仄仄平平。仄平平、仄平仄仄，仄平平仄仄平平。平仄平平，仄平平仄，仄平平仄仄平平。仄平仄、平平平仄，仄仄仄平平。平平仄、平平仄仄，平仄平平。仄平平、平平仄仄，仄平平仄平平。仄平平、仄平仄仄，仄平平仄仄平平。仄仄平平，平平平仄，平平仄仄仄平平。仄仄仄、平平仄仄，平仄仄平平。平平仄、平平仄仄，平仄平平。,0,77,62,139,"[3, 6, 3, 4, 6, 3, 4, 7, 4, 4, 7, 3, 4, 5, 3, 4, 4, 3, 4, 6, 3, 4, 7, 4, 4, 7, 3, 4, 5, 3, 4, 4]"
多丽 ,晁端礼,仄平平，仄平仄仄平平。仄平平、平平仄仄，仄仄平仄平平。仄平平、仄平仄仄，仄仄仄、平仄平平。仄仄平平，平平仄仄，仄平平仄仄平平。仄仄仄、平平平仄，平仄仄平平。平平仄，平平平仄，仄仄平平。仄平平、平平仄仄，仄仄平仄平平。仄平平、仄平平仄，仄仄平、平仄平平。仄仄平平，平平仄仄，平平平仄仄平平。仄平仄、平平仄仄，平仄仄平平。平平仄，平平仄仄，仄仄平平。,0,75,64,139,"[3, 6, 3, 4, 6, 3, 4, 3, 4, 4, 4, 7, 3, 4, 5, 3, 4, 4, 3, 4, 6, 3, 4, 3, 4, 4, 4, 7, 3, 4, 5, 3, 4, 4]"
多丽 ,李漳,仄平平。仄平仄仄平平。仄平平、仄平仄仄，仄平仄仄平平。仄平平、仄平仄仄，仄仄仄、仄平平。仄仄平平，平平平仄，仄平平仄仄平平。仄平仄，仄平平仄，平仄仄平平。仄平仄，平平仄平，平仄平平。仄平平、平平仄仄，仄平仄仄平平。仄平平、仄平仄仄，仄仄平、平仄平平。仄平平，平平平仄，仄平平仄仄平平。仄平仄、平平平仄，平仄仄平平。平平仄，平平仄仄，仄仄平平。,0,74,63,137,"[3, 6, 3, 4, 6, 3, 4, 3, 3, 4, 4, 7, 3, 4, 5, 3, 4, 4, 3, 4, 6, 3, 4, 3, 4, 3, 4, 7, 3, 4, 5, 3, 4, 4]"
多丽 ,张孝祥,仄平平，仄平仄仄平平。仄平平、平平平仄，仄平平仄平平。仄平平、仄平平仄，仄仄仄、仄仄平平。仄仄平平，平平仄仄，仄平平仄仄平平。仄平仄、平平平仄，平仄仄平平。平平仄、平平仄仄，仄仄平平。仄平平、平平仄仄，仄仄平仄平平。仄仄平平平仄仄，仄仄仄仄仄平平。仄仄平平，平平仄仄，平平平仄仄平平。仄平仄、平平平仄，平仄仄平平。平平仄，平平仄仄，平仄平平。,0,76,63,139,"[3, 6, 3, 4, 6, 3, 4, 3, 4, 4, 4, 7, 3, 4, 5, 3, 4, 4, 3, 4, 6, 7, 7, 4, 4, 7, 3, 4, 5, 3, 4, 4]"
多丽 ,张翥,仄平平。仄平平仄平平。仄平平、平平仄仄，平平仄仄平平。仄平平、平平平仄，平平仄、仄仄平平。平仄平平，平平仄仄，仄平平仄仄平平。仄平仄、仄平平仄，仄仄仄平平。平平仄，仄平平仄，平仄平平。仄平平、平平仄仄，仄平平仄平平。仄平平、仄平仄仄，平平仄、平仄平平。平仄平平，仄平仄仄，仄平平仄仄平平。仄仄仄、仄平平仄，平仄仄平平。平平仄，仄平平仄，仄仄平平。,0,79,60,139,"[3, 6, 3, 4, 6, 3, 4, 3, 4, 4, 4, 7, 3, 4, 5, 3, 4, 4, 3, 4, 6, 3, 4, 3, 4, 4, 4, 7, 3, 4, 5, 3, 4, 4]"
多丽 ,傅按察,仄平平。平平平仄平平。仄仄仄、平平仄仄，仄仄仄仄平平。仄平平、仄平平仄，平平仄、平仄平平。仄仄平平，平平仄仄，仄平平仄仄平平。平平仄、平平平仄，仄仄仄平平。平平仄，平平仄仄，仄仄平平。仄平平。平平平仄，仄平平仄平平。仄平平、仄平仄仄，仄仄仄、平仄平平。仄平仄、平平平仄，平仄仄平平。仄仄平平，平平仄仄，平平平仄仄平平。仄平仄，仄平平仄，平仄平平。,0,78,61,139,"[3, 6, 3, 4, 6, 3, 4, 3, 4, 4, 4, 7, 3, 4, 5, 3, 4, 4, 3, 4, 6, 3, 4, 3, 4, 3, 4, 5, 4, 4, 7, 3, 4, 4]"
多丽 ,葛立方,仄平平平仄，平仄平平。仄仄平、平平仄仄，平平仄仄平平。仄平平、仄平平仄，平平仄、仄仄平平。仄仄平平，平平仄仄，仄平仄仄仄平平。仄平仄、平平平仄，仄仄仄平平。平平仄、平平仄仄，平仄平平。仄平平，平平平仄，仄平平仄平平。仄平平、仄平平仄，仄仄平、平仄平平。仄仄平平，平平平仄，仄平平仄仄平平。仄仄仄平平，平仄平仄仄平平。平平仄、仄平平仄，平仄平平。,0,80,59,139,"[5, 4, 3, 4, 6, 3, 4, 3, 4, 4, 4, 7, 3, 4, 5, 3, 4, 4, 3, 4, 6, 3, 4, 3, 4, 4, 4, 7, 5, 7, 3, 4, 4]"
多丽 ,聂冠卿,仄平平，仄仄平平平仄。仄平平、仄平仄仄，仄平平仄仄仄。仄平平、仄平仄仄，仄平平、平仄平仄。仄仄平平，平平平仄，仄平平仄，仄平仄仄。仄平仄、仄平平仄，平仄仄平仄。平平仄、平平仄仄，仄仄平仄。仄平仄平平仄仄，仄平平仄平仄。仄平平、仄平平仄，仄仄平平仄平仄。仄仄平平，平平平仄，平平平仄仄平仄。仄平仄、仄平平仄，平仄仄平仄。平平仄，平仄仄平，仄仄平仄。,0,67,73,140,"[3, 6, 3, 4, 6, 3, 4, 3, 4, 4, 4, 4, 4, 3, 4, 5, 3, 4, 4, 7, 6, 3, 4, 7, 4, 4, 7, 3, 4, 5, 3, 4, 4]"
多丽 ,曹勛,仄仄平仄仄，仄平平仄。仄平平仄仄，平仄仄平，仄平平仄。仄平平、仄平平仄，平仄仄、平平平仄。仄仄平平，仄仄仄仄，平平仄仄仄平仄。仄仄仄平，平平平仄，平仄平平仄。平仄仄。平平仄仄，仄平平仄。仄平平仄仄平平，仄平仄平平仄。仄平平、仄平平仄，平仄仄、平平平仄。仄仄平平，平平仄仄，平平仄仄仄平仄。平仄仄平，平平平仄，仄仄仄仄。仄仄仄。仄仄平平，仄平仄仄。,0,64,76,140,"[5, 4, 5, 4, 4, 3, 4, 3, 4, 4, 4, 7, 4, 4, 5, 3, 4, 4, 7, 6, 3, 4, 3, 4, 4, 4, 7, 4, 4, 4, 3, 4, 4]"
玉女摇仙佩 ,柳永,平平仄仄，仄仄平平，仄仄平平平仄。仄仄平平，平平平仄，仄仄仄平平仄。仄仄平平仄。仄平平仄仄，平平平仄。仄平仄、平平仄仄，平仄平平仄仄平仄。平平仄平平，仄仄平平，平平仄仄。平仄仄平仄仄，仄仄平平，仄仄平平平仄。仄仄仄平，平平平仄，仄仄平平平仄。仄仄平平仄。仄平仄、平仄平平平仄。仄仄仄、平平仄仄，仄平平仄，仄平平仄。平平仄。平平仄仄平平仄。,0,69,70,139,"[4, 4, 6, 4, 4, 6, 5, 5, 4, 3, 4, 8, 5, 4, 4, 6, 4, 6, 4, 4, 6, 5, 3, 6, 3, 4, 4, 4, 3, 7]"
玉女摇仙佩 ,朱雍,平平仄仄，仄仄平平，仄仄平平平仄。仄仄平平，平平仄仄。仄仄平平平仄。仄仄平平仄。仄平平仄仄，仄平平仄。仄平平、平平仄仄，仄仄平平，仄平平仄。平平仄、平平仄仄，平平仄平平仄。平仄平平仄仄，仄仄平平，仄仄平平仄仄。仄仄平平，平平平仄，仄仄平平平仄。仄仄平平仄。平平仄、仄仄平平平仄。仄仄仄、平仄仄仄，平平仄仄，仄平平仄。平平仄。平平仄仄平平仄。,0,69,70,139,"[4, 4, 6, 4, 4, 6, 5, 5, 4, 3, 4, 4, 4, 3, 4, 6, 6, 4, 6, 4, 4, 6, 5, 3, 6, 3, 4, 4, 4, 3, 7]"
六丑 ,周邦彦,仄平平仄仄，仄仄仄、平平平仄。仄平仄平，平平平仄仄。仄仄平仄。仄仄平平仄，仄平平仄，仄仄平平仄。平平仄仄平平仄。仄仄平平，平平仄仄。平平仄平平仄。仄平平仄仄，平仄平仄。平平平仄。仄平平仄仄。仄仄平平仄，平仄仄。平平仄仄平仄。仄平平仄仄，仄平平仄。平平仄、仄平平仄。平仄仄、仄仄平平仄仄，仄平平仄。平平仄、仄仄平仄。仄仄平、仄仄平平仄，平平仄仄。,0,65,75,140,"[5, 3, 4, 4, 5, 4, 5, 4, 5, 7, 4, 4, 6, 5, 4, 4, 5, 5, 3, 6, 5, 4, 3, 4, 3, 6, 4, 3, 4, 3, 5, 4]"
六丑 ,吴文英,仄平平仄仄，仄仄仄、平平平仄。仄平仄平，平平平仄仄。仄仄平仄。仄仄平平仄，仄平平仄，仄仄平平仄。平平仄仄平平仄。仄仄平平，平平仄仄。平平仄平平仄。仄平平仄仄，平仄平仄。平平仄仄。仄平平仄仄。仄仄平平，仄平仄仄。平平仄仄平仄。仄平平仄仄，仄平平仄。平平仄、平平平仄。仄平仄、仄仄平平，仄仄仄平平仄。平平仄、平仄平仄。仄仄仄、仄仄平平仄，平平仄仄。,0,65,75,140,"[5, 3, 4, 4, 5, 4, 5, 4, 5, 7, 4, 4, 6, 5, 4, 4, 5, 4, 4, 6, 5, 4, 3, 4, 3, 4, 6, 3, 4, 3, 5, 4]"
六丑 ,詹正,仄平平仄仄，仄仄仄、平平平仄。仄平仄仄，平平平仄仄。仄仄平仄。仄仄平平仄，仄平仄仄，仄仄平平仄。平平仄仄平平仄。仄仄平平，平平平仄。平平仄平平仄。仄平平仄仄，仄仄平仄。平平平仄。仄平平仄仄。仄仄平平，平平仄仄。仄平仄仄平仄。仄平平平仄，仄平平仄。平平仄、平平平仄。仄仄仄、平仄平平，仄仄平平平仄。平平仄、平仄平仄。仄仄平仄，仄平平仄，仄平仄仄。,0,66,74,140,"[5, 3, 4, 4, 5, 4, 5, 4, 5, 7, 4, 4, 6, 5, 4, 4, 5, 4, 4, 6, 5, 4, 3, 4, 3, 4, 6, 3, 4, 4, 4, 4]"
玉抱肚 ,杨无咎,平平平仄。平平平仄。仄平平仄仄平平，仄平平仄平仄。仄平平仄仄，平平仄、平仄平平仄平仄。仄平仄仄，仄仄仄仄。平平仄、仄平仄。仄仄平平，平平仄、平平仄仄，平平仄平仄。仄平平、仄仄平平仄。仄仄平、仄仄平平仄。仄平平、仄仄平平，仄平平仄仄仄。仄平平仄。仄平仄、仄仄平平仄平仄。仄仄仄仄，仄平仄、平平仄。仄仄平、平仄仄。仄平平仄仄、平仄仄，仄仄仄仄、仄平平仄。,0,63,78,141,"[4, 4, 7, 6, 5, 3, 7, 4, 4, 3, 3, 4, 3, 4, 5, 3, 5, 3, 5, 3, 4, 6, 4, 3, 7, 4, 3, 3, 3, 3, 5, 3, 4, 4]"
六州歌头 ,贺铸,仄平仄仄，平仄仄平平。平仄仄。平仄仄。仄平平。仄平平。仄仄平平仄。平平仄。平平仄。平仄仄。平平仄。仄平平。平仄仄平，平仄平平仄。仄仄平平。仄平平仄仄，仄仄仄平平。仄仄平平。仄平平。仄平平仄。平平仄。平仄仄。仄平平。平仄仄。平仄仄。仄平平。仄平平。仄仄平平仄。平平仄。仄平平。平仄仄。平平仄。仄平平。仄仄平平，仄仄平平仄。仄仄平平。仄平平平仄，仄仄仄平平。仄仄平平。,0,73,70,143,"[4, 5, 3, 3, 3, 3, 5, 3, 3, 3, 3, 3, 4, 5, 4, 5, 5, 4, 3, 4, 3, 3, 3, 3, 3, 3, 3, 5, 3, 3, 3, 3, 3, 4, 5, 4, 5, 5, 4]"
六州歌头 ,汪元量,仄平平仄，平仄仄平平。平平仄。平平仄。仄平平。平平平。平仄平平仄。仄平仄。平平仄。平平仄。仄平平。仄平平。仄仄平平平仄，仄平平、仄仄平平。平仄平平。仄平平。平平仄仄。平平仄。平平仄。仄平平。平平仄。平平仄。平平平。仄平平。仄仄平平仄。平平仄。仄平平。平平仄。平平仄。仄平平。平仄平平仄仄，平平仄、平仄平平。仄平平平仄，仄仄仄平平。平仄平平。,0,83,50,133,"[4, 5, 3, 3, 3, 3, 5, 3, 3, 3, 3, 3, 6, 3, 4, 4, 3, 4, 3, 3, 3, 3, 3, 3, 3, 5, 3, 3, 3, 3, 3, 6, 3, 4, 5, 5, 4]"
六州歌头 ,韩元吉,平平仄仄，平仄仄平平。平仄仄。平平仄。仄平平。仄平平。仄仄平平仄。平仄仄。平平仄。平仄仄。平平仄。仄平平。仄仄平平，仄仄平平仄，仄仄平平。仄平平平仄，仄仄仄平平。仄仄平平。仄平平。仄平仄仄。平平仄。平平仄。仄平平。平仄仄。平平仄。仄平平。仄平平。仄仄平平仄，平平仄，仄平平。平仄仄。平平仄。仄平平。平仄平平，仄仄平平仄，仄仄平平。仄平平仄仄，仄仄仄平平。仄仄平平。,0,75,68,143,"[4, 5, 3, 3, 3, 3, 5, 3, 3, 3, 3, 3, 4, 5, 4, 5, 5, 4, 3, 4, 3, 3, 3, 3, 3, 3, 3, 5, 3, 3, 3, 3, 3, 4, 5, 4, 5, 5, 4]"
六州歌头 ,李冠,平平仄仄，平仄仄平平。平平仄。平平仄。仄平平。仄平平。仄仄平平仄。仄平仄，平平仄。平仄仄。平平仄。仄平平。平仄仄平平仄，平平仄，平仄平平。仄平平平仄，仄仄仄平平。仄仄平平。仄平平。仄平平仄。平平仄。平仄仄，仄平平。平仄仄。平仄仄。仄平平。仄平平。平平平平仄，仄平仄，仄平平。平仄仄。平平仄。仄平平。平仄仄平平仄，平平仄，仄仄平平。仄平平仄仄，平仄仄平平。仄仄平平。,0,79,64,143,"[4, 5, 3, 3, 3, 3, 5, 3, 3, 3, 3, 3, 6, 3, 4, 5, 5, 4, 3, 4, 3, 3, 3, 3, 3, 3, 3, 5, 3, 3, 3, 3, 3, 6, 3, 4, 5, 5, 4]"
六州歌头 ,刘褒,平平仄仄，平仄仄平平。平平仄，平平仄，平仄仄，仄平平。仄仄平平仄，仄仄仄，平平仄，平仄仄，仄平平。仄平平。仄仄平平仄仄，平平仄，平仄平平。仄平平仄仄，平仄仄平平。仄仄平平。仄平平。仄平平仄，平平仄，平平仄，仄平平。平仄仄，平平仄，平平仄，仄平平。仄仄平平仄，平仄仄，仄平平。平仄仄，平平仄，仄平平。平仄仄平平仄，仄平平仄仄平平。仄平平平仄，平仄仄平平。仄仄平平。,0,77,66,143,"[4, 5, 3, 3, 3, 3, 5, 3, 3, 3, 3, 3, 6, 3, 4, 5, 5, 4, 3, 4, 3, 3, 3, 3, 3, 3, 3, 5, 3, 3, 3, 3, 3, 6, 7, 5, 5, 4]"
六州歌头 ,袁去华,平平平仄，平仄仄平平。仄平仄，平平仄，仄平平。仄平平。仄仄平平仄，仄平仄，平平仄，平平仄，平平仄，仄平平。仄仄平平平仄，平平仄，平仄平平。仄平平仄仄，平仄仄平平。仄仄平平。仄平平，仄平平仄，平平仄，仄平仄，仄平平。平平仄，平平仄，仄平平。仄平平。仄仄平平仄，仄平仄，仄平平。平仄仄，平平仄，仄平平。平仄平平平仄，平平仄，平仄平平。仄平平仄仄，仄仄仄平平。仄仄平平。,0,81,62,143,"[4, 5, 3, 3, 3, 3, 5, 3, 3, 3, 3, 3, 6, 3, 4, 5, 5, 4, 3, 4, 3, 3, 3, 3, 3, 3, 3, 5, 3, 3, 3, 3, 3, 6, 3, 4, 5, 5, 4]"
六州歌头 ,刘过,仄平平，仄平仄，仄平平。平平仄，平平仄仄，平平仄平平。平平平平仄，平平仄，平仄仄，平平仄，平平仄，仄平平。仄仄仄平，仄仄平平仄，仄仄平平。仄平平平仄，平仄仄平平。仄仄平平。仄平平。仄仄平平仄，平平仄，平仄仄平平。平平仄，平平仄，仄平平。仄平平。仄仄平平仄，平平仄，仄平平。仄平仄，平平仄，仄平平。仄仄仄平平仄，平平仄，平仄平平。仄平平平仄，仄仄仄平平。平仄平平。,0,82,61,143,"[3, 3, 3, 3, 4, 5, 5, 3, 3, 3, 3, 3, 4, 5, 4, 5, 5, 4, 3, 5, 3, 5, 3, 3, 3, 3, 5, 3, 3, 3, 3, 3, 6, 3, 4, 5, 5, 4]"
六州歌头 ,程珌,仄平仄仄，仄仄仄平平。平仄仄，仄平仄，仄平平。仄平平，仄仄仄平仄仄，平平仄，平平仄，仄仄仄，仄仄仄，仄平平。仄仄平平平仄，仄平平、仄仄平平。仄平平平仄，仄仄仄平平。仄仄平平，仄平平。平平平仄，仄仄仄，平平仄，仄平平。仄仄仄，平仄仄，仄平平。仄平平仄仄，平仄仄，仄平平。平平仄，平仄仄，仄平平。仄仄平平仄仄，仄平平、仄仄平平。仄平平仄仄，仄仄仄平平。平仄平平。,0,65,76,141,"[4, 5, 3, 3, 3, 3, 6, 3, 3, 3, 3, 3, 6, 3, 4, 5, 5, 4, 3, 4, 3, 3, 3, 3, 3, 3, 5, 3, 3, 3, 3, 3, 6, 3, 4, 5, 5, 4]"
六州歌头 ,卢挚,平平仄仄，仄仄仄平平。平仄仄，仄仄仄，仄平平。仄平平。仄仄平平平仄，仄平平，平平仄，平仄仄，平仄仄，仄平平。仄仄平平仄仄，平仄仄，平仄平平。仄平平仄仄，仄仄仄平平。仄仄平平。仄平平。仄平平仄，平仄仄，仄仄仄，仄平平。平仄仄，平仄仄，仄平平。仄平平。仄仄平平仄，平仄仄，仄平平。平仄仄，平仄仄，仄平平。仄仄平平仄仄，平平仄，仄仄平平。仄平平仄仄，仄仄仄平平。仄仄平平。,0,66,78,144,"[4, 5, 3, 3, 3, 3, 6, 3, 3, 3, 3, 3, 6, 3, 4, 5, 5, 4, 3, 4, 3, 3, 3, 3, 3, 3, 3, 5, 3, 3, 3, 3, 3, 6, 3, 4, 5, 5, 4]"
